"","Gene","female","male","total","male_ratio","female_ratio","p_value"
"1","A1BG",12,26,38,0.684210526315789,0.315789473684211,1
"2","A1CF",46,87,133,0.654135338345865,0.345864661654135,0.74233
"3","A2M",80,112,192,0.583333333333333,0.416666666666667,0.71711
"4","A2ML1",66,145,211,0.687203791469194,0.312796208530806,0.81929
"5","A3GALT2",7,6,13,0.461538461538462,0.538461538461538,1
"6","A4GALT",20,19,39,0.487179487179487,0.512820512820513,0.3338
"7","A4GNT",20,28,48,0.583333333333333,0.416666666666667,0.15236
"8","AAAS",24,17,41,0.414634146341463,0.585365853658537,0.07271
"9","AACS",23,43,66,0.651515151515151,0.348484848484849,0.58325
"10","AADAC",17,39,56,0.696428571428571,0.303571428571429,0.44817
"11","AADACL2",26,51,77,0.662337662337662,0.337662337662338,0.78105
"12","AADACL3",23,39,62,0.629032258064516,0.370967741935484,1
"13","AADACL4",27,44,71,0.619718309859155,0.380281690140845,1
"14","AADAT",10,22,32,0.6875,0.3125,1
"15","AAGAB",13,14,27,0.518518518518518,0.481481481481481,0.18167
"16","AAK1",21,34,55,0.618181818181818,0.381818181818182,1
"17","AAMDC",3,3,6,0.5,0.5,1
"18","AAMP",13,20,33,0.606060606060606,0.393939393939394,1
"19","AANAT",8,9,17,0.529411764705882,0.470588235294118,1
"20","AAR2",10,27,37,0.72972972972973,0.27027027027027,0.73696
"21","AARD",15,12,27,0.444444444444444,0.555555555555556,0.54009
"22","AARS1",23,41,64,0.640625,0.359375,0.77
"23","AARS2",46,43,89,0.48314606741573,0.51685393258427,0.77
"24","AASDH",39,70,109,0.642201834862385,0.357798165137615,0.75
"25","AASDHPPT",16,15,31,0.483870967741935,0.516129032258065,0.53
"26","AASS",43,79,122,0.647540983606557,0.352459016393443,0.62
"27","AATF",17,24,41,0.585365853658537,0.414634146341463,0.41
"28","AATK",23,40,63,0.634920634920635,0.365079365079365,0.65
"29","ABAT",30,37,67,0.552238805970149,0.447761194029851,0.06
"30","ABCA1",79,135,214,0.630841121495327,0.369158878504673,0.97
"31","ABCA10",67,143,210,0.680952380952381,0.319047619047619,0.4
"32","ABCA12",151,270,421,0.641330166270784,0.358669833729216,0.47
"33","ABCA13",248,427,675,0.632592592592593,0.367407407407407,0.71
"34","ABCA2",65,119,184,0.646739130434783,0.353260869565217,0.88
"35","ABCA3",39,87,126,0.69047619047619,0.30952380952381,0.9
"36","ABCA4",93,177,270,0.655555555555556,0.344444444444444,0.52
"37","ABCA5",79,103,182,0.565934065934066,0.434065934065934,0.66
"38","ABCA6",75,132,207,0.63768115942029,0.36231884057971,0.61
"39","ABCA7",66,103,169,0.609467455621302,0.390532544378698,0.69
"40","ABCA8",69,142,211,0.672985781990521,0.327014218009479,0.56
"41","ABCA9",88,147,235,0.625531914893617,0.374468085106383,0.9
"42","ABCB1",109,182,291,0.625429553264605,0.374570446735395,1
"43","ABCB10",33,43,76,0.565789473684211,0.434210526315789,0.66
"44","ABCB11",65,121,186,0.650537634408602,0.349462365591398,0.36
"45","ABCB4",63,110,173,0.635838150289017,0.364161849710983,0.85
"46","ABCB5",118,188,306,0.61437908496732,0.38562091503268,0.61
"47","ABCB6",23,41,64,0.640625,0.359375,1
"48","ABCB7",41,23,64,0.359375,0.640625,0.54
"49","ABCB8",32,46,78,0.58974358974359,0.41025641025641,0.35
"50","ABCB9",23,26,49,0.530612244897959,0.469387755102041,0.52
"51","ABCC1",67,75,142,0.528169014084507,0.471830985915493,0.15
"52","ABCC10",57,70,127,0.551181102362205,0.448818897637795,0.17
"53","ABCC11",88,94,182,0.516483516483517,0.483516483516484,0.64
"54","ABCC12",62,118,180,0.655555555555556,0.344444444444444,0.28
"55","ABCC2",65,68,133,0.511278195488722,0.488721804511278,0.09
"56","ABCC3",54,92,146,0.63013698630137,0.36986301369863,0.94
"57","ABCC4",70,85,155,0.548387096774194,0.451612903225806,0.02
"58","ABCC5",66,81,147,0.551020408163265,0.448979591836735,0.08
"59","ABCC6",46,101,147,0.687074829931973,0.312925170068027,0.92
"60","ABCC8",76,132,208,0.634615384615385,0.365384615384615,0.44
"61","ABCC9",108,189,297,0.636363636363636,0.363636363636364,0.68
"62","ABCD1",41,20,61,0.327868852459016,0.672131147540984,0.33
"63","ABCD2",40,91,131,0.694656488549618,0.305343511450382,0.74
"64","ABCD3",22,31,53,0.584905660377358,0.415094339622642,0.64
"65","ABCD4",30,25,55,0.454545454545455,0.545454545454545,0.32
"66","ABCE1",22,42,64,0.65625,0.34375,0.86
"67","ABCF1",21,44,65,0.676923076923077,0.323076923076923,0.68
"68","ABCF2",11,28,39,0.717948717948718,0.282051282051282,0.69
"69","ABCF2-H2BE1",1,1,2,0.5,0.5,1
"70","ABCF3",24,52,76,0.684210526315789,0.315789473684211,0.51
"71","ABCG1",39,38,77,0.493506493506494,0.506493506493506,0.01
"72","ABCG2",41,56,97,0.577319587628866,0.422680412371134,0.39
"73","ABCG4",31,63,94,0.670212765957447,0.329787234042553,0.8
"74","ABCG5",22,40,62,0.645161290322581,0.354838709677419,0.95
"75","ABCG8",38,67,105,0.638095238095238,0.361904761904762,0.9
"76","ABHD1",12,16,28,0.571428571428571,0.428571428571429,1
"77","ABHD10",17,18,35,0.514285714285714,0.485714285714286,0.37
"78","ABHD11",9,14,23,0.608695652173913,0.391304347826087,1
"79","ABHD12",14,15,29,0.517241379310345,0.482758620689655,0.47
"80","ABHD12B",12,14,26,0.538461538461538,0.461538461538462,0.7
"81","ABHD13",9,22,31,0.709677419354839,0.290322580645161,0.21
"82","ABHD14A",1,1,2,0.5,0.5,1
"83","ABHD14A-ACY1",8,19,27,0.703703703703704,0.296296296296296,1
"84","ABHD14B",0,6,6,1,0,1
"85","ABHD15",11,21,32,0.65625,0.34375,0.59
"86","ABHD16A",18,36,54,0.666666666666667,0.333333333333333,0.35
"87","ABHD16B",10,11,21,0.523809523809524,0.476190476190476,1
"88","ABHD17A",4,11,15,0.733333333333333,0.266666666666667,0.71
"89","ABHD17B",9,16,25,0.64,0.36,1
"90","ABHD17C",4,8,12,0.666666666666667,0.333333333333333,1
"91","ABHD18",10,16,26,0.615384615384615,0.384615384615385,1
"92","ABHD2",10,34,44,0.772727272727273,0.227272727272727,0.41
"93","ABHD3",9,25,34,0.735294117647059,0.264705882352941,0.36
"94","ABHD4",12,17,29,0.586206896551724,0.413793103448276,0.76
"95","ABHD5",7,15,22,0.681818181818182,0.318181818181818,0.27
"96","ABHD6",11,13,24,0.541666666666667,0.458333333333333,0.12
"97","ABHD8",13,21,34,0.617647058823529,0.382352941176471,1
"98","ABI1",14,18,32,0.5625,0.4375,1
"99","ABI2",14,28,42,0.666666666666667,0.333333333333333,0.61
"100","ABI3",13,22,35,0.628571428571429,0.371428571428571,1
"101","ABI3BP",55,91,146,0.623287671232877,0.376712328767123,1
"102","ABITRAM",3,7,10,0.7,0.3,1
"103","ABL1",43,64,107,0.598130841121495,0.401869158878505,0.79
"104","ABL2",48,90,138,0.652173913043478,0.347826086956522,0.39
"105","ABLIM1",32,50,82,0.609756097560976,0.390243902439024,0.8
"106","ABLIM2",34,35,69,0.507246376811594,0.492753623188406,0.11
"107","ABLIM3",35,49,84,0.583333333333333,0.416666666666667,0.76
"108","ABO",15,19,34,0.558823529411765,0.441176470588235,1
"109","ABR",30,40,70,0.571428571428571,0.428571428571429,0.53
"110","ABRA",27,48,75,0.64,0.36,0.66
"111","ABRACL",4,6,10,0.6,0.4,1
"112","ABRAXAS1",13,10,23,0.434782608695652,0.565217391304348,0.27
"113","ABRAXAS2",16,23,39,0.58974358974359,0.41025641025641,0.82
"114","ABT1",10,29,39,0.743589743589744,0.256410256410256,0.67
"115","ABTB1",21,24,45,0.533333333333333,0.466666666666667,0.17
"116","ABTB2",23,26,49,0.530612244897959,0.469387755102041,0.96
"117","AC002094.3",1,1,2,0.5,0.5,1
"118","AC004076.1",1,1,2,0.5,0.5,1
"119","AC004593.2",22,27,49,0.551020408163265,0.448979591836735,0.78
"120","AC004832.3",4,10,14,0.714285714285714,0.285714285714286,1
"121","AC004922.1",28,31,59,0.525423728813559,0.474576271186441,0.24
"122","AC004997.1",3,4,7,0.571428571428571,0.428571428571429,1
"123","AC005324.2",17,13,30,0.433333333333333,0.566666666666667,0.55
"124","AC005833.1",9,25,34,0.735294117647059,0.264705882352941,0.46
"125","AC005863.1",18,14,32,0.4375,0.5625,0.59
"126","AC006059.2",27,57,84,0.678571428571429,0.321428571428571,0.7
"127","AC007040.2",5,4,9,0.444444444444444,0.555555555555556,0.43
"128","AC008397.2",29,46,75,0.613333333333333,0.386666666666667,0.99
"129","AC008676.3",4,26,30,0.866666666666667,0.133333333333333,0.92
"130","AC008763.3",2,1,3,0.333333333333333,0.666666666666667,1
"131","AC008764.4",1,0,1,0,1,1
"132","AC008878.1",2,1,3,0.333333333333333,0.666666666666667,1
"133","AC009779.3",1,2,3,0.666666666666667,0.333333333333333,1
"134","AC010132.3",0,1,1,1,0,1
"135","AC011448.1",20,16,36,0.444444444444444,0.555555555555556,0.06
"136","AC011455.2",10,21,31,0.67741935483871,0.32258064516129,0.8
"137","AC011462.1",27,29,56,0.517857142857143,0.482142857142857,0.67
"138","AC011479.1",0,3,3,1,0,1
"139","AC012485.1",0,1,1,1,0,1
"140","AC013477.1",4,19,23,0.826086956521739,0.173913043478261,0.4
"141","AC013489.1",27,31,58,0.53448275862069,0.46551724137931,0.82
"142","AC016747.4",1,4,5,0.8,0.2,1
"143","AC018630.4",9,7,16,0.4375,0.5625,1
"144","AC018755.2",1,1,2,0.5,0.5,1
"145","AC019068.1",0,1,1,1,0,1
"146","AC020765.6",1,1,2,0.5,0.5,1
"147","AC020907.6",1,5,6,0.833333333333333,0.166666666666667,1
"148","AC021218.1",0,1,1,1,0,1
"149","AC023055.1",8,11,19,0.578947368421053,0.421052631578947,0.45
"150","AC023469.1",0,2,2,1,0,1
"151","AC024592.3",1,1,2,0.5,0.5,1
"152","AC024598.1",2,16,18,0.888888888888889,0.111111111111111,1
"153","AC024940.1",38,92,130,0.707692307692308,0.292307692307692,0.4
"154","AC025165.3",2,0,2,0,1,1
"155","AC026786.1",0,1,1,1,0,1
"156","AC053503.6",0,1,1,1,0,1
"157","AC055839.2",0,1,1,1,0,1
"158","AC064805.2",0,2,2,1,0,1
"159","AC068580.4",14,22,36,0.611111111111111,0.388888888888889,1
"160","AC073140.1",0,1,1,1,0,1
"161","AC073310.1",43,63,106,0.594339622641509,0.405660377358491,0.43
"162","AC074085.2",9,20,29,0.689655172413793,0.310344827586207,0.87
"163","AC079612.1",0,3,3,1,0,1
"164","AC083849.1",0,1,1,1,0,1
"165","AC090517.4",21,40,61,0.655737704918033,0.344262295081967,0.67
"166","AC091959.1",1,2,3,0.666666666666667,0.333333333333333,1
"167","AC092143.1",13,36,49,0.73469387755102,0.26530612244898,0.48
"168","AC092442.1",0,2,2,1,0,1
"169","AC092675.1",0,1,1,1,0,1
"170","AC092687.1",1,0,1,0,1,1
"171","AC092718.8",2,3,5,0.6,0.4,1
"172","AC092718.9",1,1,2,0.5,0.5,1
"173","AC093155.3",1,3,4,0.75,0.25,1
"174","AC093246.1",1,1,2,0.5,0.5,1
"175","AC093512.2",0,1,1,1,0,1
"176","AC093525.2",6,8,14,0.571428571428571,0.428571428571429,0.34
"177","AC093827.5",4,5,9,0.555555555555556,0.444444444444444,1
"178","AC097636.1",12,14,26,0.538461538461538,0.461538461538462,1
"179","AC097637.1",6,4,10,0.4,0.6,1
"180","AC098582.1",26,54,80,0.675,0.325,0.81
"181","AC099552.1",0,1,1,1,0,1
"182","AC100868.1",32,67,99,0.676767676767677,0.323232323232323,0.47
"183","AC104389.6",2,7,9,0.777777777777778,0.222222222222222,1
"184","AC104452.1",4,13,17,0.764705882352941,0.235294117647059,1
"185","AC105001.2",8,6,14,0.428571428571429,0.571428571428571,0.56
"186","AC107871.1",0,4,4,1,0,1
"187","AC107959.5",0,2,2,1,0,1
"188","AC109583.1",4,19,23,0.826086956521739,0.173913043478261,0.84
"189","AC112721.2",0,1,1,1,0,1
"190","AC126283.2",18,50,68,0.735294117647059,0.264705882352941,0.38
"191","AC127029.3",6,25,31,0.806451612903226,0.193548387096774,0.82
"192","AC131160.1",9,25,34,0.735294117647059,0.264705882352941,1
"193","AC132217.2",3,5,8,0.625,0.375,1
"194","AC134980.2",11,13,24,0.541666666666667,0.458333333333333,0.37
"195","AC136428.1",20,25,45,0.555555555555556,0.444444444444444,0.18
"196","AC139530.2",8,12,20,0.6,0.4,1
"197","AC144573.1",2,3,5,0.6,0.4,1
"198","AC231657.3",3,3,6,0.5,0.5,1
"199","AC242842.3",3,6,9,0.666666666666667,0.333333333333333,1
"200","AC244197.3",20,12,32,0.375,0.625,0.4
"201","AC244258.1",30,58,88,0.659090909090909,0.340909090909091,0.88
"202","AC245033.1",7,9,16,0.5625,0.4375,0.37
"203","AC245047.1",8,5,13,0.384615384615385,0.615384615384615,0.62
"204","AC245128.1",0,1,1,1,0,1
"205","AC245748.1",1,2,3,0.666666666666667,0.333333333333333,1
"206","AC245884.12",1,4,5,0.8,0.2,0.7
"207","AC253536.7",1,2,3,0.666666666666667,0.333333333333333,1
"208","ACAA1",8,22,30,0.733333333333333,0.266666666666667,0.75
"209","ACAA2",8,13,21,0.619047619047619,0.380952380952381,1
"210","ACACA",97,135,232,0.581896551724138,0.418103448275862,0.05
"211","ACACB",103,170,273,0.622710622710623,0.377289377289377,0.92
"212","ACAD10",38,56,94,0.595744680851064,0.404255319148936,0.48
"213","ACAD11",33,39,72,0.541666666666667,0.458333333333333,0.59
"214","ACAD8",15,16,31,0.516129032258065,0.483870967741935,0.61
"215","ACAD9",22,25,47,0.531914893617021,0.468085106382979,0.26
"216","ACADL",8,36,44,0.818181818181818,0.181818181818182,0.59
"217","ACADM",23,35,58,0.603448275862069,0.396551724137931,1
"218","ACADS",14,26,40,0.65,0.35,0.85
"219","ACADSB",15,20,35,0.571428571428571,0.428571428571429,0.58
"220","ACADVL",13,18,31,0.580645161290323,0.419354838709677,0.92
"221","ACAN",118,225,343,0.65597667638484,0.34402332361516,0.33
"222","ACAP1",38,32,70,0.457142857142857,0.542857142857143,0.29
"223","ACAP2",24,47,71,0.661971830985915,0.338028169014085,0.41
"224","ACAP3",12,37,49,0.755102040816326,0.244897959183673,0.85
"225","ACAT1",18,13,31,0.419354838709677,0.580645161290323,0.14
"226","ACAT2",10,17,27,0.62962962962963,0.37037037037037,1
"227","ACBD3",20,29,49,0.591836734693878,0.408163265306122,0.78
"228","ACBD4",8,17,25,0.68,0.32,0.6
"229","ACBD5",12,31,43,0.720930232558139,0.27906976744186,0.55
"230","ACBD6",5,15,20,0.75,0.25,0.94
"231","ACBD7",4,8,12,0.666666666666667,0.333333333333333,1
"232","ACCS",24,41,65,0.630769230769231,0.369230769230769,1
"233","ACCSL",30,44,74,0.594594594594595,0.405405405405405,0.13
"234","ACD",20,31,51,0.607843137254902,0.392156862745098,0.63
"235","ACE",51,93,144,0.645833333333333,0.354166666666667,0.57
"236","ACE2",45,26,71,0.366197183098592,0.633802816901408,0.6
"237","ACER1",15,29,44,0.659090909090909,0.340909090909091,0.7
"238","ACER2",7,18,25,0.72,0.28,0.61
"239","ACER3",2,16,18,0.888888888888889,0.111111111111111,0.87
"240","ACHE",25,37,62,0.596774193548387,0.403225806451613,0.67
"241","ACIN1",46,90,136,0.661764705882353,0.338235294117647,0.31
"242","ACKR1",25,46,71,0.647887323943662,0.352112676056338,1
"243","ACKR2",26,24,50,0.48,0.52,0.01
"244","ACKR3",19,39,58,0.672413793103448,0.327586206896552,0.89
"245","ACKR4",16,19,35,0.542857142857143,0.457142857142857,0.98
"246","ACLY",23,52,75,0.693333333333333,0.306666666666667,0.96
"247","ACMSD",19,36,55,0.654545454545455,0.345454545454545,0.68
"248","ACO1",30,40,70,0.571428571428571,0.428571428571429,0.58
"249","ACO2",21,29,50,0.58,0.42,0.68
"250","ACOD1",0,3,3,1,0,1
"251","ACOT1",2,13,15,0.866666666666667,0.133333333333333,0.72
"252","ACOT11",17,44,61,0.721311475409836,0.278688524590164,0.34
"253","ACOT12",24,51,75,0.68,0.32,0.23
"254","ACOT13",4,4,8,0.5,0.5,1
"255","ACOT2",9,15,24,0.625,0.375,1
"256","ACOT4",13,18,31,0.580645161290323,0.419354838709677,0.12
"257","ACOT6",3,15,18,0.833333333333333,0.166666666666667,1
"258","ACOT7",13,17,30,0.566666666666667,0.433333333333333,1
"259","ACOT8",9,19,28,0.678571428571429,0.321428571428571,0.77
"260","ACOT9",14,9,23,0.391304347826087,0.608695652173913,0.29
"261","ACOX1",16,35,51,0.686274509803922,0.313725490196078,0.95
"262","ACOX2",18,32,50,0.64,0.36,0.9
"263","ACOX3",31,48,79,0.607594936708861,0.392405063291139,0.89
"264","ACOXL",21,48,69,0.695652173913043,0.304347826086957,0.39
"265","ACP1",17,13,30,0.433333333333333,0.566666666666667,0.51
"266","ACP2",16,21,37,0.567567567567568,0.432432432432432,1
"267","ACP3",20,44,64,0.6875,0.3125,0.96
"268","ACP4",15,18,33,0.545454545454545,0.454545454545455,0.37
"269","ACP5",16,20,36,0.555555555555556,0.444444444444444,0.56
"270","ACP6",9,19,28,0.678571428571429,0.321428571428571,1
"271","ACP7",22,35,57,0.614035087719298,0.385964912280702,0.71
"272","ACR",13,14,27,0.518518518518518,0.481481481481481,0.37
"273","ACRBP",18,34,52,0.653846153846154,0.346153846153846,0.43
"274","ACRV1",10,14,24,0.583333333333333,0.416666666666667,0.36
"275","ACSBG1",42,59,101,0.584158415841584,0.415841584158416,0.52
"276","ACSBG2",29,48,77,0.623376623376623,0.376623376623377,0.94
"277","ACSF2",19,33,52,0.634615384615385,0.365384615384615,0.64
"278","ACSF3",16,33,49,0.673469387755102,0.326530612244898,0.19
"279","ACSL1",19,43,62,0.693548387096774,0.306451612903226,0.35
"280","ACSL3",33,27,60,0.45,0.55,0.01
"281","ACSL4",42,21,63,0.333333333333333,0.666666666666667,0.48
"282","ACSL5",33,39,72,0.541666666666667,0.458333333333333,0.27
"283","ACSL6",20,55,75,0.733333333333333,0.266666666666667,0.34
"284","ACSM1",42,69,111,0.621621621621622,0.378378378378378,1
"285","ACSM2A",56,112,168,0.666666666666667,0.333333333333333,0.83
"286","ACSM2B",51,127,178,0.713483146067416,0.286516853932584,0.78
"287","ACSM3",23,40,63,0.634920634920635,0.365079365079365,0.7
"288","ACSM4",34,81,115,0.704347826086957,0.295652173913043,0.68
"289","ACSM5",41,60,101,0.594059405940594,0.405940594059406,0.88
"290","ACSM6",5,16,21,0.761904761904762,0.238095238095238,0.41
"291","ACSS1",20,36,56,0.642857142857143,0.357142857142857,1
"292","ACSS2",24,32,56,0.571428571428571,0.428571428571429,0.32
"293","ACSS3",50,120,170,0.705882352941177,0.294117647058824,0.17
"294","ACTA1",23,36,59,0.610169491525424,0.389830508474576,1
"295","ACTA2",16,22,38,0.578947368421053,0.421052631578947,1
"296","ACTB",34,51,85,0.6,0.4,0.47
"297","ACTBL2",14,26,40,0.65,0.35,1
"298","ACTC1",29,54,83,0.650602409638554,0.349397590361446,0.91
"299","ACTG1",18,36,54,0.666666666666667,0.333333333333333,0.51
"300","ACTG2",28,40,68,0.588235294117647,0.411764705882353,0.38
"301","ACTL10",5,3,8,0.375,0.625,1
"302","ACTL6A",24,29,53,0.547169811320755,0.452830188679245,0.9
"303","ACTL6B",30,38,68,0.558823529411765,0.441176470588235,0.63
"304","ACTL7A",16,36,52,0.692307692307692,0.307692307692308,0.66
"305","ACTL7B",33,37,70,0.528571428571429,0.471428571428571,0.13
"306","ACTL8",23,43,66,0.651515151515151,0.348484848484849,0.62
"307","ACTL9",40,57,97,0.587628865979381,0.412371134020619,0.27
"308","ACTN1",34,42,76,0.552631578947368,0.447368421052632,0.57
"309","ACTN2",58,108,166,0.650602409638554,0.349397590361446,0.78
"310","ACTN3",26,49,75,0.653333333333333,0.346666666666667,0.58
"311","ACTN4",29,53,82,0.646341463414634,0.353658536585366,0.91
"312","ACTR10",14,20,34,0.588235294117647,0.411764705882353,0.58
"313","ACTR1A",15,15,30,0.5,0.5,0.23
"314","ACTR1B",12,25,37,0.675675675675676,0.324324324324324,0.93
"315","ACTR2",7,16,23,0.695652173913043,0.304347826086957,0.35
"316","ACTR3",15,12,27,0.444444444444444,0.555555555555556,0.09
"317","ACTR3B",15,27,42,0.642857142857143,0.357142857142857,0.63
"318","ACTR5",19,35,54,0.648148148148148,0.351851851851852,0.98
"319","ACTR6",8,28,36,0.777777777777778,0.222222222222222,1
"320","ACTR8",19,32,51,0.627450980392157,0.372549019607843,0.99
"321","ACTRT1",46,71,117,0.606837606837607,0.393162393162393,0.57
"322","ACTRT2",28,52,80,0.65,0.35,0.65
"323","ACTRT3",8,13,21,0.619047619047619,0.380952380952381,1
"324","ACVR1",15,31,46,0.673913043478261,0.326086956521739,0.54
"325","ACVR1B",45,57,102,0.558823529411765,0.441176470588235,0.12
"326","ACVR1C",32,36,68,0.529411764705882,0.470588235294118,0.43
"327","ACVR2A",110,111,221,0.502262443438914,0.497737556561086,0.6
"328","ACVR2B",25,26,51,0.509803921568627,0.490196078431373,0.08
"329","ACVRL1",25,45,70,0.642857142857143,0.357142857142857,0.92
"330","ACY1",0,2,2,1,0,1
"331","ACY3",14,19,33,0.575757575757576,0.424242424242424,1
"332","ACYP1",3,5,8,0.625,0.375,1
"333","ACYP2",2,5,7,0.714285714285714,0.285714285714286,1
"334","ADA",11,23,34,0.676470588235294,0.323529411764706,1
"335","ADA2",30,39,69,0.565217391304348,0.434782608695652,0.36
"336","ADAD1",58,77,135,0.57037037037037,0.42962962962963,0.1
"337","ADAD2",16,31,47,0.659574468085106,0.340425531914894,0.96
"338","ADAL",13,21,34,0.617647058823529,0.382352941176471,1
"339","ADAM10",26,53,79,0.670886075949367,0.329113924050633,0.16
"340","ADAM11",35,51,86,0.593023255813954,0.406976744186047,0.62
"341","ADAM12",42,80,122,0.655737704918033,0.344262295081967,0.21
"342","ADAM15",24,41,65,0.630769230769231,0.369230769230769,1
"343","ADAM17",30,37,67,0.552238805970149,0.447761194029851,0.11
"344","ADAM18",71,150,221,0.678733031674208,0.321266968325792,0.09
"345","ADAM19",45,84,129,0.651162790697674,0.348837209302326,0.91
"346","ADAM2",61,116,177,0.655367231638418,0.344632768361582,0.41
"347","ADAM20",16,56,72,0.777777777777778,0.222222222222222,0.34
"348","ADAM21",51,82,133,0.616541353383459,0.383458646616541,0.82
"349","ADAM22",50,103,153,0.673202614379085,0.326797385620915,0.02
"350","ADAM23",49,95,144,0.659722222222222,0.340277777777778,0.81
"351","ADAM28",47,111,158,0.70253164556962,0.29746835443038,0.05
"352","ADAM29",69,147,216,0.680555555555556,0.319444444444444,0.01
"353","ADAM30",37,81,118,0.686440677966102,0.313559322033898,0.26
"354","ADAM32",26,66,92,0.717391304347826,0.282608695652174,0.16
"355","ADAM33",27,52,79,0.658227848101266,0.341772151898734,1
"356","ADAM7",61,136,197,0.690355329949239,0.309644670050761,0.36
"357","ADAM8",20,32,52,0.615384615384615,0.384615384615385,1
"358","ADAM9",21,36,57,0.631578947368421,0.368421052631579,1
"359","ADAMDEC1",44,73,117,0.623931623931624,0.376068376068376,1
"360","ADAMTS1",46,55,101,0.544554455445545,0.455445544554455,1
"361","ADAMTS10",56,85,141,0.602836879432624,0.397163120567376,1
"362","ADAMTS12",189,273,462,0.590909090909091,0.409090909090909,1
"363","ADAMTS13",44,72,116,0.620689655172414,0.379310344827586,1
"364","ADAMTS14",50,98,148,0.662162162162162,0.337837837837838,1
"365","ADAMTS15",41,57,98,0.581632653061224,0.418367346938776,1
"366","ADAMTS16",116,191,307,0.622149837133551,0.37785016286645,1
"367","ADAMTS17",51,70,121,0.578512396694215,0.421487603305785,1
"368","ADAMTS18",108,222,330,0.672727272727273,0.327272727272727,1
"369","ADAMTS19",72,157,229,0.685589519650655,0.314410480349345,1
"370","ADAMTS2",87,134,221,0.606334841628959,0.393665158371041,1
"371","ADAMTS20",132,264,396,0.666666666666667,0.333333333333333,1
"372","ADAMTS3",71,117,188,0.622340425531915,0.377659574468085,1
"373","ADAMTS4",34,68,102,0.666666666666667,0.333333333333333,1
"374","ADAMTS5",63,111,174,0.637931034482759,0.362068965517241,1
"375","ADAMTS6",75,122,197,0.619289340101523,0.380710659898477,1
"376","ADAMTS7",69,86,155,0.554838709677419,0.445161290322581,1
"377","ADAMTS8",28,60,88,0.681818181818182,0.318181818181818,1
"378","ADAMTS9",84,162,246,0.658536585365854,0.341463414634146,1
"379","ADAMTSL1",78,125,203,0.61576354679803,0.38423645320197,1
"380","ADAMTSL2",40,50,90,0.555555555555556,0.444444444444444,1
"381","ADAMTSL3",85,183,268,0.682835820895522,0.317164179104478,1
"382","ADAMTSL4",49,56,105,0.533333333333333,0.466666666666667,1
"383","ADAMTSL5",13,22,35,0.628571428571429,0.371428571428571,1
"384","ADAP1",13,10,23,0.434782608695652,0.565217391304348,0.53
"385","ADAP2",10,25,35,0.714285714285714,0.285714285714286,0.95
"386","ADAR",37,66,103,0.640776699029126,0.359223300970874,0.77
"387","ADARB1",28,47,75,0.626666666666667,0.373333333333333,0.77
"388","ADARB2",27,73,100,0.73,0.27,0.77
"389","ADAT1",22,27,49,0.551020408163265,0.448979591836735,0.42
"390","ADAT2",4,13,17,0.764705882352941,0.235294117647059,0.74
"391","ADAT3",4,5,9,0.555555555555556,0.444444444444444,1
"392","ADCK1",34,38,72,0.527777777777778,0.472222222222222,0.04
"393","ADCK2",16,24,40,0.6,0.4,0.8
"394","ADCK5",17,16,33,0.484848484848485,0.515151515151515,1
"395","ADCY1",84,124,208,0.596153846153846,0.403846153846154,0.32
"396","ADCY10",98,120,218,0.55045871559633,0.44954128440367,0.08
"397","ADCY2",94,140,234,0.598290598290598,0.401709401709402,0.62
"398","ADCY3",35,58,93,0.623655913978495,0.376344086021505,1
"399","ADCY4",35,63,98,0.642857142857143,0.357142857142857,0.85
"400","ADCY5",68,98,166,0.590361445783133,0.409638554216867,0.91
"401","ADCY6",38,66,104,0.634615384615385,0.365384615384615,0.86
"402","ADCY7",45,52,97,0.536082474226804,0.463917525773196,0.42
"403","ADCY8",122,224,346,0.647398843930636,0.352601156069364,0.86
"404","ADCY9",38,74,112,0.660714285714286,0.339285714285714,0.93
"405","ADCYAP1",8,18,26,0.692307692307692,0.307692307692308,0.93
"406","ADCYAP1R1",39,70,109,0.642201834862385,0.357798165137615,0.63
"407","ADD1",23,38,61,0.622950819672131,0.377049180327869,1
"408","ADD2",44,89,133,0.669172932330827,0.330827067669173,0.76
"409","ADD3",51,52,103,0.504854368932039,0.495145631067961,0.01
"410","ADGB",1,14,15,0.933333333333333,0.0666666666666667,0.54
"411","ADGRA1",31,52,83,0.626506024096386,0.373493975903614,0.77
"412","ADGRA2",39,61,100,0.61,0.39,0.66
"413","ADGRA3",58,75,133,0.56390977443609,0.43609022556391,0.02
"414","ADGRB1",56,101,157,0.643312101910828,0.356687898089172,0.63
"415","ADGRB2",44,83,127,0.653543307086614,0.346456692913386,0.73
"416","ADGRB3",147,318,465,0.683870967741935,0.316129032258064,0.04
"417","ADGRD1",46,90,136,0.661764705882353,0.338235294117647,0.98
"418","ADGRD2",1,3,4,0.75,0.25,0.57
"419","ADGRE1",44,113,157,0.719745222929936,0.280254777070064,0.32
"420","ADGRE2",37,56,93,0.602150537634409,0.397849462365591,0.7
"421","ADGRE3",39,59,98,0.602040816326531,0.397959183673469,0.68
"422","ADGRE4P",8,27,35,0.771428571428571,0.228571428571429,0.64
"423","ADGRE5",27,46,73,0.63013698630137,0.36986301369863,0.92
"424","ADGRF1",35,75,110,0.681818181818182,0.318181818181818,0.23
"425","ADGRF2",34,47,81,0.580246913580247,0.419753086419753,0.34
"426","ADGRF3",22,23,45,0.511111111111111,0.488888888888889,0.06
"427","ADGRF4",40,74,114,0.649122807017544,0.350877192982456,0.52
"428","ADGRF5",50,111,161,0.68944099378882,0.31055900621118,0.81
"429","ADGRG1",14,29,43,0.674418604651163,0.325581395348837,0.41
"430","ADGRG2",54,49,103,0.475728155339806,0.524271844660194,0.95
"431","ADGRG3",31,42,73,0.575342465753425,0.424657534246575,0.5
"432","ADGRG4",241,256,497,0.515090543259557,0.484909456740443,0.74
"433","ADGRG5",22,37,59,0.627118644067797,0.372881355932203,0.99
"434","ADGRG6",45,53,98,0.540816326530612,0.459183673469388,0.21
"435","ADGRG7",54,53,107,0.495327102803738,0.504672897196262,0.07
"436","ADGRL1",55,57,112,0.508928571428571,0.491071428571429,0.32
"437","ADGRL2",103,195,298,0.654362416107383,0.345637583892617,0.55
"438","ADGRL3",103,211,314,0.671974522292994,0.328025477707006,0.07
"439","ADGRL4",68,155,223,0.695067264573991,0.304932735426009,0.25
"440","ADGRV1",307,554,861,0.643437862950058,0.356562137049942,0.27
"441","ADH1A",26,42,68,0.617647058823529,0.382352941176471,1
"442","ADH1B",39,57,96,0.59375,0.40625,0.86
"443","ADH1C",31,61,92,0.66304347826087,0.33695652173913,0.48
"444","ADH4",14,27,41,0.658536585365854,0.341463414634146,1
"445","ADH5",7,22,29,0.758620689655172,0.241379310344828,0.96
"446","ADH6",30,34,64,0.53125,0.46875,0.44
"447","ADH7",14,41,55,0.745454545454545,0.254545454545455,0.43
"448","ADHFE1",14,36,50,0.72,0.28,0.97
"449","ADI1",4,8,12,0.666666666666667,0.333333333333333,1
"450","ADIG",4,7,11,0.636363636363636,0.363636363636364,1
"451","ADIPOQ",10,27,37,0.72972972972973,0.27027027027027,0.48
"452","ADIPOR1",15,29,44,0.659090909090909,0.340909090909091,0.98
"453","ADIPOR2",10,23,33,0.696969696969697,0.303030303030303,0.95
"454","ADIRF",2,3,5,0.6,0.4,1
"455","ADK",11,17,28,0.607142857142857,0.392857142857143,1
"456","ADM",13,12,25,0.48,0.52,1
"457","ADM2",3,7,10,0.7,0.3,1
"458","ADM5",2,2,4,0.5,0.5,1
"459","ADNP",47,68,115,0.591304347826087,0.408695652173913,0.33
"460","ADNP2",46,64,110,0.581818181818182,0.418181818181818,0.42
"461","ADO",2,7,9,0.777777777777778,0.222222222222222,0.74
"462","ADORA1",23,27,50,0.54,0.46,0.1
"463","ADORA2A",10,28,38,0.736842105263158,0.263157894736842,0.29
"464","ADORA2B",3,9,12,0.75,0.25,0.74
"465","ADORA3",11,19,30,0.633333333333333,0.366666666666667,0.87
"466","ADPGK",16,8,24,0.333333333333333,0.666666666666667,0.73
"467","ADPRH",16,15,31,0.483870967741935,0.516129032258065,0.48
"468","ADPRHL1",11,18,29,0.620689655172414,0.379310344827586,1
"469","ADPRM",13,19,32,0.59375,0.40625,0.55
"470","ADPRS",9,16,25,0.64,0.36,1
"471","ADRA1A",37,47,84,0.55952380952381,0.44047619047619,0.9
"472","ADRA1B",15,27,42,0.642857142857143,0.357142857142857,0.6
"473","ADRA1D",14,31,45,0.688888888888889,0.311111111111111,0.94
"474","ADRA2A",17,21,38,0.552631578947368,0.447368421052632,0.46
"475","ADRA2B",24,24,48,0.5,0.5,0.65
"476","ADRA2C",6,23,29,0.793103448275862,0.206896551724138,0.99
"477","ADRB1",8,23,31,0.741935483870968,0.258064516129032,0.53
"478","ADRB2",20,21,41,0.51219512195122,0.48780487804878,0.63
"479","ADRB3",10,20,30,0.666666666666667,0.333333333333333,1
"480","ADRM1",11,11,22,0.5,0.5,1
"481","ADSL",16,26,42,0.619047619047619,0.380952380952381,1
"482","ADSS1",20,32,52,0.615384615384615,0.384615384615385,1
"483","ADSS2",10,30,40,0.75,0.25,0.33
"484","ADTRP",10,15,25,0.6,0.4,1
"485","AEBP1",60,51,111,0.459459459459459,0.540540540540541,0.12
"486","AEBP2",12,9,21,0.428571428571429,0.571428571428571,0.25
"487","AEN",10,11,21,0.523809523809524,0.476190476190476,0.5
"488","AF196969.1",3,5,8,0.625,0.375,1
"489","AFAP1",26,40,66,0.606060606060606,0.393939393939394,0.87
"490","AFAP1L1",22,49,71,0.690140845070423,0.309859154929577,0.73
"491","AFAP1L2",25,31,56,0.553571428571429,0.446428571428571,1
"492","AFDN",69,109,178,0.612359550561798,0.387640449438202,0.89
"493","AFF1",35,79,114,0.692982456140351,0.307017543859649,0.66
"494","AFF2",158,145,303,0.478547854785479,0.521452145214521,0.39
"495","AFF3",66,122,188,0.648936170212766,0.351063829787234,0.98
"496","AFF4",40,87,127,0.68503937007874,0.31496062992126,0.57
"497","AFG1L",18,24,42,0.571428571428571,0.428571428571429,0.85
"498","AFG3L2",15,34,49,0.693877551020408,0.306122448979592,0.35
"499","AFM",44,53,97,0.54639175257732,0.45360824742268,0.92
"500","AFMID",14,18,32,0.5625,0.4375,0.58
"501","AFP",30,55,85,0.647058823529412,0.352941176470588,0.72
"502","AFTPH",30,44,74,0.594594594594595,0.405405405405405,0.74
"503","AGA",19,32,51,0.627450980392157,0.372549019607843,0.9
"504","AGAP1",46,77,123,0.626016260162602,0.373983739837398,0.87
"505","AGAP14P",0,1,1,1,0,1
"506","AGAP2",24,55,79,0.69620253164557,0.30379746835443,0.25
"507","AGAP3",39,51,90,0.566666666666667,0.433333333333333,0.39
"508","AGAP4",18,28,46,0.608695652173913,0.391304347826087,0.32
"509","AGAP5",0,1,1,1,0,1
"510","AGAP6",22,29,51,0.568627450980392,0.431372549019608,0.61
"511","AGAP7P",36,80,116,0.689655172413793,0.310344827586207,0.37
"512","AGBL1",63,116,179,0.64804469273743,0.35195530726257,0.4
"513","AGBL2",30,56,86,0.651162790697674,0.348837209302326,0.46
"514","AGBL3",0,7,7,1,0,1
"515","AGBL4",10,14,24,0.583333333333333,0.416666666666667,0.68
"516","AGBL5",36,53,89,0.595505617977528,0.404494382022472,0.8
"517","AGER",5,20,25,0.8,0.2,0.6
"518","AGFG1",17,23,40,0.575,0.425,0.29
"519","AGFG2",15,23,38,0.605263157894737,0.394736842105263,1
"520","AGGF1",27,47,74,0.635135135135135,0.364864864864865,0.5
"521","AGK",21,21,42,0.5,0.5,0.23
"522","AGL",50,102,152,0.671052631578947,0.328947368421053,0.62
"523","AGMAT",13,16,29,0.551724137931034,0.448275862068966,1
"524","AGMO",43,59,102,0.57843137254902,0.42156862745098,0.04
"525","AGO1",43,66,109,0.605504587155963,0.394495412844037,0.82
"526","AGO2",46,48,94,0.51063829787234,0.48936170212766,0.87
"527","AGO3",24,62,86,0.720930232558139,0.27906976744186,0.58
"528","AGO4",28,49,77,0.636363636363636,0.363636363636364,0.73
"529","AGPAT1",14,21,35,0.6,0.4,0.69
"530","AGPAT2",10,10,20,0.5,0.5,0.5
"531","AGPAT3",17,20,37,0.540540540540541,0.459459459459459,0.17
"532","AGPAT4",21,28,49,0.571428571428571,0.428571428571429,0.24
"533","AGPAT5",15,14,29,0.482758620689655,0.517241379310345,0.84
"534","AGPS",17,34,51,0.666666666666667,0.333333333333333,0.86
"535","AGR2",2,15,17,0.882352941176471,0.117647058823529,0.93
"536","AGR3",6,17,23,0.739130434782609,0.260869565217391,0.43
"537","AGRN",60,75,135,0.555555555555556,0.444444444444444,0.13
"538","AGRP",5,4,9,0.444444444444444,0.555555555555556,1
"539","AGT",18,39,57,0.684210526315789,0.315789473684211,0.88
"540","AGTPBP1",42,66,108,0.611111111111111,0.388888888888889,0.87
"541","AGTR1",23,59,82,0.719512195121951,0.280487804878049,0.39
"542","AGTR2",35,36,71,0.507042253521127,0.492957746478873,0.3
"543","AGTRAP",4,10,14,0.714285714285714,0.285714285714286,1
"544","AGXT",22,23,45,0.511111111111111,0.488888888888889,0.54
"545","AGXT2",40,67,107,0.626168224299065,0.373831775700935,0.89
"546","AHCTF1",78,121,199,0.608040201005025,0.391959798994975,0.4
"547","AHCY",15,22,37,0.594594594594595,0.405405405405405,0.68
"548","AHCYL1",21,24,45,0.533333333333333,0.466666666666667,0.53
"549","AHCYL2",18,43,61,0.704918032786885,0.295081967213115,0.33
"550","AHDC1",47,92,139,0.661870503597122,0.338129496402878,0.83
"551","AHI1",38,51,89,0.573033707865168,0.426966292134831,0.73
"552","AHNAK",197,365,562,0.649466192170818,0.350533807829181,0.8
"553","AHNAK2",258,403,661,0.609682299546142,0.390317700453858,1
"554","AHR",49,62,111,0.558558558558559,0.441441441441441,0.3
"555","AHRR",27,37,64,0.578125,0.421875,0.02
"556","AHSA1",10,15,25,0.6,0.4,1
"557","AHSG",17,46,63,0.73015873015873,0.26984126984127,0.15
"558","AHSP",4,10,14,0.714285714285714,0.285714285714286,0.64
"559","AICDA",20,33,53,0.622641509433962,0.377358490566038,1
"560","AIDA",10,20,30,0.666666666666667,0.333333333333333,0.88
"561","AIF1",8,4,12,0.333333333333333,0.666666666666667,1
"562","AIF1L",3,2,5,0.4,0.6,1
"563","AIFM1",36,18,54,0.333333333333333,0.666666666666667,0.25
"564","AIFM2",5,18,23,0.782608695652174,0.217391304347826,0.97
"565","AIFM3",22,34,56,0.607142857142857,0.392857142857143,1
"566","AIG1",6,5,11,0.454545454545455,0.545454545454545,0.49
"567","AIM2",23,40,63,0.634920634920635,0.365079365079365,1
"568","AIMP1",9,10,19,0.526315789473684,0.473684210526316,0.77
"569","AIMP2",10,20,30,0.666666666666667,0.333333333333333,0.34
"570","AIP",6,12,18,0.666666666666667,0.333333333333333,1
"571","AIPL1",13,25,38,0.657894736842105,0.342105263157895,0.97
"572","AIRE",19,33,52,0.634615384615385,0.365384615384615,0.78
"573","AJAP1",30,44,74,0.594594594594595,0.405405405405405,0.3
"574","AJM1",17,29,46,0.630434782608696,0.369565217391304,0.9
"575","AJUBA",22,43,65,0.661538461538462,0.338461538461538,0.58
"576","AK1",3,9,12,0.75,0.25,1
"577","AK2",3,12,15,0.8,0.2,1
"578","AK3",8,6,14,0.428571428571429,0.571428571428571,0.54
"579","AK4",7,7,14,0.5,0.5,1
"580","AK5",41,65,106,0.613207547169811,0.386792452830189,0.95
"581","AK6",3,2,5,0.4,0.6,1
"582","AK7",31,63,94,0.670212765957447,0.329787234042553,0.58
"583","AK8",13,30,43,0.697674418604651,0.302325581395349,0.09
"584","AK9",36,102,138,0.739130434782609,0.260869565217391,0.54
"585","AKAP1",28,39,67,0.582089552238806,0.417910447761194,0.8
"586","AKAP10",16,21,37,0.567567567567568,0.432432432432432,0.46
"587","AKAP11",47,104,151,0.688741721854305,0.311258278145695,0.65
"588","AKAP12",54,99,153,0.647058823529412,0.352941176470588,0.29
"589","AKAP13",84,146,230,0.634782608695652,0.365217391304348,0.81
"590","AKAP14",17,10,27,0.37037037037037,0.62962962962963,0.79
"591","AKAP17A",34,35,69,0.507246376811594,0.492753623188406,0.68
"592","AKAP3",39,88,127,0.692913385826772,0.307086614173228,0.84
"593","AKAP4",70,53,123,0.430894308943089,0.569105691056911,0.58
"594","AKAP5",15,16,31,0.516129032258065,0.483870967741935,0.68
"595","AKAP6",96,236,332,0.710843373493976,0.289156626506024,0.52
"596","AKAP7",36,24,60,0.4,0.6,0.36
"597","AKAP8",19,29,48,0.604166666666667,0.395833333333333,0.83
"598","AKAP8L",21,27,48,0.5625,0.4375,1
"599","AKAP9",151,235,386,0.60880829015544,0.39119170984456,0.79
"600","AKIP1",8,7,15,0.466666666666667,0.533333333333333,1
"601","AKIRIN1",1,3,4,0.75,0.25,1
"602","AKIRIN2",12,8,20,0.4,0.6,0.13
"603","AKNA",32,78,110,0.709090909090909,0.290909090909091,0.74
"604","AKNAD1",28,59,87,0.67816091954023,0.32183908045977,0.31
"605","AKR1A1",6,17,23,0.739130434782609,0.260869565217391,1
"606","AKR1B1",18,16,34,0.470588235294118,0.529411764705882,0.21
"607","AKR1B10",14,39,53,0.735849056603774,0.264150943396226,0.36
"608","AKR1B15",19,43,62,0.693548387096774,0.306451612903226,0.48
"609","AKR1C1",18,13,31,0.419354838709677,0.580645161290323,0.65
"610","AKR1C2",14,13,27,0.481481481481481,0.518518518518518,0.04
"611","AKR1C3",13,27,40,0.675,0.325,0.36
"612","AKR1C4",22,30,52,0.576923076923077,0.423076923076923,0.03
"613","AKR1C8P",11,17,28,0.607142857142857,0.392857142857143,0.45
"614","AKR1D1",24,53,77,0.688311688311688,0.311688311688312,0.77
"615","AKR1E2",12,20,32,0.625,0.375,1
"616","AKR7A2",10,19,29,0.655172413793103,0.344827586206897,0.57
"617","AKR7A3",15,16,31,0.516129032258065,0.483870967741935,1
"618","AKR7L",6,7,13,0.538461538461538,0.461538461538462,0.75
"619","AKT1",22,22,44,0.5,0.5,1
"620","AKT1S1",7,12,19,0.631578947368421,0.368421052631579,1
"621","AKT2",19,38,57,0.666666666666667,0.333333333333333,0.61
"622","AKT3",18,44,62,0.709677419354839,0.290322580645161,0.56
"623","AKTIP",9,12,21,0.571428571428571,0.428571428571429,0.56
"624","AL021546.1",0,2,2,1,0,1
"625","AL031315.1",1,0,1,0,1,1
"626","AL031681.2",5,1,6,0.166666666666667,0.833333333333333,0.72
"627","AL031777.2",13,21,34,0.617647058823529,0.382352941176471,1
"628","AL035460.1",4,4,8,0.5,0.5,1
"629","AL035461.3",6,6,12,0.5,0.5,0.76
"630","AL049569.3",1,6,7,0.857142857142857,0.142857142857143,1
"631","AL117348.2",3,3,6,0.5,0.5,1
"632","AL121758.1",0,2,2,1,0,1
"633","AL121845.3",1,0,1,0,1,1
"634","AL121899.2",47,69,116,0.594827586206897,0.405172413793103,0.29
"635","AL133373.3",4,2,6,0.333333333333333,0.666666666666667,1
"636","AL133467.6",7,10,17,0.588235294117647,0.411764705882353,1
"637","AL133500.1",5,3,8,0.375,0.625,1
"638","AL135905.2",1,0,1,0,1,1
"639","AL136295.1",23,34,57,0.596491228070175,0.403508771929825,0.58
"640","AL136982.4",40,64,104,0.615384615384615,0.384615384615385,1
"641","AL138831.3",0,2,2,1,0,1
"642","AL139300.1",1,0,1,0,1,1
"643","AL159163.1",1,0,1,0,1,1
"644","AL162417.1",5,6,11,0.545454545454545,0.454545454545455,1
"645","AL163195.3",3,0,3,0,1,1
"646","AL163540.1",4,11,15,0.733333333333333,0.266666666666667,1
"647","AL163636.1",0,2,2,1,0,1
"648","AL353804.4",0,1,1,1,0,1
"649","AL353804.6",0,2,2,1,0,1
"650","AL358113.1",4,8,12,0.666666666666667,0.333333333333333,1
"651","AL359922.1",1,4,5,0.8,0.2,1
"652","AL391650.1",0,1,1,1,0,1
"653","AL441992.2",13,20,33,0.606060606060606,0.393939393939394,1
"654","AL445524.2",1,0,1,0,1,1
"655","AL512625.1",0,1,1,1,0,1
"656","AL590867.2",32,46,78,0.58974358974359,0.41025641025641,0.57
"657","AL592490.1",64,117,181,0.646408839779006,0.353591160220994,0.88
"658","AL645922.1",40,82,122,0.672131147540984,0.327868852459016,0.57
"659","AL645941.2",0,1,1,1,0,1
"660","AL662899.2",5,7,12,0.583333333333333,0.416666666666667,1
"661","AL669918.1",8,12,20,0.6,0.4,1
"662","AL713999.2",2,3,5,0.6,0.4,1
"663","ALAD",13,18,31,0.580645161290323,0.419354838709677,0.4
"664","ALAS1",20,28,48,0.583333333333333,0.416666666666667,0.51
"665","ALAS2",40,30,70,0.428571428571429,0.571428571428571,0.5
"666","ALB",56,122,178,0.685393258426966,0.314606741573034,0.86
"667","ALCAM",26,47,73,0.643835616438356,0.356164383561644,0.22
"668","ALDH16A1",22,54,76,0.710526315789474,0.289473684210526,0.97
"669","ALDH18A1",26,32,58,0.551724137931034,0.448275862068966,0.21
"670","ALDH1A1",24,23,47,0.48936170212766,0.51063829787234,0.37
"671","ALDH1A2",32,58,90,0.644444444444444,0.355555555555556,0.6
"672","ALDH1A3",27,28,55,0.509090909090909,0.490909090909091,0.98
"673","ALDH1B1",44,45,89,0.50561797752809,0.49438202247191,0.1
"674","ALDH1L1",43,77,120,0.641666666666667,0.358333333333333,0.69
"675","ALDH1L2",24,57,81,0.703703703703704,0.296296296296296,0.26
"676","ALDH2",15,29,44,0.659090909090909,0.340909090909091,0.77
"677","ALDH3A1",21,43,64,0.671875,0.328125,0.13
"678","ALDH3A2",19,13,32,0.40625,0.59375,0.65
"679","ALDH3B1",15,11,26,0.423076923076923,0.576923076923077,0.07
"680","ALDH3B2",11,26,37,0.702702702702703,0.297297297297297,1
"681","ALDH4A1",15,21,36,0.583333333333333,0.416666666666667,0.72
"682","ALDH5A1",17,27,44,0.613636363636364,0.386363636363636,1
"683","ALDH6A1",15,23,38,0.605263157894737,0.394736842105263,1
"684","ALDH7A1",10,22,32,0.6875,0.3125,0.5
"685","ALDH8A1",29,42,71,0.591549295774648,0.408450704225352,0.81
"686","ALDH9A1",13,26,39,0.666666666666667,0.333333333333333,1
"687","ALDOA",8,14,22,0.636363636363636,0.363636363636364,1
"688","ALDOB",28,44,72,0.611111111111111,0.388888888888889,1
"689","ALDOC",15,10,25,0.4,0.6,0.62
"690","ALG1",13,18,31,0.580645161290323,0.419354838709677,1
"691","ALG10",31,53,84,0.630952380952381,0.369047619047619,0.9
"692","ALG10B",26,40,66,0.606060606060606,0.393939393939394,0.57
"693","ALG11",23,28,51,0.549019607843137,0.450980392156863,0.14
"694","ALG12",14,19,33,0.575757575757576,0.424242424242424,0.39
"695","ALG13",51,39,90,0.433333333333333,0.566666666666667,0.91
"696","ALG14",3,12,15,0.8,0.2,0.98
"697","ALG1L",4,8,12,0.666666666666667,0.333333333333333,1
"698","ALG1L2",0,1,1,1,0,1
"699","ALG2",13,21,34,0.617647058823529,0.382352941176471,1
"700","ALG3",13,16,29,0.551724137931034,0.448275862068966,0.73
"701","ALG5",15,20,35,0.571428571428571,0.428571428571429,0.09
"702","ALG6",17,19,36,0.527777777777778,0.472222222222222,0.06
"703","ALG8",25,22,47,0.468085106382979,0.531914893617021,0.58
"704","ALG9",18,19,37,0.513513513513513,0.486486486486487,0.49
"705","ALK",73,153,226,0.676991150442478,0.323008849557522,0.29
"706","ALKAL1",4,14,18,0.777777777777778,0.222222222222222,0.74
"707","ALKAL2",2,2,4,0.5,0.5,1
"708","ALKBH1",18,23,41,0.560975609756098,0.439024390243902,1
"709","ALKBH2",8,14,22,0.636363636363636,0.363636363636364,1
"710","ALKBH3",12,13,25,0.52,0.48,0.46
"711","ALKBH4",12,15,27,0.555555555555556,0.444444444444444,0.41
"712","ALKBH5",13,15,28,0.535714285714286,0.464285714285714,1
"713","ALKBH6",11,12,23,0.521739130434783,0.478260869565217,1
"714","ALKBH7",4,7,11,0.636363636363636,0.363636363636364,1
"715","ALKBH8",10,17,27,0.62962962962963,0.37037037037037,1
"716","ALLC",26,50,76,0.657894736842105,0.342105263157895,0.78
"717","ALMS1",157,261,418,0.624401913875598,0.375598086124402,1
"718","ALOX12",23,25,48,0.520833333333333,0.479166666666667,0.3
"719","ALOX12B",23,57,80,0.7125,0.2875,0.61
"720","ALOX15",24,27,51,0.529411764705882,0.470588235294118,0.45
"721","ALOX15B",18,51,69,0.739130434782609,0.260869565217391,0.72
"722","ALOX5",28,69,97,0.711340206185567,0.288659793814433,0.55
"723","ALOX5AP",7,4,11,0.363636363636364,0.636363636363636,0.59
"724","ALOXE3",25,46,71,0.647887323943662,0.352112676056338,0.83
"725","ALPG",16,35,51,0.686274509803922,0.313725490196078,0.8
"726","ALPI",25,37,62,0.596774193548387,0.403225806451613,0.31
"727","ALPK1",69,79,148,0.533783783783784,0.466216216216216,0.15
"728","ALPK2",115,204,319,0.639498432601881,0.360501567398119,0.4
"729","ALPK3",82,116,198,0.585858585858586,0.414141414141414,0.37
"730","ALPL",28,31,59,0.525423728813559,0.474576271186441,0.45
"731","ALPP",30,40,70,0.571428571428571,0.428571428571429,0.74
"732","ALS2",61,82,143,0.573426573426573,0.426573426573427,0.09
"733","ALS2CL",23,44,67,0.656716417910448,0.343283582089552,0.5
"734","ALX1",16,34,50,0.68,0.32,0.23
"735","ALX3",7,23,30,0.766666666666667,0.233333333333333,0.7
"736","ALX4",31,39,70,0.557142857142857,0.442857142857143,0.29
"737","ALYREF",8,14,22,0.636363636363636,0.363636363636364,1
"738","AMACR",23,19,42,0.452380952380952,0.547619047619048,0.47
"739","AMBN",23,45,68,0.661764705882353,0.338235294117647,0.9
"740","AMBP",16,22,38,0.578947368421053,0.421052631578947,0.45
"741","AMBRA1",56,75,131,0.572519083969466,0.427480916030534,0.38
"742","AMD1",11,22,33,0.666666666666667,0.333333333333333,0.29
"743","AMDHD1",17,27,44,0.613636363636364,0.386363636363636,1
"744","AMDHD2",13,23,36,0.638888888888889,0.361111111111111,1
"745","AMELX",23,9,32,0.28125,0.71875,0.71
"746","AMELY",0,6,6,1,0,1
"747","AMER1",142,94,236,0.398305084745763,0.601694915254237,0.12
"748","AMER2",39,47,86,0.546511627906977,0.453488372093023,0.81
"749","AMER3",52,146,198,0.737373737373737,0.262626262626263,0.18
"750","AMFR",21,29,50,0.58,0.42,0.74
"751","AMH",2,11,13,0.846153846153846,0.153846153846154,1
"752","AMHR2",35,29,64,0.453125,0.546875,0.59
"753","AMIGO1",17,21,38,0.552631578947368,0.447368421052632,0.83
"754","AMIGO2",19,40,59,0.677966101694915,0.322033898305085,0.92
"755","AMIGO3",19,29,48,0.604166666666667,0.395833333333333,0.74
"756","AMMECR1",24,8,32,0.25,0.75,0.76
"757","AMMECR1L",10,24,34,0.705882352941177,0.294117647058824,0.77
"758","AMN",4,19,23,0.826086956521739,0.173913043478261,0.84
"759","AMN1",5,8,13,0.615384615384615,0.384615384615385,1
"760","AMOT",60,40,100,0.4,0.6,0.72
"761","AMOTL1",39,63,102,0.617647058823529,0.382352941176471,0.93
"762","AMOTL2",19,48,67,0.716417910447761,0.283582089552239,0.32
"763","AMPD1",51,95,146,0.650684931506849,0.349315068493151,0.73
"764","AMPD2",18,50,68,0.735294117647059,0.264705882352941,0.59
"765","AMPD3",35,68,103,0.660194174757282,0.339805825242718,0.02
"766","AMPH",58,120,178,0.674157303370786,0.325842696629214,0.59
"767","AMT",5,6,11,0.545454545454545,0.454545454545455,1
"768","AMTN",11,26,37,0.702702702702703,0.297297297297297,0.53
"769","AMY1A",3,8,11,0.727272727272727,0.272727272727273,0.67
"770","AMY1B",4,5,9,0.555555555555556,0.444444444444444,0.42
"771","AMY1C",15,26,41,0.634146341463415,0.365853658536585,0.52
"772","AMY2A",33,58,91,0.637362637362637,0.362637362637363,0.71
"773","AMY2B",41,71,112,0.633928571428571,0.366071428571429,0.67
"774","AMZ1",17,29,46,0.630434782608696,0.369565217391304,0.6
"775","AMZ2",7,23,30,0.766666666666667,0.233333333333333,0.75
"776","ANAPC1",40,86,126,0.682539682539683,0.317460317460317,0.39
"777","ANAPC10",10,2,12,0.166666666666667,0.833333333333333,0.39
"778","ANAPC11",2,2,4,0.5,0.5,0.39
"779","ANAPC13",0,3,3,1,0,0.39
"780","ANAPC15",3,6,9,0.666666666666667,0.333333333333333,0.39
"781","ANAPC16",2,5,7,0.714285714285714,0.285714285714286,0.39
"782","ANAPC2",29,36,65,0.553846153846154,0.446153846153846,0.88
"783","ANAPC4",11,44,55,0.8,0.2,0.39
"784","ANAPC5",31,36,67,0.537313432835821,0.462686567164179,0.39
"785","ANAPC7",17,25,42,0.595238095238095,0.404761904761905,0.39
"786","ANG",6,6,12,0.5,0.5,0.11
"787","ANGEL1",21,45,66,0.681818181818182,0.318181818181818,0.86
"788","ANGEL2",11,20,31,0.645161290322581,0.354838709677419,0.76
"789","ANGPT1",32,92,124,0.741935483870968,0.258064516129032,0.05
"790","ANGPT2",23,37,60,0.616666666666667,0.383333333333333,1
"791","ANGPT4",31,56,87,0.64367816091954,0.35632183908046,0.55
"792","ANGPTL1",15,39,54,0.722222222222222,0.277777777777778,0.29
"793","ANGPTL2",16,36,52,0.692307692307692,0.307692307692308,0.85
"794","ANGPTL3",12,12,24,0.5,0.5,1
"795","ANGPTL4",12,23,35,0.657142857142857,0.342857142857143,0.83
"796","ANGPTL5",22,42,64,0.65625,0.34375,0.9
"797","ANGPTL6",9,16,25,0.64,0.36,0.57
"798","ANGPTL7",9,22,31,0.709677419354839,0.290322580645161,0.96
"799","ANGPTL8",1,11,12,0.916666666666667,0.0833333333333333,1
"800","ANK1",131,198,329,0.601823708206687,0.398176291793313,0.44
"801","ANK2",239,366,605,0.60495867768595,0.39504132231405,0.21
"802","ANK3",246,466,712,0.654494382022472,0.345505617977528,0.14
"803","ANKAR",45,73,118,0.61864406779661,0.38135593220339,0.77
"804","ANKDD1A",12,33,45,0.733333333333333,0.266666666666667,0.99
"805","ANKEF1",41,62,103,0.601941747572815,0.398058252427184,0.51
"806","ANKFN1",47,81,128,0.6328125,0.3671875,0.67
"807","ANKFY1",26,45,71,0.633802816901408,0.366197183098592,0.96
"808","ANKH",19,36,55,0.654545454545455,0.345454545454545,0.86
"809","ANKHD1",3,2,5,0.4,0.6,1
"810","ANKHD1-EIF4EBP3",81,132,213,0.619718309859155,0.380281690140845,0.88
"811","ANKIB1",37,65,102,0.637254901960784,0.362745098039216,0.6
"812","ANKK1",30,37,67,0.552238805970149,0.447761194029851,0.24
"813","ANKLE1",16,29,45,0.644444444444444,0.355555555555556,0.47
"814","ANKLE2",30,55,85,0.647058823529412,0.352941176470588,0.95
"815","ANKMY1",31,58,89,0.651685393258427,0.348314606741573,0.71
"816","ANKMY2",21,25,46,0.543478260869565,0.456521739130435,0.93
"817","ANKRA2",11,13,24,0.541666666666667,0.458333333333333,0.19
"818","ANKRD1",17,20,37,0.540540540540541,0.459459459459459,0.36
"819","ANKRD10",11,11,22,0.5,0.5,0.14
"820","ANKRD11",95,177,272,0.650735294117647,0.349264705882353,0.98
"821","ANKRD12",72,125,197,0.634517766497462,0.365482233502538,0.58
"822","ANKRD13A",18,32,50,0.64,0.36,0.63
"823","ANKRD13B",20,14,34,0.411764705882353,0.588235294117647,0.62
"824","ANKRD13C",22,24,46,0.521739130434783,0.478260869565217,0.23
"825","ANKRD16",5,17,22,0.772727272727273,0.227272727272727,1
"826","ANKRD17",61,131,192,0.682291666666667,0.317708333333333,0.17
"827","ANKRD18A",1,2,3,0.666666666666667,0.333333333333333,1
"828","ANKRD18B",0,9,9,1,0,1
"829","ANKRD2",6,16,22,0.727272727272727,0.272727272727273,1
"830","ANKRD20A1",6,18,24,0.75,0.25,0.78
"831","ANKRD20A2P",3,7,10,0.7,0.3,0.69
"832","ANKRD20A4P",15,19,34,0.558823529411765,0.441176470588235,1
"833","ANKRD20A5P",8,17,25,0.68,0.32,0.3
"834","ANKRD22",4,14,18,0.777777777777778,0.222222222222222,1
"835","ANKRD23",5,12,17,0.705882352941177,0.294117647058824,1
"836","ANKRD24",31,36,67,0.537313432835821,0.462686567164179,0.07
"837","ANKRD26",63,102,165,0.618181818181818,0.381818181818182,0.93
"838","ANKRD27",31,53,84,0.630952380952381,0.369047619047619,1
"839","ANKRD28",22,37,59,0.627118644067797,0.372881355932203,0.93
"840","ANKRD29",12,13,25,0.52,0.48,0.05
"841","ANKRD30A",128,302,430,0.702325581395349,0.297674418604651,0.03
"842","ANKRD30B",2,5,7,0.714285714285714,0.285714285714286,0.43
"843","ANKRD30BL",0,2,2,1,0,1
"844","ANKRD33",20,26,46,0.565217391304348,0.434782608695652,0.41
"845","ANKRD34A",24,41,65,0.630769230769231,0.369230769230769,1
"846","ANKRD34B",19,52,71,0.732394366197183,0.267605633802817,0.59
"847","ANKRD34C",1,3,4,0.75,0.25,1
"848","ANKRD35",44,89,133,0.669172932330827,0.330827067669173,0.81
"849","ANKRD36",1,12,13,0.923076923076923,0.0769230769230769,1
"850","ANKRD36B",12,17,29,0.586206896551724,0.413793103448276,0.91
"851","ANKRD37",4,3,7,0.428571428571429,0.571428571428571,1
"852","ANKRD39",4,6,10,0.6,0.4,1
"853","ANKRD40",15,17,32,0.53125,0.46875,0.72
"854","ANKRD42",17,24,41,0.585365853658537,0.414634146341463,0.63
"855","ANKRD44",38,62,100,0.62,0.38,1
"856","ANKRD45",16,42,58,0.724137931034483,0.275862068965517,0.83
"857","ANKRD46",11,15,26,0.576923076923077,0.423076923076923,0.42
"858","ANKRD49",15,12,27,0.444444444444444,0.555555555555556,0.65
"859","ANKRD50",67,91,158,0.575949367088608,0.424050632911392,0.61
"860","ANKRD52",29,46,75,0.613333333333333,0.386666666666667,1
"861","ANKRD53",13,19,32,0.59375,0.40625,0.54
"862","ANKRD54",7,7,14,0.5,0.5,1
"863","ANKRD55",38,44,82,0.536585365853659,0.463414634146341,0
"864","ANKRD6",22,35,57,0.614035087719298,0.385964912280702,1
"865","ANKRD60",0,1,1,1,0,1
"866","ANKRD61",0,2,2,1,0,0.47
"867","ANKRD65",0,1,1,1,0,1
"868","ANKRD66",0,1,1,1,0,1
"869","ANKRD7",23,27,50,0.54,0.46,0.4
"870","ANKRD9",4,3,7,0.428571428571429,0.571428571428571,1
"871","ANKS1A",36,57,93,0.612903225806452,0.387096774193548,1
"872","ANKS1B",74,135,209,0.645933014354067,0.354066985645933,0.62
"873","ANKS3",10,24,34,0.705882352941177,0.294117647058824,0.95
"874","ANKS4B",20,38,58,0.655172413793103,0.344827586206897,0.46
"875","ANKS6",28,45,73,0.616438356164384,0.383561643835616,0.79
"876","ANKUB1",1,1,2,0.5,0.5,1
"877","ANKZF1",18,40,58,0.689655172413793,0.310344827586207,0.53
"878","ANLN",44,66,110,0.6,0.4,0.87
"879","ANO1",41,61,102,0.598039215686274,0.401960784313726,0.63
"880","ANO10",29,21,50,0.42,0.58,0.02
"881","ANO2",57,107,164,0.652439024390244,0.347560975609756,0.52
"882","ANO3",67,112,179,0.625698324022346,0.374301675977654,0.97
"883","ANO4",101,173,274,0.631386861313869,0.368613138686131,0.56
"884","ANO5",75,110,185,0.594594594594595,0.405405405405405,0.39
"885","ANO6",32,45,77,0.584415584415584,0.415584415584416,0.36
"886","ANO7",34,51,85,0.6,0.4,0.63
"887","ANO8",28,39,67,0.582089552238806,0.417910447761194,0.28
"888","ANO9",37,38,75,0.506666666666667,0.493333333333333,0.95
"889","ANOS1",47,32,79,0.40506329113924,0.594936708860759,0.48
"890","ANP32A",7,20,27,0.740740740740741,0.259259259259259,0.65
"891","ANP32B",2,7,9,0.777777777777778,0.222222222222222,0.79
"892","ANP32D",6,21,27,0.777777777777778,0.222222222222222,0.41
"893","ANP32E",11,16,27,0.592592592592593,0.407407407407407,0.61
"894","ANPEP",35,79,114,0.692982456140351,0.307017543859649,0.93
"895","ANTKMT",3,2,5,0.4,0.6,1
"896","ANTXR1",31,46,77,0.597402597402597,0.402597402597403,0.76
"897","ANTXR2",11,35,46,0.760869565217391,0.239130434782609,1
"898","ANXA1",14,34,48,0.708333333333333,0.291666666666667,0.28
"899","ANXA10",13,31,44,0.704545454545455,0.295454545454545,0.41
"900","ANXA11",17,21,38,0.552631578947368,0.447368421052632,0.37
"901","ANXA13",30,35,65,0.538461538461538,0.461538461538462,0.53
"902","ANXA2",12,14,26,0.538461538461538,0.461538461538462,0.72
"903","ANXA2R",3,7,10,0.7,0.3,1
"904","ANXA3",7,27,34,0.794117647058823,0.205882352941176,0.83
"905","ANXA4",10,20,30,0.666666666666667,0.333333333333333,0.92
"906","ANXA5",12,16,28,0.571428571428571,0.428571428571429,0.12
"907","ANXA6",23,39,62,0.629032258064516,0.370967741935484,0.92
"908","ANXA7",12,29,41,0.707317073170732,0.292682926829268,0.69
"909","ANXA8",13,11,24,0.458333333333333,0.541666666666667,0.84
"910","ANXA8L1",3,8,11,0.727272727272727,0.272727272727273,1
"911","ANXA9",11,31,42,0.738095238095238,0.261904761904762,0.37
"912","AOAH",34,65,99,0.656565656565657,0.343434343434343,0.79
"913","AOC1",56,80,136,0.588235294117647,0.411764705882353,0.43
"914","AOC2",27,46,73,0.63013698630137,0.36986301369863,0.74
"915","AOC3",28,47,75,0.626666666666667,0.373333333333333,1
"916","AOPEP",23,39,62,0.629032258064516,0.370967741935484,0.9
"917","AOX1",56,108,164,0.658536585365854,0.341463414634146,0.64
"918","AP000311.1",3,6,9,0.666666666666667,0.333333333333333,1
"919","AP000471.1",1,1,2,0.5,0.5,1
"920","AP000721.1",3,3,6,0.5,0.5,1
"921","AP000769.3",3,7,10,0.7,0.3,0.72
"922","AP000812.4",3,1,4,0.25,0.75,0.59
"923","AP001042.1",5,5,10,0.5,0.5,1
"924","AP001341.1",0,1,1,1,0,1
"925","AP001453.3",1,0,1,0,1,1
"926","AP001458.2",1,1,2,0.5,0.5,1
"927","AP001781.2",7,9,16,0.5625,0.4375,0.36
"928","AP002414.1",1,1,2,0.5,0.5,1
"929","AP002512.3",45,58,103,0.563106796116505,0.436893203883495,0.02
"930","AP002748.5",23,28,51,0.549019607843137,0.450980392156863,0.22
"931","AP003393.1",4,5,9,0.555555555555556,0.444444444444444,1
"932","AP1AR",5,7,12,0.583333333333333,0.416666666666667,0.77
"933","AP1B1",30,38,68,0.558823529411765,0.441176470588235,0.61
"934","AP1G1",25,50,75,0.666666666666667,0.333333333333333,0.15
"935","AP1G2",23,40,63,0.634920634920635,0.365079365079365,1
"936","AP1M1",15,32,47,0.680851063829787,0.319148936170213,0.7
"937","AP1M2",14,22,36,0.611111111111111,0.388888888888889,1
"938","AP1S1",21,17,38,0.447368421052632,0.552631578947368,0.84
"939","AP1S2",5,6,11,0.545454545454545,0.454545454545455,1
"940","AP1S3",2,9,11,0.818181818181818,0.181818181818182,1
"941","AP2A1",22,37,59,0.627118644067797,0.372881355932203,0.62
"942","AP2A2",25,53,78,0.67948717948718,0.320512820512821,0.69
"943","AP2B1",27,45,72,0.625,0.375,1
"944","AP2M1",17,22,39,0.564102564102564,0.435897435897436,0.95
"945","AP2S1",1,3,4,0.75,0.25,1
"946","AP3B1",46,56,102,0.549019607843137,0.450980392156863,0.06
"947","AP3B2",40,64,104,0.615384615384615,0.384615384615385,1
"948","AP3D1",48,52,100,0.52,0.48,0.01
"949","AP3M1",16,10,26,0.384615384615385,0.615384615384615,0.34
"950","AP3M2",22,21,43,0.488372093023256,0.511627906976744,0.04
"951","AP3S1",4,12,16,0.75,0.25,1
"952","AP3S2",2,12,14,0.857142857142857,0.142857142857143,1
"953","AP4B1",21,43,64,0.671875,0.328125,0.71
"954","AP4E1",41,56,97,0.577319587628866,0.422680412371134,0.71
"955","AP4M1",18,21,39,0.538461538461538,0.461538461538462,0.66
"956","AP4S1",5,3,8,0.375,0.625,0.55
"957","AP5B1",11,21,32,0.65625,0.34375,0.7
"958","AP5M1",10,34,44,0.772727272727273,0.227272727272727,0.53
"959","AP5S1",8,7,15,0.466666666666667,0.533333333333333,1
"960","AP5Z1",22,34,56,0.607142857142857,0.392857142857143,0.33
"961","APAF1",38,66,104,0.634615384615385,0.365384615384615,0.84
"962","APBA1",54,64,118,0.542372881355932,0.457627118644068,0.03
"963","APBA2",41,106,147,0.72108843537415,0.27891156462585,0.9
"964","APBA3",14,17,31,0.548387096774194,0.451612903225806,1
"965","APBB1",29,51,80,0.6375,0.3625,1
"966","APBB1IP",41,75,116,0.646551724137931,0.353448275862069,0.49
"967","APBB2",27,45,72,0.625,0.375,0.92
"968","APBB3",26,19,45,0.422222222222222,0.577777777777778,0.83
"969","APC",428,557,985,0.565482233502538,0.434517766497462,0.39
"970","APC2",26,45,71,0.633802816901408,0.366197183098592,0.88
"971","APCDD1",21,31,52,0.596153846153846,0.403846153846154,1
"972","APCDD1L",20,33,53,0.622641509433962,0.377358490566038,1
"973","APCS",27,43,70,0.614285714285714,0.385714285714286,0.81
"974","APEH",21,22,43,0.511627906976744,0.488372093023256,0.07
"975","APEX1",7,15,22,0.681818181818182,0.318181818181818,0.67
"976","APEX2",29,7,36,0.194444444444444,0.805555555555556,0.67
"977","APH1A",11,11,22,0.5,0.5,1
"978","APH1B",2,14,16,0.875,0.125,0.78
"979","API5",20,26,46,0.565217391304348,0.434782608695652,0.35
"980","APIP",6,16,22,0.727272727272727,0.272727272727273,0.44
"981","APLF",19,25,44,0.568181818181818,0.431818181818182,0.05
"982","APLN",4,2,6,0.333333333333333,0.666666666666667,1
"983","APLNR",24,46,70,0.657142857142857,0.342857142857143,0.98
"984","APLP1",35,56,91,0.615384615384615,0.384615384615385,0.79
"985","APLP2",29,27,56,0.482142857142857,0.517857142857143,0.3
"986","APMAP",24,29,53,0.547169811320755,0.452830188679245,0.2
"987","APOA1",13,17,30,0.566666666666667,0.433333333333333,0.68
"988","APOA2",3,5,8,0.625,0.375,1
"989","APOA4",28,38,66,0.575757575757576,0.424242424242424,0.08
"990","APOA5",24,29,53,0.547169811320755,0.452830188679245,0.6
"991","APOB",290,542,832,0.651442307692308,0.348557692307692,0.3
"992","APOBEC1",18,26,44,0.590909090909091,0.409090909090909,0.66
"993","APOBEC2",9,11,20,0.55,0.45,0.35
"994","APOBEC3A",3,9,12,0.75,0.25,1
"995","APOBEC3B",9,30,39,0.769230769230769,0.230769230769231,0.92
"996","APOBEC3C",2,22,24,0.916666666666667,0.0833333333333333,0.72
"997","APOBEC3D",13,15,28,0.535714285714286,0.464285714285714,0.21
"998","APOBEC3F",7,22,29,0.758620689655172,0.241379310344828,1
"999","APOBEC3G",18,20,38,0.526315789473684,0.473684210526316,0.12
"1000","APOBEC3H",9,14,23,0.608695652173913,0.391304347826087,1
"1001","APOBEC4",11,32,43,0.744186046511628,0.255813953488372,0.64
"1002","APOBR",26,64,90,0.711111111111111,0.288888888888889,0.27
"1003","APOC1",2,10,12,0.833333333333333,0.166666666666667,0.61
"1004","APOC2",2,6,8,0.75,0.25,1
"1005","APOC3",6,9,15,0.6,0.4,1
"1006","APOC4",4,5,9,0.555555555555556,0.444444444444444,1
"1007","APOC4-APOC2",1,2,3,0.666666666666667,0.333333333333333,1
"1008","APOD",6,18,24,0.75,0.25,1
"1009","APOE",4,13,17,0.764705882352941,0.235294117647059,1
"1010","APOF",5,20,25,0.8,0.2,0.79
"1011","APOH",22,35,57,0.614035087719298,0.385964912280702,1
"1012","APOL1",14,22,36,0.611111111111111,0.388888888888889,1
"1013","APOL2",9,18,27,0.666666666666667,0.333333333333333,0.49
"1014","APOL3",14,24,38,0.631578947368421,0.368421052631579,1
"1015","APOL4",10,15,25,0.6,0.4,1
"1016","APOL5",21,30,51,0.588235294117647,0.411764705882353,0.68
"1017","APOL6",12,16,28,0.571428571428571,0.428571428571429,1
"1018","APOLD1",6,9,15,0.6,0.4,1
"1019","APOM",2,9,11,0.818181818181818,0.181818181818182,1
"1020","APOO",11,5,16,0.3125,0.6875,0.68
"1021","APOOL",8,6,14,0.428571428571429,0.571428571428571,1
"1022","APP",25,63,88,0.715909090909091,0.284090909090909,1
"1023","APPBP2",15,33,48,0.6875,0.3125,0.73
"1024","APPL1",33,41,74,0.554054054054054,0.445945945945946,0.77
"1025","APPL2",10,42,52,0.807692307692308,0.192307692307692,0.86
"1026","APRT",3,7,10,0.7,0.3,0.69
"1027","APTX",9,12,21,0.571428571428571,0.428571428571429,1
"1028","AQP1",9,20,29,0.689655172413793,0.310344827586207,0.41
"1029","AQP10",30,32,62,0.516129032258065,0.483870967741935,0.21
"1030","AQP11",3,12,15,0.8,0.2,1
"1031","AQP12A",9,14,23,0.608695652173913,0.391304347826087,1
"1032","AQP12B",4,20,24,0.833333333333333,0.166666666666667,0.61
"1033","AQP2",14,22,36,0.611111111111111,0.388888888888889,1
"1034","AQP3",16,13,29,0.448275862068966,0.551724137931034,0.54
"1035","AQP4",12,33,45,0.733333333333333,0.266666666666667,0.99
"1036","AQP5",8,10,18,0.555555555555556,0.444444444444444,1
"1037","AQP6",10,25,35,0.714285714285714,0.285714285714286,0.63
"1038","AQP7",18,26,44,0.590909090909091,0.409090909090909,0.52
"1039","AQP8",15,26,41,0.634146341463415,0.365853658536585,0.56
"1040","AQP9",20,37,57,0.649122807017544,0.350877192982456,0.97
"1041","AQR",59,76,135,0.562962962962963,0.437037037037037,0.8
"1042","AR",55,49,104,0.471153846153846,0.528846153846154,0.77
"1043","ARAF",35,26,61,0.426229508196721,0.573770491803279,0.82
"1044","ARAP1",35,77,112,0.6875,0.3125,0.86
"1045","ARAP2",97,145,242,0.599173553719008,0.400826446280992,0.61
"1046","ARAP3",48,91,139,0.654676258992806,0.345323741007194,0.62
"1047","ARC",24,22,46,0.478260869565217,0.521739130434783,0.24
"1048","ARCN1",16,20,36,0.555555555555556,0.444444444444444,0.73
"1049","AREG",20,44,64,0.6875,0.3125,0.07
"1050","AREL1",27,42,69,0.608695652173913,0.391304347826087,0.6
"1051","ARF1",12,9,21,0.428571428571429,0.571428571428571,0.6
"1052","ARF3",5,4,9,0.444444444444444,0.555555555555556,1
"1053","ARF4",8,8,16,0.5,0.5,1
"1054","ARF5",5,10,15,0.666666666666667,0.333333333333333,0.74
"1055","ARF6",6,4,10,0.4,0.6,0.61
"1056","ARFGAP1",13,25,38,0.657894736842105,0.342105263157895,0.88
"1057","ARFGAP2",29,26,55,0.472727272727273,0.527272727272727,0.24
"1058","ARFGAP3",16,35,51,0.686274509803922,0.313725490196078,0.94
"1059","ARFGEF1",88,127,215,0.590697674418605,0.409302325581395,0.46
"1060","ARFGEF2",78,105,183,0.573770491803279,0.426229508196721,0.39
"1061","ARFGEF3",66,121,187,0.647058823529412,0.352941176470588,0.69
"1062","ARFIP1",11,25,36,0.694444444444444,0.305555555555556,0.61
"1063","ARFIP2",14,15,29,0.517241379310345,0.482758620689655,0.14
"1064","ARFRP1",4,10,14,0.714285714285714,0.285714285714286,0.66
"1065","ARG1",11,14,25,0.56,0.44,1
"1066","ARG2",11,11,22,0.5,0.5,0.94
"1067","ARGFX",21,29,50,0.58,0.42,0
"1068","ARGLU1",9,14,23,0.608695652173913,0.391304347826087,1
"1069","ARHGAP1",12,21,33,0.636363636363636,0.363636363636364,1
"1070","ARHGAP10",31,40,71,0.563380281690141,0.436619718309859,0.26
"1071","ARHGAP11A",30,75,105,0.714285714285714,0.285714285714286,0.62
"1072","ARHGAP11B",4,11,15,0.733333333333333,0.266666666666667,1
"1073","ARHGAP12",25,46,71,0.647887323943662,0.352112676056338,0.42
"1074","ARHGAP15",31,56,87,0.64367816091954,0.35632183908046,0.87
"1075","ARHGAP17",34,65,99,0.656565656565657,0.343434343434343,0.84
"1076","ARHGAP18",24,39,63,0.619047619047619,0.380952380952381,1
"1077","ARHGAP19",18,34,52,0.653846153846154,0.346153846153846,0.97
"1078","ARHGAP20",42,96,138,0.695652173913043,0.304347826086957,0.72
"1079","ARHGAP21",68,121,189,0.64021164021164,0.35978835978836,0.72
"1080","ARHGAP22",41,61,102,0.598039215686274,0.401960784313726,0.48
"1081","ARHGAP23",1,5,6,0.833333333333333,0.166666666666667,1
"1082","ARHGAP24",32,57,89,0.640449438202247,0.359550561797753,0.99
"1083","ARHGAP25",41,64,105,0.60952380952381,0.39047619047619,0.68
"1084","ARHGAP26",28,52,80,0.65,0.35,0.46
"1085","ARHGAP27",31,41,72,0.569444444444444,0.430555555555556,0.45
"1086","ARHGAP28",33,54,87,0.620689655172414,0.379310344827586,1
"1087","ARHGAP29",66,97,163,0.595092024539877,0.404907975460123,0.8
"1088","ARHGAP30",68,91,159,0.572327044025157,0.427672955974843,0.1
"1089","ARHGAP31",67,119,186,0.639784946236559,0.360215053763441,0.62
"1090","ARHGAP32",66,129,195,0.661538461538462,0.338461538461538,0.77
"1091","ARHGAP33",57,95,152,0.625,0.375,1
"1092","ARHGAP35",71,137,208,0.658653846153846,0.341346153846154,0.6
"1093","ARHGAP36",84,68,152,0.447368421052632,0.552631578947368,0.61
"1094","ARHGAP39",37,64,101,0.633663366336634,0.366336633663366,0.45
"1095","ARHGAP4",38,30,68,0.441176470588235,0.558823529411765,0.71
"1096","ARHGAP40",0,5,5,1,0,1
"1097","ARHGAP42",0,5,5,1,0,1
"1098","ARHGAP44",30,55,85,0.647058823529412,0.352941176470588,0.82
"1099","ARHGAP45",28,53,81,0.654320987654321,0.345679012345679,0.61
"1100","ARHGAP5",61,101,162,0.623456790123457,0.376543209876543,1
"1101","ARHGAP6",65,55,120,0.458333333333333,0.541666666666667,0.77
"1102","ARHGAP8",2,0,2,0,1,1
"1103","ARHGAP9",31,50,81,0.617283950617284,0.382716049382716,0.86
"1104","ARHGDIA",9,9,18,0.5,0.5,0.46
"1105","ARHGDIB",14,11,25,0.44,0.56,0.16
"1106","ARHGDIG",1,6,7,0.857142857142857,0.142857142857143,1
"1107","ARHGEF1",32,46,78,0.58974358974359,0.41025641025641,0.26
"1108","ARHGEF10",47,67,114,0.587719298245614,0.412280701754386,0.41
"1109","ARHGEF10L",41,72,113,0.63716814159292,0.36283185840708,0.88
"1110","ARHGEF11",69,90,159,0.566037735849057,0.433962264150943,0.02
"1111","ARHGEF12",58,87,145,0.6,0.4,0.55
"1112","ARHGEF15",40,75,115,0.652173913043478,0.347826086956522,0.78
"1113","ARHGEF16",21,18,39,0.461538461538462,0.538461538461538,0.55
"1114","ARHGEF17",61,104,165,0.63030303030303,0.36969696969697,0.75
"1115","ARHGEF18",41,53,94,0.563829787234043,0.436170212765957,0.19
"1116","ARHGEF19",20,32,52,0.615384615384615,0.384615384615385,0.79
"1117","ARHGEF2",37,60,97,0.618556701030928,0.381443298969072,0.78
"1118","ARHGEF25",21,32,53,0.60377358490566,0.39622641509434,1
"1119","ARHGEF26",23,73,96,0.760416666666667,0.239583333333333,0.39
"1120","ARHGEF28",38,73,111,0.657657657657658,0.342342342342342,0.99
"1121","ARHGEF3",8,45,53,0.849056603773585,0.150943396226415,0.59
"1122","ARHGEF33",0,8,8,1,0,1
"1123","ARHGEF35",10,28,38,0.736842105263158,0.263157894736842,0.71
"1124","ARHGEF37",30,29,59,0.491525423728814,0.508474576271186,0.59
"1125","ARHGEF38",3,11,14,0.785714285714286,0.214285714285714,1
"1126","ARHGEF39",12,5,17,0.294117647058824,0.705882352941177,0.67
"1127","ARHGEF4",24,42,66,0.636363636363636,0.363636363636364,0.81
"1128","ARHGEF40",64,61,125,0.488,0.512,0.57
"1129","ARHGEF5",43,73,116,0.629310344827586,0.370689655172414,0.7
"1130","ARHGEF6",61,51,112,0.455357142857143,0.544642857142857,0.51
"1131","ARHGEF7",31,47,78,0.602564102564103,0.397435897435897,0.75
"1132","ARHGEF9",43,19,62,0.306451612903226,0.693548387096774,0.35
"1133","ARID1A",231,361,592,0.609797297297297,0.390202702702703,0.43
"1134","ARID1B",110,129,239,0.539748953974895,0.460251046025105,0.13
"1135","ARID2",124,227,351,0.646723646723647,0.353276353276353,0.79
"1136","ARID3A",6,20,26,0.769230769230769,0.230769230769231,0.84
"1137","ARID3B",12,25,37,0.675675675675676,0.324324324324324,0.88
"1138","ARID3C",15,28,43,0.651162790697674,0.348837209302326,0.46
"1139","ARID4A",57,84,141,0.595744680851064,0.404255319148936,0.33
"1140","ARID4B",29,72,101,0.712871287128713,0.287128712871287,0.76
"1141","ARID5A",18,33,51,0.647058823529412,0.352941176470588,0.71
"1142","ARID5B",39,84,123,0.682926829268293,0.317073170731707,0.65
"1143","ARIH1",13,22,35,0.628571428571429,0.371428571428571,1
"1144","ARIH2",24,35,59,0.593220338983051,0.406779661016949,0.81
"1145","ARL1",4,8,12,0.666666666666667,0.333333333333333,0.92
"1146","ARL10",8,7,15,0.466666666666667,0.533333333333333,1
"1147","ARL11",10,12,22,0.545454545454545,0.454545454545455,0.42
"1148","ARL13A",19,7,26,0.269230769230769,0.730769230769231,0.77
"1149","ARL13B",15,36,51,0.705882352941177,0.294117647058824,0.73
"1150","ARL14",9,9,18,0.5,0.5,0.13
"1151","ARL14EP",14,14,28,0.5,0.5,1
"1152","ARL15",7,6,13,0.461538461538462,0.538461538461538,1
"1153","ARL16",7,11,18,0.611111111111111,0.388888888888889,0.92
"1154","ARL2",2,7,9,0.777777777777778,0.222222222222222,0.77
"1155","ARL2BP",8,6,14,0.428571428571429,0.571428571428571,0.77
"1156","ARL3",1,9,10,0.9,0.1,0.77
"1157","ARL4A",10,14,24,0.583333333333333,0.416666666666667,0.77
"1158","ARL4AP1",0,4,4,1,0,0.77
"1159","ARL4C",7,8,15,0.533333333333333,0.466666666666667,0.77
"1160","ARL4D",11,7,18,0.388888888888889,0.611111111111111,0.77
"1161","ARL5A",5,9,14,0.642857142857143,0.357142857142857,0.77
"1162","ARL5B",8,15,23,0.652173913043478,0.347826086956522,0.77
"1163","ARL6",4,18,22,0.818181818181818,0.181818181818182,0.77
"1164","ARL6IP1",5,14,19,0.736842105263158,0.263157894736842,0.77
"1165","ARL6IP4",6,5,11,0.454545454545455,0.545454545454545,0.77
"1166","ARL6IP5",3,13,16,0.8125,0.1875,0.77
"1167","ARL6IP6",9,15,24,0.625,0.375,0.77
"1168","ARL8A",8,6,14,0.428571428571429,0.571428571428571,0.77
"1169","ARL8B",10,11,21,0.523809523809524,0.476190476190476,0.77
"1170","ARL9",8,8,16,0.5,0.5,0.77
"1171","ARMC1",13,17,30,0.566666666666667,0.433333333333333,0.77
"1172","ARMC10",8,20,28,0.714285714285714,0.285714285714286,0.77
"1173","ARMC12",22,19,41,0.463414634146341,0.536585365853659,0.77
"1174","ARMC2",25,29,54,0.537037037037037,0.462962962962963,0.77
"1175","ARMC3",55,85,140,0.607142857142857,0.392857142857143,0.77
"1176","ARMC4",82,176,258,0.682170542635659,0.317829457364341,0.77
"1177","ARMC5",29,60,89,0.674157303370786,0.325842696629214,0.77
"1178","ARMC6",9,35,44,0.795454545454545,0.204545454545455,0.77
"1179","ARMC7",6,11,17,0.647058823529412,0.352941176470588,0.77
"1180","ARMC8",21,27,48,0.5625,0.4375,0.77
"1181","ARMC9",13,38,51,0.745098039215686,0.254901960784314,0.77
"1182","ARMCX1",25,24,49,0.489795918367347,0.510204081632653,0.77
"1183","ARMCX2",50,27,77,0.350649350649351,0.649350649350649,0.77
"1184","ARMCX3",18,21,39,0.538461538461538,0.461538461538462,0.77
"1185","ARMCX5",30,19,49,0.387755102040816,0.612244897959184,0.77
"1186","ARMCX5-GPRASP2",44,20,64,0.3125,0.6875,0.77
"1187","ARMCX6",9,11,20,0.55,0.45,0.77
"1188","ARMH1",0,3,3,1,0,0.77
"1189","ARMH3",28,31,59,0.525423728813559,0.474576271186441,0.77
"1190","ARMH4",29,56,85,0.658823529411765,0.341176470588235,0.77
"1191","ARMS2",4,7,11,0.636363636363636,0.363636363636364,0.77
"1192","ARMT1",21,23,44,0.522727272727273,0.477272727272727,0.77
"1193","ARNT",17,41,58,0.706896551724138,0.293103448275862,0.77
"1194","ARNT2",34,40,74,0.540540540540541,0.459459459459459,0.77
"1195","ARNTL",15,43,58,0.741379310344828,0.258620689655172,0.77
"1196","ARNTL2",24,37,61,0.60655737704918,0.39344262295082,0.77
"1197","ARPC1B",1,0,1,0,1,0.77
"1198","ARPC2",15,11,26,0.423076923076923,0.576923076923077,0.77
"1199","ARPC3",5,10,15,0.666666666666667,0.333333333333333,0.77
"1200","ARPC4",3,9,12,0.75,0.25,0.77
"1201","ARPC5",4,7,11,0.636363636363636,0.363636363636364,0.77
"1202","ARPC5L",3,3,6,0.5,0.5,0.77
"1203","ARPIN",4,7,11,0.636363636363636,0.363636363636364,0.77
"1204","ARPP19",5,4,9,0.444444444444444,0.555555555555556,0.77
"1205","ARPP19P1",6,9,15,0.6,0.4,0.77
"1206","ARPP19P2",4,17,21,0.80952380952381,0.19047619047619,0.77
"1207","ARPP21",56,144,200,0.72,0.28,0.77
"1208","ARR3",19,12,31,0.387096774193548,0.612903225806452,0.77
"1209","ARRB1",14,21,35,0.6,0.4,0.77
"1210","ARRB2",11,20,31,0.645161290322581,0.354838709677419,0.77
"1211","ARRDC1",14,12,26,0.461538461538462,0.538461538461538,0.77
"1212","ARRDC2",8,19,27,0.703703703703704,0.296296296296296,0.77
"1213","ARRDC3",14,36,50,0.72,0.28,0.77
"1214","ARRDC4",12,23,35,0.657142857142857,0.342857142857143,0.77
"1215","ARRDC5",14,25,39,0.641025641025641,0.358974358974359,0.77
"1216","ARSA",13,12,25,0.48,0.52,0.77
"1217","ARSB",26,21,47,0.446808510638298,0.553191489361702,0.77
"1218","ARSD",26,19,45,0.422222222222222,0.577777777777778,0.77
"1219","ARSF",56,47,103,0.456310679611651,0.543689320388349,0.77
"1220","ARSG",21,40,61,0.655737704918033,0.344262295081967,0.77
"1221","ARSH",29,32,61,0.524590163934426,0.475409836065574,0.77
"1222","ARSI",25,34,59,0.576271186440678,0.423728813559322,0.77
"1223","ARSJ",33,53,86,0.616279069767442,0.383720930232558,0.77
"1224","ARSK",22,28,50,0.56,0.44,0.77
"1225","ARSL",25,22,47,0.468085106382979,0.531914893617021,0.77
"1226","ART1",25,30,55,0.545454545454545,0.454545454545455,0.77
"1227","ART3",14,27,41,0.658536585365854,0.341463414634146,0.77
"1228","ART4",14,18,32,0.5625,0.4375,0.77
"1229","ART5",12,28,40,0.7,0.3,0.77
"1230","ARTN",1,5,6,0.833333333333333,0.166666666666667,0.77
"1231","ARV1",15,26,41,0.634146341463415,0.365853658536585,0.77
"1232","ARVCF",27,39,66,0.590909090909091,0.409090909090909,0.77
"1233","ARX",11,10,21,0.476190476190476,0.523809523809524,0.77
"1234","AS3MT",21,8,29,0.275862068965517,0.724137931034483,1
"1235","ASAH1",13,20,33,0.606060606060606,0.393939393939394,1
"1236","ASAH2",45,113,158,0.715189873417722,0.284810126582278,1
"1237","ASAH2B",2,4,6,0.666666666666667,0.333333333333333,1
"1238","ASAP1",47,92,139,0.661870503597122,0.338129496402878,1
"1239","ASAP2",52,73,125,0.584,0.416,1
"1240","ASAP3",25,37,62,0.596774193548387,0.403225806451613,1
"1241","ASB1",8,10,18,0.555555555555556,0.444444444444444,1
"1242","ASB10",25,26,51,0.509803921568627,0.490196078431373,1
"1243","ASB11",18,26,44,0.590909090909091,0.409090909090909,1
"1244","ASB12",20,16,36,0.444444444444444,0.555555555555556,1
"1245","ASB13",6,13,19,0.684210526315789,0.315789473684211,1
"1246","ASB14",8,8,16,0.5,0.5,1
"1247","ASB15",38,63,101,0.623762376237624,0.376237623762376,1
"1248","ASB16",14,15,29,0.517241379310345,0.482758620689655,1
"1249","ASB17",30,35,65,0.538461538461538,0.461538461538462,1
"1250","ASB18",7,18,25,0.72,0.28,1
"1251","ASB2",21,36,57,0.631578947368421,0.368421052631579,1
"1252","ASB3",19,28,47,0.595744680851064,0.404255319148936,1
"1253","ASB4",23,48,71,0.676056338028169,0.323943661971831,1
"1254","ASB5",32,72,104,0.692307692307692,0.307692307692308,1
"1255","ASB6",11,17,28,0.607142857142857,0.392857142857143,1
"1256","ASB7",11,17,28,0.607142857142857,0.392857142857143,1
"1257","ASB8",7,14,21,0.666666666666667,0.333333333333333,1
"1258","ASB9",28,9,37,0.243243243243243,0.756756756756757,1
"1259","ASCC1",7,15,22,0.681818181818182,0.318181818181818,1
"1260","ASCC2",24,37,61,0.60655737704918,0.39344262295082,1
"1261","ASCC3",85,146,231,0.632034632034632,0.367965367965368,1
"1262","ASCL1",11,12,23,0.521739130434783,0.478260869565217,1
"1263","ASCL2",0,2,2,1,0,1
"1264","ASCL3",4,9,13,0.692307692307692,0.307692307692308,1
"1265","ASCL4",8,15,23,0.652173913043478,0.347826086956522,1
"1266","ASF1A",0,10,10,1,0,1
"1267","ASF1B",8,9,17,0.529411764705882,0.470588235294118,1
"1268","ASGR1",5,14,19,0.736842105263158,0.263157894736842,1
"1269","ASGR2",7,20,27,0.740740740740741,0.259259259259259,1
"1270","ASH1L",125,215,340,0.632352941176471,0.367647058823529,1
"1271","ASH2L",24,25,49,0.510204081632653,0.489795918367347,1
"1272","ASIC1",8,37,45,0.822222222222222,0.177777777777778,1
"1273","ASIC2",40,53,93,0.56989247311828,0.43010752688172,1
"1274","ASIC3",30,27,57,0.473684210526316,0.526315789473684,1
"1275","ASIC4",27,48,75,0.64,0.36,1
"1276","ASIC5",43,61,104,0.586538461538462,0.413461538461538,1
"1277","ASIP",7,4,11,0.363636363636364,0.636363636363636,1
"1278","ASL",12,26,38,0.684210526315789,0.315789473684211,1
"1279","ASMT",22,32,54,0.592592592592593,0.407407407407407,1
"1280","ASMTL",21,31,52,0.596153846153846,0.403846153846154,1
"1281","ASNS",13,45,58,0.775862068965517,0.224137931034483,1
"1282","ASNSD1",24,40,64,0.625,0.375,1
"1283","ASPA",12,23,35,0.657142857142857,0.342857142857143,1
"1284","ASPDH",7,10,17,0.588235294117647,0.411764705882353,1
"1285","ASPG",18,26,44,0.590909090909091,0.409090909090909,1
"1286","ASPH",28,45,73,0.616438356164384,0.383561643835616,1
"1287","ASPHD1",19,27,46,0.58695652173913,0.41304347826087,1
"1288","ASPHD2",15,23,38,0.605263157894737,0.394736842105263,1
"1289","ASPM",181,263,444,0.592342342342342,0.407657657657658,1
"1290","ASPN",16,18,34,0.529411764705882,0.470588235294118,1
"1291","ASPRV1",18,29,47,0.617021276595745,0.382978723404255,1
"1292","ASPSCR1",12,35,47,0.74468085106383,0.25531914893617,1
"1293","ASRGL1",10,14,24,0.583333333333333,0.416666666666667,1
"1294","ASS1",22,30,52,0.576923076923077,0.423076923076923,1
"1295","ASTE1",22,34,56,0.607142857142857,0.392857142857143,1
"1296","ASTL",36,51,87,0.586206896551724,0.413793103448276,1
"1297","ASTN1",142,252,394,0.639593908629442,0.360406091370558,1
"1298","ASTN2",120,160,280,0.571428571428571,0.428571428571429,1
"1299","ASXL1",84,101,185,0.545945945945946,0.454054054054054,1
"1300","ASXL2",72,96,168,0.571428571428571,0.428571428571429,1
"1301","ASXL3",171,283,454,0.623348017621145,0.376651982378855,1
"1302","ASZ1",22,42,64,0.65625,0.34375,1
"1303","ATAD1",11,14,25,0.56,0.44,1
"1304","ATAD2",66,108,174,0.620689655172414,0.379310344827586,1
"1305","ATAD2B",40,79,119,0.663865546218487,0.336134453781513,1
"1306","ATAD3A",15,16,31,0.516129032258065,0.483870967741935,1
"1307","ATAD3B",14,17,31,0.548387096774194,0.451612903225806,1
"1308","ATAD3C",2,3,5,0.6,0.4,1
"1309","ATAD5",67,115,182,0.631868131868132,0.368131868131868,1
"1310","ATAT1",6,18,24,0.75,0.25,1
"1311","ATCAY",34,32,66,0.484848484848485,0.515151515151515,1
"1312","ATE1",17,24,41,0.585365853658537,0.414634146341463,1
"1313","ATF1",10,14,24,0.583333333333333,0.416666666666667,1
"1314","ATF2",14,29,43,0.674418604651163,0.325581395348837,1
"1315","ATF3",5,7,12,0.583333333333333,0.416666666666667,1
"1316","ATF4",13,26,39,0.666666666666667,0.333333333333333,1
"1317","ATF5",13,20,33,0.606060606060606,0.393939393939394,1
"1318","ATF6",20,35,55,0.636363636363636,0.363636363636364,1
"1319","ATF6B",18,42,60,0.7,0.3,1
"1320","ATF7",14,22,36,0.611111111111111,0.388888888888889,1
"1321","ATF7-NPFF",0,1,1,1,0,1
"1322","ATF7IP",54,100,154,0.649350649350649,0.350649350649351,1
"1323","ATF7IP2",18,42,60,0.7,0.3,1
"1324","ATG10",8,15,23,0.652173913043478,0.347826086956522,1
"1325","ATG101",14,8,22,0.363636363636364,0.636363636363636,1
"1326","ATG12",5,13,18,0.722222222222222,0.277777777777778,1
"1327","ATG13",15,33,48,0.6875,0.3125,1
"1328","ATG14",18,22,40,0.55,0.45,1
"1329","ATG16L1",24,31,55,0.563636363636364,0.436363636363636,1
"1330","ATG16L2",11,11,22,0.5,0.5,1
"1331","ATG2A",61,91,152,0.598684210526316,0.401315789473684,1
"1332","ATG2B",83,116,199,0.582914572864322,0.417085427135678,1
"1333","ATG3",6,11,17,0.647058823529412,0.352941176470588,1
"1334","ATG4A",24,10,34,0.294117647058824,0.705882352941177,1
"1335","ATG4B",7,16,23,0.695652173913043,0.304347826086957,1
"1336","ATG4C",14,41,55,0.745454545454545,0.254545454545455,1
"1337","ATG4D",23,25,48,0.520833333333333,0.479166666666667,1
"1338","ATG5",13,24,37,0.648648648648649,0.351351351351351,1
"1339","ATG7",35,29,64,0.453125,0.546875,1
"1340","ATG9A",19,41,60,0.683333333333333,0.316666666666667,1
"1341","ATG9B",25,40,65,0.615384615384615,0.384615384615385,1
"1342","ATIC",21,31,52,0.596153846153846,0.403846153846154,1
"1343","ATL1",22,37,59,0.627118644067797,0.372881355932203,1
"1344","ATL2",12,20,32,0.625,0.375,1
"1345","ATL3",12,12,24,0.5,0.5,1
"1346","ATM",184,251,435,0.577011494252874,0.422988505747126,1
"1347","ATMIN",25,42,67,0.626865671641791,0.373134328358209,1
"1348","ATN1",35,63,98,0.642857142857143,0.357142857142857,1
"1349","ATOH1",25,23,48,0.479166666666667,0.520833333333333,1
"1350","ATOH7",3,1,4,0.25,0.75,1
"1351","ATOH8",3,11,14,0.785714285714286,0.214285714285714,1
"1352","ATOX1",2,0,2,0,1,1
"1353","ATP10A",90,172,262,0.656488549618321,0.343511450381679,1
"1354","ATP10B",88,131,219,0.598173515981735,0.401826484018265,1
"1355","ATP10D",85,119,204,0.583333333333333,0.416666666666667,1
"1356","ATP11A",37,73,110,0.663636363636364,0.336363636363636,1
"1357","ATP11AUN",4,11,15,0.733333333333333,0.266666666666667,1
"1358","ATP11B",41,58,99,0.585858585858586,0.414141414141414,1
"1359","ATP11C",62,60,122,0.491803278688525,0.508196721311475,1
"1360","ATP12A",64,100,164,0.609756097560976,0.390243902439024,1
"1361","ATP13A1",39,48,87,0.551724137931034,0.448275862068966,1
"1362","ATP13A2",46,71,117,0.606837606837607,0.393162393162393,1
"1363","ATP13A3",46,81,127,0.637795275590551,0.362204724409449,1
"1364","ATP13A4",48,121,169,0.715976331360947,0.284023668639053,1
"1365","ATP13A5",64,147,211,0.696682464454976,0.303317535545024,1
"1366","ATP1A1",37,49,86,0.569767441860465,0.430232558139535,1
"1367","ATP1A2",63,110,173,0.635838150289017,0.364161849710983,1
"1368","ATP1A3",54,97,151,0.642384105960265,0.357615894039735,1
"1369","ATP1A4",61,89,150,0.593333333333333,0.406666666666667,1
"1370","ATP1B1",23,16,39,0.41025641025641,0.58974358974359,1
"1371","ATP1B2",5,23,28,0.821428571428571,0.178571428571429,1
"1372","ATP1B3",6,16,22,0.727272727272727,0.272727272727273,1
"1373","ATP1B4",34,42,76,0.552631578947368,0.447368421052632,1
"1374","ATP23",9,11,20,0.55,0.45,1
"1375","ATP2A1",47,85,132,0.643939393939394,0.356060606060606,1
"1376","ATP2A2",45,66,111,0.594594594594595,0.405405405405405,1
"1377","ATP2A3",33,55,88,0.625,0.375,1
"1378","ATP2B1",42,74,116,0.637931034482759,0.362068965517241,1
"1379","ATP2B2",64,106,170,0.623529411764706,0.376470588235294,1
"1380","ATP2B3",90,68,158,0.430379746835443,0.569620253164557,1
"1381","ATP2B4",53,61,114,0.535087719298246,0.464912280701754,1
"1382","ATP2C1",36,66,102,0.647058823529412,0.352941176470588,1
"1383","ATP2C2",36,53,89,0.595505617977528,0.404494382022472,1
"1384","ATP4A",69,83,152,0.546052631578947,0.453947368421053,1
"1385","ATP4B",12,9,21,0.428571428571429,0.571428571428571,1
"1386","ATP5F1A",15,25,40,0.625,0.375,1
"1387","ATP5F1B",19,27,46,0.58695652173913,0.41304347826087,1
"1388","ATP5F1C",9,29,38,0.763157894736842,0.236842105263158,1
"1389","ATP5F1D",1,1,2,0.5,0.5,1
"1390","ATP5F1E",1,1,2,0.5,0.5,1
"1391","ATP5F1EP2",0,1,1,1,0,1
"1392","ATP5IF1",2,4,6,0.666666666666667,0.333333333333333,1
"1393","ATP5MC1",8,2,10,0.2,0.8,1
"1394","ATP5MC2",7,11,18,0.611111111111111,0.388888888888889,1
"1395","ATP5MC3",5,8,13,0.615384615384615,0.384615384615385,1
"1396","ATP5MD",3,6,9,0.666666666666667,0.333333333333333,1
"1397","ATP5ME",3,2,5,0.4,0.6,1
"1398","ATP5MF",5,5,10,0.5,0.5,1
"1399","ATP5MF-PTCD1",3,1,4,0.25,0.75,1
"1400","ATP5MG",1,4,5,0.8,0.2,1
"1401","ATP5MPL",3,3,6,0.5,0.5,1
"1402","ATP5PB",6,16,22,0.727272727272727,0.272727272727273,1
"1403","ATP5PD",2,7,9,0.777777777777778,0.222222222222222,1
"1404","ATP5PF",2,6,8,0.75,0.25,1
"1405","ATP5PO",8,1,9,0.111111111111111,0.888888888888889,1
"1406","ATP6AP1",25,16,41,0.390243902439024,0.609756097560976,1
"1407","ATP6AP1L",15,22,37,0.594594594594595,0.405405405405405,1
"1408","ATP6AP2",22,16,38,0.421052631578947,0.578947368421053,1
"1409","ATP6V0A1",26,51,77,0.662337662337662,0.337662337662338,1
"1410","ATP6V0A2",25,51,76,0.671052631578947,0.328947368421053,1
"1411","ATP6V0A4",48,78,126,0.619047619047619,0.380952380952381,1
"1412","ATP6V0B",5,11,16,0.6875,0.3125,1
"1413","ATP6V0C",4,5,9,0.555555555555556,0.444444444444444,1
"1414","ATP6V0D1",12,21,33,0.636363636363636,0.363636363636364,1
"1415","ATP6V0D2",18,44,62,0.709677419354839,0.290322580645161,1
"1416","ATP6V0E1",0,4,4,1,0,1
"1417","ATP6V0E2",5,6,11,0.545454545454545,0.454545454545455,1
"1418","ATP6V1A",24,39,63,0.619047619047619,0.380952380952381,1
"1419","ATP6V1B1",47,47,94,0.5,0.5,1
"1420","ATP6V1B2",15,29,44,0.659090909090909,0.340909090909091,1
"1421","ATP6V1C1",12,29,41,0.707317073170732,0.292682926829268,1
"1422","ATP6V1C2",14,34,48,0.708333333333333,0.291666666666667,1
"1423","ATP6V1D",9,13,22,0.590909090909091,0.409090909090909,1
"1424","ATP6V1E1",13,7,20,0.35,0.65,1
"1425","ATP6V1E2",10,20,30,0.666666666666667,0.333333333333333,1
"1426","ATP6V1F",4,5,9,0.555555555555556,0.444444444444444,1
"1427","ATP6V1G1",4,7,11,0.636363636363636,0.363636363636364,1
"1428","ATP6V1G2",1,8,9,0.888888888888889,0.111111111111111,1
"1429","ATP6V1G3",11,19,30,0.633333333333333,0.366666666666667,1
"1430","ATP6V1H",20,38,58,0.655172413793103,0.344827586206897,1
"1431","ATP7A",96,55,151,0.364238410596026,0.635761589403974,1
"1432","ATP7B",44,98,142,0.690140845070423,0.309859154929577,1
"1433","ATP8A1",41,109,150,0.726666666666667,0.273333333333333,1
"1434","ATP8A2",80,113,193,0.585492227979275,0.414507772020725,1
"1435","ATP8B1",44,75,119,0.630252100840336,0.369747899159664,1
"1436","ATP8B2",47,86,133,0.646616541353383,0.353383458646617,1
"1437","ATP8B3",46,58,104,0.557692307692308,0.442307692307692,1
"1438","ATP8B4",79,121,200,0.605,0.395,1
"1439","ATP9A",59,80,139,0.575539568345324,0.424460431654676,1
"1440","ATP9B",34,62,96,0.645833333333333,0.354166666666667,1
"1441","ATPAF1",7,10,17,0.588235294117647,0.411764705882353,1
"1442","ATPAF2",0,7,7,1,0,1
"1443","ATPSCKMT",17,22,39,0.564102564102564,0.435897435897436,1
"1444","ATR",102,173,275,0.629090909090909,0.370909090909091,1
"1445","ATRAID",5,8,13,0.615384615384615,0.384615384615385,1
"1446","ATRIP",15,27,42,0.642857142857143,0.357142857142857,1
"1447","ATRN",32,74,106,0.69811320754717,0.30188679245283,1
"1448","ATRNL1",89,152,241,0.630705394190871,0.369294605809129,1
"1449","ATRX",307,252,559,0.450805008944544,0.549194991055456,1
"1450","ATXN1",38,68,106,0.641509433962264,0.358490566037736,1
"1451","ATXN10",14,24,38,0.631578947368421,0.368421052631579,1
"1452","ATXN2",38,55,93,0.591397849462366,0.408602150537634,1
"1453","ATXN2L",54,67,121,0.553719008264463,0.446280991735537,1
"1454","ATXN3",10,25,35,0.714285714285714,0.285714285714286,1
"1455","ATXN3L",24,20,44,0.454545454545455,0.545454545454545,1
"1456","ATXN7",28,51,79,0.645569620253165,0.354430379746835,1
"1457","ATXN7L1",8,15,23,0.652173913043478,0.347826086956522,1
"1458","ATXN7L2",27,35,62,0.564516129032258,0.435483870967742,1
"1459","ATXN7L3",12,27,39,0.692307692307692,0.307692307692308,1
"1460","AUH",11,14,25,0.56,0.44,1
"1461","AUNIP",9,4,13,0.307692307692308,0.692307692307692,1
"1462","AUP1",7,25,32,0.78125,0.21875,1
"1463","AURKA",9,15,24,0.625,0.375,1
"1464","AURKAIP1",8,6,14,0.428571428571429,0.571428571428571,1
"1465","AURKB",13,20,33,0.606060606060606,0.393939393939394,1
"1466","AURKC",22,37,59,0.627118644067797,0.372881355932203,1
"1467","AUTS2",77,90,167,0.538922155688623,0.461077844311377,1
"1468","AVEN",6,20,26,0.769230769230769,0.230769230769231,1
"1469","AVIL",22,31,53,0.584905660377358,0.415094339622642,1
"1470","AVL9",21,25,46,0.543478260869565,0.456521739130435,1
"1471","AVP",6,5,11,0.454545454545455,0.545454545454545,1
"1472","AVPI1",4,9,13,0.692307692307692,0.307692307692308,1
"1473","AVPR1A",42,63,105,0.6,0.4,1
"1474","AVPR1B",17,46,63,0.73015873015873,0.26984126984127,1
"1475","AVPR2",25,16,41,0.390243902439024,0.609756097560976,1
"1476","AWAT1",18,12,30,0.4,0.6,1
"1477","AWAT2",12,20,32,0.625,0.375,1
"1478","AXDND1",65,132,197,0.67005076142132,0.32994923857868,1
"1479","AXIN1",38,76,114,0.666666666666667,0.333333333333333,1
"1480","AXIN2",50,64,114,0.56140350877193,0.43859649122807,1
"1481","AXL",40,81,121,0.669421487603306,0.330578512396694,1
"1482","AZGP1",20,26,46,0.565217391304348,0.434782608695652,1
"1483","AZI2",6,14,20,0.7,0.3,1
"1484","AZIN1",9,19,28,0.678571428571429,0.321428571428571,1
"1485","AZIN2",13,15,28,0.535714285714286,0.464285714285714,1
"1486","AZU1",9,19,28,0.678571428571429,0.321428571428571,1
"1487","B2M",59,72,131,0.549618320610687,0.450381679389313,1
"1488","B3GALNT1",6,27,33,0.818181818181818,0.181818181818182,1
"1489","B3GALNT2",11,14,25,0.56,0.44,1
"1490","B3GALT1",11,45,56,0.803571428571429,0.196428571428571,1
"1491","B3GALT2",12,33,45,0.733333333333333,0.266666666666667,1
"1492","B3GALT4",15,25,40,0.625,0.375,1
"1493","B3GALT5",18,15,33,0.454545454545455,0.545454545454545,1
"1494","B3GALT5-AS1",0,2,2,1,0,1
"1495","B3GALT6",3,6,9,0.666666666666667,0.333333333333333,1
"1496","B3GAT1",19,40,59,0.677966101694915,0.322033898305085,1
"1497","B3GAT2",10,23,33,0.696969696969697,0.303030303030303,1
"1498","B3GAT3",12,14,26,0.538461538461538,0.461538461538462,1
"1499","B3GLCT",14,34,48,0.708333333333333,0.291666666666667,1
"1500","B3GNT2",18,27,45,0.6,0.4,1
"1501","B3GNT3",24,18,42,0.428571428571429,0.571428571428571,1
"1502","B3GNT4",14,26,40,0.65,0.35,1
"1503","B3GNT5",17,26,43,0.604651162790698,0.395348837209302,1
"1504","B3GNT6",10,18,28,0.642857142857143,0.357142857142857,1
"1505","B3GNT7",18,27,45,0.6,0.4,1
"1506","B3GNT8",12,18,30,0.6,0.4,1
"1507","B3GNT9",5,7,12,0.583333333333333,0.416666666666667,1
"1508","B3GNTL1",10,14,24,0.583333333333333,0.416666666666667,1
"1509","B4GALNT1",30,41,71,0.577464788732394,0.422535211267606,1
"1510","B4GALNT2",27,59,86,0.686046511627907,0.313953488372093,1
"1511","B4GALNT3",26,60,86,0.697674418604651,0.302325581395349,1
"1512","B4GALNT4",49,40,89,0.449438202247191,0.550561797752809,1
"1513","B4GALT1",11,15,26,0.576923076923077,0.423076923076923,1
"1514","B4GALT2",14,17,31,0.548387096774194,0.451612903225806,1
"1515","B4GALT3",13,20,33,0.606060606060606,0.393939393939394,1
"1516","B4GALT4",11,18,29,0.620689655172414,0.379310344827586,1
"1517","B4GALT5",12,18,30,0.6,0.4,1
"1518","B4GALT6",15,23,38,0.605263157894737,0.394736842105263,1
"1519","B4GALT7",7,9,16,0.5625,0.4375,1
"1520","B4GAT1",13,24,37,0.648648648648649,0.351351351351351,1
"1521","B9D1",3,8,11,0.727272727272727,0.272727272727273,1
"1522","B9D2",10,10,20,0.5,0.5,1
"1523","BAALC",6,14,20,0.7,0.3,1
"1524","BAAT",27,39,66,0.590909090909091,0.409090909090909,1
"1525","BABAM1",10,12,22,0.545454545454545,0.454545454545455,1
"1526","BABAM2",21,30,51,0.588235294117647,0.411764705882353,1
"1527","BACE1",9,22,31,0.709677419354839,0.290322580645161,0.57
"1528","BACE2",24,27,51,0.529411764705882,0.470588235294118,0.6
"1529","BACH1",36,51,87,0.586206896551724,0.413793103448276,1
"1530","BACH1-IT1",1,3,4,0.75,0.25,1
"1531","BACH2",57,67,124,0.540322580645161,0.459677419354839,1
"1532","BAD",6,5,11,0.454545454545455,0.545454545454545,1
"1533","BAG1",6,11,17,0.647058823529412,0.352941176470588,1
"1534","BAG2",7,7,14,0.5,0.5,1
"1535","BAG3",16,27,43,0.627906976744186,0.372093023255814,1
"1536","BAG4",15,27,42,0.642857142857143,0.357142857142857,1
"1537","BAG5",17,10,27,0.37037037037037,0.62962962962963,1
"1538","BAG6",41,55,96,0.572916666666667,0.427083333333333,1
"1539","BAGE2",3,4,7,0.571428571428571,0.428571428571429,1
"1540","BAHCC1",59,71,130,0.546153846153846,0.453846153846154,1
"1541","BAHD1",37,41,78,0.525641025641026,0.474358974358974,1
"1542","BAIAP2",19,29,48,0.604166666666667,0.395833333333333,1
"1543","BAIAP2L1",26,27,53,0.509433962264151,0.490566037735849,1
"1544","BAIAP2L2",8,21,29,0.724137931034483,0.275862068965517,1
"1545","BAIAP3",32,69,101,0.683168316831683,0.316831683168317,1
"1546","BAK1",9,11,20,0.55,0.45,1
"1547","BAMBI",10,22,32,0.6875,0.3125,1
"1548","BANF1",5,4,9,0.444444444444444,0.555555555555556,1
"1549","BANF2",2,4,6,0.666666666666667,0.333333333333333,1
"1550","BANK1",38,78,116,0.672413793103448,0.327586206896552,0.44
"1551","BANP",16,29,45,0.644444444444444,0.355555555555556,1
"1552","BAP1",76,116,192,0.604166666666667,0.395833333333333,1
"1553","BARD1",42,52,94,0.553191489361702,0.446808510638298,0.77
"1554","BARHL1",13,21,34,0.617647058823529,0.382352941176471,0.77
"1555","BARHL2",14,30,44,0.681818181818182,0.318181818181818,0.77
"1556","BARX1",4,8,12,0.666666666666667,0.333333333333333,0.77
"1557","BARX2",10,24,34,0.705882352941177,0.294117647058824,0.77
"1558","BASP1",11,21,32,0.65625,0.34375,1
"1559","BATF",4,11,15,0.733333333333333,0.266666666666667,1
"1560","BATF2",5,17,22,0.772727272727273,0.227272727272727,1
"1561","BATF3",5,9,14,0.642857142857143,0.357142857142857,1
"1562","BAX",6,22,28,0.785714285714286,0.214285714285714,1
"1563","BAZ1A",49,73,122,0.598360655737705,0.401639344262295,1
"1564","BAZ1B",40,68,108,0.62962962962963,0.37037037037037,1
"1565","BAZ2A",58,64,122,0.524590163934426,0.475409836065574,1
"1566","BAZ2B",82,127,209,0.607655502392344,0.392344497607655,1
"1567","BBC3",3,1,4,0.25,0.75,1
"1568","BBOF1",16,18,34,0.529411764705882,0.470588235294118,1
"1569","BBOX1",18,38,56,0.678571428571429,0.321428571428571,1
"1570","BBS1",0,5,5,1,0,1
"1571","BBS10",20,36,56,0.642857142857143,0.357142857142857,1
"1572","BBS12",18,40,58,0.689655172413793,0.310344827586207,1
"1573","BBS2",25,39,64,0.609375,0.390625,1
"1574","BBS4",12,25,37,0.675675675675676,0.324324324324324,1
"1575","BBS5",7,14,21,0.666666666666667,0.333333333333333,1
"1576","BBS7",34,46,80,0.575,0.425,1
"1577","BBS9",44,72,116,0.620689655172414,0.379310344827586,1
"1578","BBX",31,63,94,0.670212765957447,0.329787234042553,1
"1579","BCAM",24,56,80,0.7,0.3,1
"1580","BCAN",57,77,134,0.574626865671642,0.425373134328358,1
"1581","BCAP31",10,4,14,0.285714285714286,0.714285714285714,1
"1582","BCAR1",26,32,58,0.551724137931034,0.448275862068966,0.77
"1583","BCAR3",28,44,72,0.611111111111111,0.388888888888889,0.77
"1584","BCAS1",32,65,97,0.670103092783505,0.329896907216495,1
"1585","BCAS2",8,18,26,0.692307692307692,0.307692307692308,1
"1586","BCAS3",38,71,109,0.651376146788991,0.348623853211009,1
"1587","BCAS4",3,9,12,0.75,0.25,1
"1588","BCAT1",23,30,53,0.566037735849057,0.433962264150943,1
"1589","BCAT2",10,19,29,0.655172413793103,0.344827586206897,1
"1590","BCCIP",6,15,21,0.714285714285714,0.285714285714286,1
"1591","BCDIN3D",8,15,23,0.652173913043478,0.347826086956522,1
"1592","BCHE",62,98,160,0.6125,0.3875,1
"1593","BCKDHA",3,3,6,0.5,0.5,1
"1594","BCKDHB",17,23,40,0.575,0.425,1
"1595","BCKDK",17,19,36,0.527777777777778,0.472222222222222,1
"1596","BCL10",14,16,30,0.533333333333333,0.466666666666667,1
"1597","BCL11A",65,97,162,0.598765432098765,0.401234567901235,1
"1598","BCL11B",33,67,100,0.67,0.33,1
"1599","BCL2",12,11,23,0.478260869565217,0.521739130434783,1
"1600","BCL2A1",8,14,22,0.636363636363636,0.363636363636364,1
"1601","BCL2L1",10,6,16,0.375,0.625,1
"1602","BCL2L10",6,5,11,0.454545454545455,0.545454545454545,1
"1603","BCL2L11",10,21,31,0.67741935483871,0.32258064516129,1
"1604","BCL2L12",8,17,25,0.68,0.32,1
"1605","BCL2L13",14,25,39,0.641025641025641,0.358974358974359,1
"1606","BCL2L14",8,19,27,0.703703703703704,0.296296296296296,1
"1607","BCL2L15",7,6,13,0.461538461538462,0.538461538461538,1
"1608","BCL2L2",5,10,15,0.666666666666667,0.333333333333333,1
"1609","BCL2L2-PABPN1",7,3,10,0.3,0.7,1
"1610","BCL3",13,25,38,0.657894736842105,0.342105263157895,1
"1611","BCL6",33,48,81,0.592592592592593,0.407407407407407,1
"1612","BCL6B",23,37,60,0.616666666666667,0.383333333333333,1
"1613","BCL7A",8,11,19,0.578947368421053,0.421052631578947,1
"1614","BCL7B",4,6,10,0.6,0.4,1
"1615","BCL7C",8,13,21,0.619047619047619,0.380952380952381,1
"1616","BCL9",70,98,168,0.583333333333333,0.416666666666667,1
"1617","BCL9L",73,125,198,0.631313131313131,0.368686868686869,1
"1618","BCLAF1",40,84,124,0.67741935483871,0.32258064516129,1
"1619","BCLAF3",36,20,56,0.357142857142857,0.642857142857143,1
"1620","BCO1",21,35,56,0.625,0.375,1
"1621","BCO2",31,32,63,0.507936507936508,0.492063492063492,1
"1622","BCOR",112,87,199,0.437185929648241,0.562814070351759,1
"1623","BCORL1",135,88,223,0.394618834080717,0.605381165919282,1
"1624","BCR",43,55,98,0.561224489795918,0.438775510204082,1
"1625","BCS1L",11,13,24,0.541666666666667,0.458333333333333,1
"1626","BDH1",14,20,34,0.588235294117647,0.411764705882353,1
"1627","BDH2",4,7,11,0.636363636363636,0.363636363636364,1
"1628","BDKRB1",11,33,44,0.75,0.25,1
"1629","BDKRB2",10,37,47,0.787234042553192,0.212765957446809,1
"1630","BDNF",11,25,36,0.694444444444444,0.305555555555556,1
"1631","BDP1",112,135,247,0.546558704453441,0.453441295546559,1
"1632","BECN1",7,25,32,0.78125,0.21875,1
"1633","BEGAIN",10,18,28,0.642857142857143,0.357142857142857,1
"1634","BEND2",66,51,117,0.435897435897436,0.564102564102564,1
"1635","BEND3",38,64,102,0.627450980392157,0.372549019607843,1
"1636","BEND4",19,51,70,0.728571428571429,0.271428571428571,1
"1637","BEND5",13,24,37,0.648648648648649,0.351351351351351,1
"1638","BEND6",20,23,43,0.534883720930233,0.465116279069767,1
"1639","BEND7",16,27,43,0.627906976744186,0.372093023255814,1
"1640","BEST1",19,21,40,0.525,0.475,1
"1641","BEST2",20,32,52,0.615384615384615,0.384615384615385,1
"1642","BEST3",47,85,132,0.643939393939394,0.356060606060606,1
"1643","BEST4",12,20,32,0.625,0.375,1
"1644","BET1",5,4,9,0.444444444444444,0.555555555555556,1
"1645","BET1L",4,2,6,0.333333333333333,0.666666666666667,1
"1646","BET1P1",0,2,2,1,0,1
"1647","BEX1",14,7,21,0.333333333333333,0.666666666666667,1
"1648","BEX2",7,7,14,0.5,0.5,1
"1649","BEX3",4,10,14,0.714285714285714,0.285714285714286,1
"1650","BEX4",4,2,6,0.333333333333333,0.666666666666667,1
"1651","BEX5",9,7,16,0.4375,0.5625,1
"1652","BFAR",26,18,44,0.409090909090909,0.590909090909091,0.77
"1653","BFSP1",23,28,51,0.549019607843137,0.450980392156863,1
"1654","BFSP2",17,43,60,0.716666666666667,0.283333333333333,1
"1655","BGLAP",4,4,8,0.5,0.5,1
"1656","BGN",17,16,33,0.484848484848485,0.515151515151515,1
"1657","BHLHA15",3,2,5,0.4,0.6,1
"1658","BHLHE22",18,13,31,0.419354838709677,0.580645161290323,1
"1659","BHLHE23",4,8,12,0.666666666666667,0.333333333333333,1
"1660","BHLHE40",17,25,42,0.595238095238095,0.404761904761905,1
"1661","BHLHE41",4,17,21,0.80952380952381,0.19047619047619,1
"1662","BHMT",15,37,52,0.711538461538462,0.288461538461538,1
"1663","BHMT2",20,25,45,0.555555555555556,0.444444444444444,1
"1664","BICC1",51,84,135,0.622222222222222,0.377777777777778,1
"1665","BICD1",45,57,102,0.558823529411765,0.441176470588235,1
"1666","BICD2",27,43,70,0.614285714285714,0.385714285714286,1
"1667","BICDL1",22,32,54,0.592592592592593,0.407407407407407,1
"1668","BICDL2",11,14,25,0.56,0.44,1
"1669","BICRA",37,54,91,0.593406593406593,0.406593406593407,1
"1670","BICRAL",31,67,98,0.683673469387755,0.316326530612245,1
"1671","BID",3,18,21,0.857142857142857,0.142857142857143,1
"1672","BIK",5,3,8,0.375,0.625,1
"1673","BIN1",20,28,48,0.583333333333333,0.416666666666667,1
"1674","BIN2",20,49,69,0.710144927536232,0.289855072463768,1
"1675","BIN3",15,8,23,0.347826086956522,0.652173913043478,1
"1676","BIRC2",17,26,43,0.604651162790698,0.395348837209302,1
"1677","BIRC3",24,40,64,0.625,0.375,1
"1678","BIRC5",4,7,11,0.636363636363636,0.363636363636364,1
"1679","BIRC6",179,294,473,0.621564482029598,0.378435517970402,1
"1680","BIRC7",13,18,31,0.580645161290323,0.419354838709677,1
"1681","BIRC8",27,46,73,0.63013698630137,0.36986301369863,1
"1682","BIVM",1,2,3,0.666666666666667,0.333333333333333,1
"1683","BIVM-ERCC5",59,95,154,0.616883116883117,0.383116883116883,1
"1684","BLCAP",4,4,8,0.5,0.5,1
"1685","BLID",5,14,19,0.736842105263158,0.263157894736842,1
"1686","BLK",35,48,83,0.578313253012048,0.421686746987952,1
"1687","BLM",67,77,144,0.534722222222222,0.465277777777778,1
"1688","BLMH",17,27,44,0.613636363636364,0.386363636363636,1
"1689","BLNK",17,50,67,0.746268656716418,0.253731343283582,1
"1690","BLOC1S1",3,4,7,0.571428571428571,0.428571428571429,1
"1691","BLOC1S2",6,9,15,0.6,0.4,1
"1692","BLOC1S3",1,4,5,0.8,0.2,1
"1693","BLOC1S4",4,6,10,0.6,0.4,1
"1694","BLOC1S5",6,5,11,0.454545454545455,0.545454545454545,1
"1695","BLOC1S6",8,5,13,0.384615384615385,0.615384615384615,1
"1696","BLVRA",14,22,36,0.611111111111111,0.388888888888889,1
"1697","BLVRB",2,8,10,0.8,0.2,1
"1698","BLZF1",24,27,51,0.529411764705882,0.470588235294118,1
"1699","BMERB1",10,19,29,0.655172413793103,0.344827586206897,1
"1700","BMF",9,15,24,0.625,0.375,1
"1701","BMI1",11,22,33,0.666666666666667,0.333333333333333,1
"1702","BMP1",35,43,78,0.551282051282051,0.448717948717949,1
"1703","BMP10",28,47,75,0.626666666666667,0.373333333333333,1
"1704","BMP15",25,29,54,0.537037037037037,0.462962962962963,1
"1705","BMP2",23,32,55,0.581818181818182,0.418181818181818,1
"1706","BMP2K",34,41,75,0.546666666666667,0.453333333333333,1
"1707","BMP2KL",0,4,4,1,0,1
"1708","BMP3",43,59,102,0.57843137254902,0.42156862745098,1
"1709","BMP4",16,35,51,0.686274509803922,0.313725490196078,1
"1710","BMP5",55,89,144,0.618055555555556,0.381944444444444,1
"1711","BMP6",27,41,68,0.602941176470588,0.397058823529412,1
"1712","BMP7",14,48,62,0.774193548387097,0.225806451612903,1
"1713","BMP8A",7,8,15,0.533333333333333,0.466666666666667,1
"1714","BMP8B",8,9,17,0.529411764705882,0.470588235294118,1
"1715","BMPER",51,101,152,0.664473684210526,0.335526315789474,1
"1716","BMPR1A",26,35,61,0.573770491803279,0.426229508196721,1
"1717","BMPR1B",30,42,72,0.583333333333333,0.416666666666667,1
"1718","BMPR2",96,84,180,0.466666666666667,0.533333333333333,1
"1719","BMS1",56,75,131,0.572519083969466,0.427480916030534,1
"1720","BMT2",21,35,56,0.625,0.375,1
"1721","BMX",37,25,62,0.403225806451613,0.596774193548387,1
"1722","BNC1",68,98,166,0.590361445783133,0.409638554216867,1
"1723","BNC2",81,115,196,0.586734693877551,0.413265306122449,1
"1724","BNIP1",17,12,29,0.413793103448276,0.586206896551724,1
"1725","BNIP2",8,8,16,0.5,0.5,1
"1726","BNIP3",8,8,16,0.5,0.5,1
"1727","BNIP3L",2,8,10,0.8,0.2,1
"1728","BNIP5",35,58,93,0.623655913978495,0.376344086021505,1
"1729","BNIPL",7,19,26,0.730769230769231,0.269230769230769,1
"1730","BOC",52,78,130,0.6,0.4,1
"1731","BOD1",6,5,11,0.454545454545455,0.545454545454545,1
"1732","BOD1L1",100,159,259,0.613899613899614,0.386100386100386,1
"1733","BOK",1,3,4,0.75,0.25,1
"1734","BOLA1",7,9,16,0.5625,0.4375,1
"1735","BOLA3",0,8,8,1,0,1
"1736","BOLL",18,20,38,0.526315789473684,0.473684210526316,1
"1737","BOP1",24,37,61,0.60655737704918,0.39344262295082,1
"1738","BORA",15,26,41,0.634146341463415,0.365853658536585,1
"1739","BORCS5",5,15,20,0.75,0.25,1
"1740","BORCS6",7,7,14,0.5,0.5,1
"1741","BORCS7",5,4,9,0.444444444444444,0.555555555555556,1
"1742","BORCS8-MEF2B",1,1,2,0.5,0.5,1
"1743","BPGM",7,16,23,0.695652173913043,0.304347826086957,1
"1744","BPHL",13,9,22,0.409090909090909,0.590909090909091,1
"1745","BPI",29,35,64,0.546875,0.453125,1
"1746","BPIFA1",18,27,45,0.6,0.4,1
"1747","BPIFA2",6,23,29,0.793103448275862,0.206896551724138,1
"1748","BPIFA3",7,27,34,0.794117647058823,0.205882352941176,1
"1749","BPIFB1",19,34,53,0.641509433962264,0.358490566037736,1
"1750","BPIFB2",29,59,88,0.670454545454545,0.329545454545455,1
"1751","BPIFB3",22,31,53,0.584905660377358,0.415094339622642,1
"1752","BPIFB4",29,73,102,0.715686274509804,0.284313725490196,1
"1753","BPIFB6",36,44,80,0.55,0.45,1
"1754","BPIFC",33,41,74,0.554054054054054,0.445945945945946,1
"1755","BPNT1",18,19,37,0.513513513513513,0.486486486486487,1
"1756","BPNT2",10,23,33,0.696969696969697,0.303030303030303,1
"1757","BPTF",99,156,255,0.611764705882353,0.388235294117647,1
"1758","BPY2C",0,1,1,1,0,1
"1759","BRAF",408,382,790,0.483544303797468,0.516455696202532,1
"1760","BRAP",14,26,40,0.65,0.35,1
"1761","BRAT1",18,39,57,0.684210526315789,0.315789473684211,1
"1762","BRCA1",61,100,161,0.62111801242236,0.37888198757764,1
"1763","BRCA2",132,233,365,0.638356164383562,0.361643835616438,1
"1764","BRCC3",10,10,20,0.5,0.5,1
"1765","BRD1",55,60,115,0.521739130434783,0.478260869565217,1
"1766","BRD2",34,65,99,0.656565656565657,0.343434343434343,1
"1767","BRD3",34,48,82,0.585365853658537,0.414634146341463,1
"1768","BRD4",50,81,131,0.618320610687023,0.381679389312977,1
"1769","BRD7",34,48,82,0.585365853658537,0.414634146341463,1
"1770","BRD8",36,80,116,0.689655172413793,0.310344827586207,1
"1771","BRD9",16,22,38,0.578947368421053,0.421052631578947,1
"1772","BRDT",40,82,122,0.672131147540984,0.327868852459016,1
"1773","BRF1",30,32,62,0.516129032258065,0.483870967741935,1
"1774","BRF2",18,25,43,0.581395348837209,0.418604651162791,1
"1775","BRI3",1,1,2,0.5,0.5,1
"1776","BRI3BP",12,10,22,0.454545454545455,0.545454545454545,1
"1777","BRICD5",4,11,15,0.733333333333333,0.266666666666667,1
"1778","BRINP1",72,146,218,0.669724770642202,0.330275229357798,1
"1779","BRINP2",72,146,218,0.669724770642202,0.330275229357798,1
"1780","BRINP3",143,246,389,0.632390745501285,0.367609254498715,1
"1781","BRIP1",47,84,131,0.641221374045801,0.358778625954198,1
"1782","BRIX1",6,16,22,0.727272727272727,0.272727272727273,1
"1783","BRK1",2,2,4,0.5,0.5,1
"1784","BRMS1",14,23,37,0.621621621621622,0.378378378378378,1
"1785","BRMS1L",14,8,22,0.363636363636364,0.636363636363636,1
"1786","BROX",16,19,35,0.542857142857143,0.457142857142857,1
"1787","BRPF1",48,47,95,0.494736842105263,0.505263157894737,1
"1788","BRPF3",43,68,111,0.612612612612613,0.387387387387387,1
"1789","BRS3",19,26,45,0.577777777777778,0.422222222222222,1
"1790","BRSK1",40,75,115,0.652173913043478,0.347826086956522,1
"1791","BRSK2",21,31,52,0.596153846153846,0.403846153846154,1
"1792","BRWD1",73,131,204,0.642156862745098,0.357843137254902,1
"1793","BRWD3",170,90,260,0.346153846153846,0.653846153846154,1
"1794","BSCL2",12,19,31,0.612903225806452,0.387096774193548,1
"1795","BSDC1",10,27,37,0.72972972972973,0.27027027027027,1
"1796","BSG",12,20,32,0.625,0.375,1
"1797","BSN",136,232,368,0.630434782608696,0.369565217391304,1
"1798","BSND",16,27,43,0.627906976744186,0.372093023255814,1
"1799","BSPRY",13,16,29,0.551724137931034,0.448275862068966,1
"1800","BST1",9,15,24,0.625,0.375,1
"1801","BST2",4,4,8,0.5,0.5,1
"1802","BSX",26,15,41,0.365853658536585,0.634146341463415,1
"1803","BTAF1",70,93,163,0.570552147239264,0.429447852760736,1
"1804","BTBD1",13,22,35,0.628571428571429,0.371428571428571,1
"1805","BTBD10",24,22,46,0.478260869565217,0.521739130434783,1
"1806","BTBD11",62,94,156,0.602564102564103,0.397435897435897,1
"1807","BTBD16",17,42,59,0.711864406779661,0.288135593220339,1
"1808","BTBD17",11,11,22,0.5,0.5,1
"1809","BTBD18",0,4,4,1,0,1
"1810","BTBD2",12,22,34,0.647058823529412,0.352941176470588,1
"1811","BTBD3",27,31,58,0.53448275862069,0.46551724137931,1
"1812","BTBD6",8,14,22,0.636363636363636,0.363636363636364,1
"1813","BTBD7",52,90,142,0.633802816901408,0.366197183098592,1
"1814","BTBD8",13,45,58,0.775862068965517,0.224137931034483,1
"1815","BTBD9",25,28,53,0.528301886792453,0.471698113207547,1
"1816","BTC",4,17,21,0.80952380952381,0.19047619047619,1
"1817","BTD",18,16,34,0.470588235294118,0.529411764705882,1
"1818","BTF3",5,11,16,0.6875,0.3125,1
"1819","BTF3L4",5,6,11,0.545454545454545,0.454545454545455,1
"1820","BTG1",10,15,25,0.6,0.4,1
"1821","BTG2",13,20,33,0.606060606060606,0.393939393939394,1
"1822","BTG3",7,17,24,0.708333333333333,0.291666666666667,1
"1823","BTG4",11,17,28,0.607142857142857,0.392857142857143,1
"1824","BTK",55,47,102,0.46078431372549,0.53921568627451,1
"1825","BTLA",10,18,28,0.642857142857143,0.357142857142857,1
"1826","BTN1A1",32,50,82,0.609756097560976,0.390243902439024,1
"1827","BTN2A1",17,31,48,0.645833333333333,0.354166666666667,1
"1828","BTN2A2",27,38,65,0.584615384615385,0.415384615384615,1
"1829","BTN2A3P",24,36,60,0.6,0.4,1
"1830","BTN3A1",12,34,46,0.739130434782609,0.260869565217391,1
"1831","BTN3A2",20,25,45,0.555555555555556,0.444444444444444,1
"1832","BTN3A3",26,27,53,0.509433962264151,0.490566037735849,1
"1833","BTNL10",0,1,1,1,0,1
"1834","BTNL2",19,30,49,0.612244897959184,0.387755102040816,1
"1835","BTNL3",22,48,70,0.685714285714286,0.314285714285714,1
"1836","BTNL8",30,61,91,0.67032967032967,0.32967032967033,1
"1837","BTNL9",17,27,44,0.613636363636364,0.386363636363636,1
"1838","BTRC",30,33,63,0.523809523809524,0.476190476190476,1
"1839","BUB1",44,64,108,0.592592592592593,0.407407407407407,1
"1840","BUB1B",32,49,81,0.604938271604938,0.395061728395062,1
"1841","BUB3",9,11,20,0.55,0.45,1
"1842","BUD13",21,33,54,0.611111111111111,0.388888888888889,1
"1843","BUD23",6,22,28,0.785714285714286,0.214285714285714,1
"1844","BUD31",5,14,19,0.736842105263158,0.263157894736842,1
"1845","BVES",23,36,59,0.610169491525424,0.389830508474576,1
"1846","BX119917.1",9,6,15,0.4,0.6,1
"1847","BYSL",4,17,21,0.80952380952381,0.19047619047619,1
"1848","BZW1",18,22,40,0.55,0.45,1
"1849","BZW2",8,19,27,0.703703703703704,0.296296296296296,1
"1850","C10orf105",0,1,1,1,0,1
"1851","C10orf120",33,50,83,0.602409638554217,0.397590361445783,1
"1852","C10orf53",8,15,23,0.652173913043478,0.347826086956522,1
"1853","C10orf62",3,11,14,0.785714285714286,0.214285714285714,1
"1854","C10orf67",3,7,10,0.7,0.3,1
"1855","C10orf71",51,114,165,0.690909090909091,0.309090909090909,1
"1856","C10orf82",9,11,20,0.55,0.45,1
"1857","C10orf88",16,28,44,0.636363636363636,0.363636363636364,1
"1858","C10orf90",53,70,123,0.569105691056911,0.430894308943089,1
"1859","C10orf95",0,1,1,1,0,1
"1860","C10orf99",1,8,9,0.888888888888889,0.111111111111111,1
"1861","C11orf1",5,14,19,0.736842105263158,0.263157894736842,1
"1862","C11orf16",17,26,43,0.604651162790698,0.395348837209302,1
"1863","C11orf24",11,30,41,0.731707317073171,0.268292682926829,1
"1864","C11orf40",7,25,32,0.78125,0.21875,1
"1865","C11orf42",8,19,27,0.703703703703704,0.296296296296296,1
"1866","C11orf45",5,7,12,0.583333333333333,0.416666666666667,1
"1867","C11orf49",8,15,23,0.652173913043478,0.347826086956522,1
"1868","C11orf52",4,8,12,0.666666666666667,0.333333333333333,1
"1869","C11orf53",9,24,33,0.727272727272727,0.272727272727273,1
"1870","C11orf54",8,14,22,0.636363636363636,0.363636363636364,1
"1871","C11orf58",7,9,16,0.5625,0.4375,1
"1872","C11orf65",8,20,28,0.714285714285714,0.285714285714286,1
"1873","C11orf68",7,6,13,0.461538461538462,0.538461538461538,1
"1874","C11orf71",7,8,15,0.533333333333333,0.466666666666667,1
"1875","C11orf80",15,21,36,0.583333333333333,0.416666666666667,1
"1876","C11orf86",1,0,1,0,1,1
"1877","C11orf87",19,22,41,0.536585365853659,0.463414634146341,1
"1878","C11orf94",4,5,9,0.555555555555556,0.444444444444444,1
"1879","C11orf95",0,1,1,1,0,1
"1880","C11orf96",1,0,1,0,1,1
"1881","C12orf29",7,9,16,0.5625,0.4375,1
"1882","C12orf4",22,36,58,0.620689655172414,0.379310344827586,1
"1883","C12orf40",42,91,133,0.684210526315789,0.315789473684211,1
"1884","C12orf42",20,42,62,0.67741935483871,0.32258064516129,1
"1885","C12orf43",6,22,28,0.785714285714286,0.214285714285714,1
"1886","C12orf45",9,11,20,0.55,0.45,1
"1887","C12orf50",23,75,98,0.76530612244898,0.23469387755102,1
"1888","C12orf54",8,19,27,0.703703703703704,0.296296296296296,1
"1889","C12orf56",9,28,37,0.756756756756757,0.243243243243243,1
"1890","C12orf57",1,6,7,0.857142857142857,0.142857142857143,1
"1891","C12orf60",5,18,23,0.782608695652174,0.217391304347826,1
"1892","C12orf65",4,6,10,0.6,0.4,1
"1893","C12orf66",13,32,45,0.711111111111111,0.288888888888889,1
"1894","C12orf71",9,21,30,0.7,0.3,1
"1895","C12orf75",0,1,1,1,0,1
"1896","C12orf76",2,9,11,0.818181818181818,0.181818181818182,1
"1897","C12orf77",9,24,33,0.727272727272727,0.272727272727273,1
"1898","C14orf119",3,6,9,0.666666666666667,0.333333333333333,1
"1899","C14orf177",14,19,33,0.575757575757576,0.424242424242424,1
"1900","C14orf178",4,1,5,0.2,0.8,1
"1901","C14orf180",5,7,12,0.583333333333333,0.416666666666667,1
"1902","C14orf28",14,16,30,0.533333333333333,0.466666666666667,1
"1903","C14orf39",42,76,118,0.644067796610169,0.355932203389831,1
"1904","C14orf93",12,22,34,0.647058823529412,0.352941176470588,1
"1905","C15orf32",0,3,3,1,0,1
"1906","C15orf39",43,50,93,0.537634408602151,0.462365591397849,1
"1907","C15orf40",4,5,9,0.555555555555556,0.444444444444444,1
"1908","C15orf48",2,7,9,0.777777777777778,0.222222222222222,1
"1909","C15orf54",9,19,28,0.678571428571429,0.321428571428571,1
"1910","C16orf46",17,27,44,0.613636363636364,0.386363636363636,1
"1911","C16orf54",2,9,11,0.818181818181818,0.181818181818182,1
"1912","C16orf70",17,25,42,0.595238095238095,0.404761904761905,1
"1913","C16orf71",14,31,45,0.688888888888889,0.311111111111111,1
"1914","C16orf72",8,12,20,0.6,0.4,1
"1915","C16orf74",3,0,3,0,1,1
"1916","C16orf78",17,34,51,0.666666666666667,0.333333333333333,1
"1917","C16orf82",6,14,20,0.7,0.3,1
"1918","C16orf86",8,10,18,0.555555555555556,0.444444444444444,1
"1919","C16orf87",8,6,14,0.428571428571429,0.571428571428571,1
"1920","C16orf89",11,18,29,0.620689655172414,0.379310344827586,1
"1921","C16orf90",6,12,18,0.666666666666667,0.333333333333333,1
"1922","C16orf91",0,8,8,1,0,1
"1923","C16orf92",8,11,19,0.578947368421053,0.421052631578947,1
"1924","C16orf96",2,7,9,0.777777777777778,0.222222222222222,1
"1925","C17orf100",1,3,4,0.75,0.25,1
"1926","C17orf107",0,1,1,1,0,1
"1927","C17orf49",1,6,7,0.857142857142857,0.142857142857143,1
"1928","C17orf50",2,1,3,0.333333333333333,0.666666666666667,1
"1929","C17orf58",3,3,6,0.5,0.5,1
"1930","C17orf64",3,14,17,0.823529411764706,0.176470588235294,1
"1931","C17orf67",3,5,8,0.625,0.375,1
"1932","C17orf75",19,15,34,0.441176470588235,0.558823529411765,1
"1933","C17orf78",6,14,20,0.7,0.3,1
"1934","C17orf80",16,20,36,0.555555555555556,0.444444444444444,1
"1935","C17orf97",11,18,29,0.620689655172414,0.379310344827586,1
"1936","C17orf98",13,10,23,0.434782608695652,0.565217391304348,1
"1937","C18orf21",3,10,13,0.769230769230769,0.230769230769231,1
"1938","C18orf25",8,13,21,0.619047619047619,0.380952380952381,1
"1939","C18orf32",3,7,10,0.7,0.3,1
"1940","C18orf54",14,22,36,0.611111111111111,0.388888888888889,1
"1941","C19orf12",7,14,21,0.666666666666667,0.333333333333333,1
"1942","C19orf18",10,21,31,0.67741935483871,0.32258064516129,1
"1943","C19orf25",1,3,4,0.75,0.25,1
"1944","C19orf33",1,5,6,0.833333333333333,0.166666666666667,1
"1945","C19orf38",0,1,1,1,0,1
"1946","C19orf44",27,39,66,0.590909090909091,0.409090909090909,1
"1947","C19orf47",11,13,24,0.541666666666667,0.458333333333333,1
"1948","C19orf53",2,9,11,0.818181818181818,0.181818181818182,1
"1949","C19orf54",3,12,15,0.8,0.2,1
"1950","C19orf57",19,42,61,0.688524590163934,0.311475409836066,1
"1951","C19orf71",0,2,2,1,0,1
"1952","C19orf73",5,4,9,0.444444444444444,0.555555555555556,1
"1953","C1D",5,9,14,0.642857142857143,0.357142857142857,1
"1954","C1GALT1",13,25,38,0.657894736842105,0.342105263157895,1
"1955","C1GALT1C1",15,21,36,0.583333333333333,0.416666666666667,1
"1956","C1GALT1C1L",12,19,31,0.612903225806452,0.387096774193548,1
"1957","C1orf100",5,15,20,0.75,0.25,1
"1958","C1orf105",7,21,28,0.75,0.25,1
"1959","C1orf109",6,7,13,0.538461538461538,0.461538461538462,1
"1960","C1orf112",22,40,62,0.645161290322581,0.354838709677419,1
"1961","C1orf115",5,3,8,0.375,0.625,1
"1962","C1orf116",27,41,68,0.602941176470588,0.397058823529412,1
"1963","C1orf122",6,3,9,0.333333333333333,0.666666666666667,1
"1964","C1orf127",18,59,77,0.766233766233766,0.233766233766234,1
"1965","C1orf131",11,19,30,0.633333333333333,0.366666666666667,1
"1966","C1orf141",19,41,60,0.683333333333333,0.316666666666667,1
"1967","C1orf146",2,11,13,0.846153846153846,0.153846153846154,1
"1968","C1orf158",11,26,37,0.702702702702703,0.297297297297297,1
"1969","C1orf159",10,14,24,0.583333333333333,0.416666666666667,1
"1970","C1orf162",9,9,18,0.5,0.5,1
"1971","C1orf167",2,0,2,0,1,1
"1972","C1orf174",5,12,17,0.705882352941177,0.294117647058824,1
"1973","C1orf185",0,3,3,1,0,1
"1974","C1orf189",4,7,11,0.636363636363636,0.363636363636364,1
"1975","C1orf194",6,9,15,0.6,0.4,1
"1976","C1orf198",13,14,27,0.518518518518518,0.481481481481481,1
"1977","C1orf21",4,7,11,0.636363636363636,0.363636363636364,1
"1978","C1orf210",9,9,18,0.5,0.5,1
"1979","C1orf216",6,6,12,0.5,0.5,1
"1980","C1orf220",11,3,14,0.214285714285714,0.785714285714286,1
"1981","C1orf226",9,9,18,0.5,0.5,1
"1982","C1orf229",2,4,6,0.666666666666667,0.333333333333333,1
"1983","C1orf35",3,11,14,0.785714285714286,0.214285714285714,1
"1984","C1orf43",4,16,20,0.8,0.2,1
"1985","C1orf50",5,8,13,0.615384615384615,0.384615384615385,1
"1986","C1orf52",7,7,14,0.5,0.5,1
"1987","C1orf53",2,3,5,0.6,0.4,1
"1988","C1orf54",5,9,14,0.642857142857143,0.357142857142857,1
"1989","C1orf56",9,21,30,0.7,0.3,1
"1990","C1orf68",0,3,3,1,0,1
"1991","C1orf74",8,23,31,0.741935483870968,0.258064516129032,1
"1992","C1orf87",25,52,77,0.675324675324675,0.324675324675325,1
"1993","C1orf94",36,64,100,0.64,0.36,1
"1994","C1QA",20,19,39,0.487179487179487,0.512820512820513,1
"1995","C1QB",18,19,37,0.513513513513513,0.486486486486487,1
"1996","C1QBP",5,7,12,0.583333333333333,0.416666666666667,1
"1997","C1QC",21,15,36,0.416666666666667,0.583333333333333,1
"1998","C1QL1",10,8,18,0.444444444444444,0.555555555555556,1
"1999","C1QL2",12,8,20,0.4,0.6,1
"2000","C1QL3",7,11,18,0.611111111111111,0.388888888888889,1
"2001","C1QL4",3,7,10,0.7,0.3,1
"2002","C1QTNF1",24,19,43,0.441860465116279,0.558139534883721,1
"2003","C1QTNF12",4,10,14,0.714285714285714,0.285714285714286,1
"2004","C1QTNF2",9,29,38,0.763157894736842,0.236842105263158,1
"2005","C1QTNF3",17,22,39,0.564102564102564,0.435897435897436,1
"2006","C1QTNF4",6,8,14,0.571428571428571,0.428571428571429,1
"2007","C1QTNF5",3,6,9,0.666666666666667,0.333333333333333,1
"2008","C1QTNF6",1,13,14,0.928571428571429,0.0714285714285714,1
"2009","C1QTNF7",11,13,24,0.541666666666667,0.458333333333333,1
"2010","C1QTNF8",5,8,13,0.615384615384615,0.384615384615385,1
"2011","C1QTNF9",18,29,47,0.617021276595745,0.382978723404255,1
"2012","C1QTNF9B",8,27,35,0.771428571428571,0.228571428571429,1
"2013","C1R",29,47,76,0.618421052631579,0.381578947368421,1
"2014","C1RL",17,32,49,0.653061224489796,0.346938775510204,1
"2015","C1S",44,70,114,0.614035087719298,0.385964912280702,1
"2016","C2",11,14,25,0.56,0.44,1
"2017","C20orf141",2,6,8,0.75,0.25,1
"2018","C20orf144",0,1,1,1,0,1
"2019","C20orf194",40,86,126,0.682539682539683,0.317460317460317,1
"2020","C20orf197",8,9,17,0.529411764705882,0.470588235294118,1
"2021","C20orf202",1,0,1,0,1,1
"2022","C20orf203",0,1,1,1,0,1
"2023","C20orf204",2,4,6,0.666666666666667,0.333333333333333,1
"2024","C20orf27",10,12,22,0.545454545454545,0.454545454545455,1
"2025","C20orf85",8,22,30,0.733333333333333,0.266666666666667,1
"2026","C20orf96",9,15,24,0.625,0.375,1
"2027","C21orf58",10,13,23,0.565217391304348,0.434782608695652,1
"2028","C21orf62",5,9,14,0.642857142857143,0.357142857142857,1
"2029","C21orf91",4,15,19,0.789473684210526,0.210526315789474,1
"2030","C22orf15",4,3,7,0.428571428571429,0.571428571428571,1
"2031","C22orf23",8,17,25,0.68,0.32,1
"2032","C22orf31",9,18,27,0.666666666666667,0.333333333333333,1
"2033","C22orf34",0,7,7,1,0,1
"2034","C22orf39",1,2,3,0.666666666666667,0.333333333333333,1
"2035","C22orf42",17,24,41,0.585365853658537,0.414634146341463,1
"2036","C2CD2",24,33,57,0.578947368421053,0.421052631578947,1
"2037","C2CD2L",22,28,50,0.56,0.44,1
"2038","C2CD3",70,114,184,0.619565217391304,0.380434782608696,1
"2039","C2CD4A",0,6,6,1,0,1
"2040","C2CD4B",0,2,2,1,0,1
"2041","C2CD4C",0,1,1,1,0,1
"2042","C2CD5",44,64,108,0.592592592592593,0.407407407407407,1
"2043","C2CD6",34,29,63,0.46031746031746,0.53968253968254,1
"2044","C2orf15",4,8,12,0.666666666666667,0.333333333333333,1
"2045","C2orf16",91,166,257,0.64591439688716,0.35408560311284,1
"2046","C2orf42",24,20,44,0.454545454545455,0.545454545454545,1
"2047","C2orf49",6,11,17,0.647058823529412,0.352941176470588,1
"2048","C2orf50",2,4,6,0.666666666666667,0.333333333333333,1
"2049","C2orf66",7,5,12,0.416666666666667,0.583333333333333,1
"2050","C2orf68",6,5,11,0.454545454545455,0.545454545454545,1
"2051","C2orf69",10,12,22,0.545454545454545,0.454545454545455,1
"2052","C2orf73",6,10,16,0.625,0.375,1
"2053","C2orf74",1,2,3,0.666666666666667,0.333333333333333,1
"2054","C2orf76",4,8,12,0.666666666666667,0.333333333333333,1
"2055","C2orf78",43,89,132,0.674242424242424,0.325757575757576,1
"2056","C2orf80",17,22,39,0.564102564102564,0.435897435897436,1
"2057","C2orf83",8,15,23,0.652173913043478,0.347826086956522,1
"2058","C2orf88",5,4,9,0.444444444444444,0.555555555555556,1
"2059","C2orf91",1,0,1,0,1,1
"2060","C3",105,168,273,0.615384615384615,0.384615384615385,1
"2061","C3AR1",32,49,81,0.604938271604938,0.395061728395062,0.77
"2062","C3orf14",4,10,14,0.714285714285714,0.285714285714286,1
"2063","C3orf18",2,11,13,0.846153846153846,0.153846153846154,1
"2064","C3orf20",47,80,127,0.62992125984252,0.37007874015748,1
"2065","C3orf22",7,15,22,0.681818181818182,0.318181818181818,1
"2066","C3orf33",8,24,32,0.75,0.25,1
"2067","C3orf35",2,5,7,0.714285714285714,0.285714285714286,1
"2068","C3orf38",22,15,37,0.405405405405405,0.594594594594595,1
"2069","C3orf52",1,3,4,0.75,0.25,1
"2070","C3orf56",10,28,38,0.736842105263158,0.263157894736842,1
"2071","C3orf62",9,18,27,0.666666666666667,0.333333333333333,1
"2072","C3orf70",12,24,36,0.666666666666667,0.333333333333333,1
"2073","C3orf84",1,2,3,0.666666666666667,0.333333333333333,1
"2074","C3P1",29,53,82,0.646341463414634,0.353658536585366,1
"2075","C4A",19,14,33,0.424242424242424,0.575757575757576,1
"2076","C4B",10,25,35,0.714285714285714,0.285714285714286,1
"2077","C4BPA",29,49,78,0.628205128205128,0.371794871794872,1
"2078","C4BPB",10,19,29,0.655172413793103,0.344827586206897,1
"2079","C4orf17",15,38,53,0.716981132075472,0.283018867924528,1
"2080","C4orf19",6,20,26,0.769230769230769,0.230769230769231,1
"2081","C4orf3",2,6,8,0.75,0.25,1
"2082","C4orf33",5,13,18,0.722222222222222,0.277777777777778,1
"2083","C4orf45",5,14,19,0.736842105263158,0.263157894736842,1
"2084","C4orf46",4,4,8,0.5,0.5,1
"2085","C4orf47",0,1,1,1,0,1
"2086","C4orf50",28,23,51,0.450980392156863,0.549019607843137,1
"2087","C4orf51",6,15,21,0.714285714285714,0.285714285714286,1
"2088","C5",40,92,132,0.696969696969697,0.303030303030303,1
"2089","C5AR1",13,32,45,0.711111111111111,0.288888888888889,0.77
"2090","C5AR2",16,18,34,0.529411764705882,0.470588235294118,0.77
"2091","C5orf15",7,12,19,0.631578947368421,0.368421052631579,1
"2092","C5orf22",18,24,42,0.571428571428571,0.428571428571429,1
"2093","C5orf24",8,9,17,0.529411764705882,0.470588235294118,1
"2094","C5orf34",15,32,47,0.680851063829787,0.319148936170213,1
"2095","C5orf38",9,14,23,0.608695652173913,0.391304347826087,1
"2096","C5orf46",3,5,8,0.625,0.375,1
"2097","C5orf47",0,1,1,1,0,1
"2098","C5orf49",9,7,16,0.4375,0.5625,1
"2099","C5orf51",9,13,22,0.590909090909091,0.409090909090909,1
"2100","C5orf52",1,0,1,0,1,1
"2101","C5orf58",1,3,4,0.75,0.25,1
"2102","C5orf60",0,4,4,1,0,1
"2103","C6",115,198,313,0.63258785942492,0.36741214057508,1
"2104","C6orf118",53,78,131,0.595419847328244,0.404580152671756,1
"2105","C6orf120",5,7,12,0.583333333333333,0.416666666666667,1
"2106","C6orf136",12,9,21,0.428571428571429,0.571428571428571,1
"2107","C6orf141",0,1,1,1,0,1
"2108","C6orf15",14,33,47,0.702127659574468,0.297872340425532,1
"2109","C6orf201",3,10,13,0.769230769230769,0.230769230769231,1
"2110","C6orf223",6,13,19,0.684210526315789,0.315789473684211,1
"2111","C6orf226",4,3,7,0.428571428571429,0.571428571428571,1
"2112","C6orf47",6,10,16,0.625,0.375,1
"2113","C6orf58",17,47,64,0.734375,0.265625,1
"2114","C6orf62",10,18,28,0.642857142857143,0.357142857142857,1
"2115","C6orf89",13,21,34,0.617647058823529,0.382352941176471,1
"2116","C6orf99",0,1,1,1,0,1
"2117","C7",68,147,215,0.683720930232558,0.316279069767442,1
"2118","C7orf25",18,19,37,0.513513513513513,0.486486486486487,1
"2119","C7orf26",13,22,35,0.628571428571429,0.371428571428571,1
"2120","C7orf31",15,38,53,0.716981132075472,0.283018867924528,1
"2121","C7orf33",12,25,37,0.675675675675676,0.324324324324324,1
"2122","C7orf50",19,15,34,0.441176470588235,0.558823529411765,1
"2123","C7orf57",9,21,30,0.7,0.3,1
"2124","C7orf61",7,8,15,0.533333333333333,0.466666666666667,1
"2125","C7orf65",10,16,26,0.615384615384615,0.384615384615385,1
"2126","C7orf66",17,28,45,0.622222222222222,0.377777777777778,1
"2127","C8A",46,103,149,0.691275167785235,0.308724832214765,1
"2128","C8B",61,108,169,0.63905325443787,0.36094674556213,1
"2129","C8G",1,6,7,0.857142857142857,0.142857142857143,1
"2130","C8orf31",17,19,36,0.527777777777778,0.472222222222222,1
"2131","C8orf33",8,20,28,0.714285714285714,0.285714285714286,1
"2132","C8orf34",66,102,168,0.607142857142857,0.392857142857143,1
"2133","C8orf37",6,17,23,0.739130434782609,0.260869565217391,1
"2134","C8orf44-SGK3",0,1,1,1,0,1
"2135","C8orf48",0,5,5,1,0,1
"2136","C8orf58",4,13,17,0.764705882352941,0.235294117647059,1
"2137","C8orf74",8,25,33,0.757575757575758,0.242424242424242,1
"2138","C8orf76",10,26,36,0.722222222222222,0.277777777777778,1
"2139","C8orf82",4,3,7,0.428571428571429,0.571428571428571,1
"2140","C8orf86",8,18,26,0.692307692307692,0.307692307692308,1
"2141","C9",42,77,119,0.647058823529412,0.352941176470588,1
"2142","C9orf106",9,12,21,0.571428571428571,0.428571428571429,1
"2143","C9orf116",4,3,7,0.428571428571429,0.571428571428571,1
"2144","C9orf129",8,13,21,0.619047619047619,0.380952380952381,1
"2145","C9orf131",40,65,105,0.619047619047619,0.380952380952381,1
"2146","C9orf135",9,29,38,0.763157894736842,0.236842105263158,1
"2147","C9orf152",7,18,25,0.72,0.28,1
"2148","C9orf153",2,15,17,0.882352941176471,0.117647058823529,1
"2149","C9orf16",1,1,2,0.5,0.5,1
"2150","C9orf163",11,9,20,0.45,0.55,1
"2151","C9orf24",5,15,20,0.75,0.25,1
"2152","C9orf40",4,7,11,0.636363636363636,0.363636363636364,1
"2153","C9orf43",16,32,48,0.666666666666667,0.333333333333333,1
"2154","C9orf50",9,12,21,0.571428571428571,0.428571428571429,1
"2155","C9orf57",1,1,2,0.5,0.5,1
"2156","C9orf62",0,1,1,1,0,1
"2157","C9orf64",9,29,38,0.763157894736842,0.236842105263158,1
"2158","C9orf72",12,24,36,0.666666666666667,0.333333333333333,1
"2159","C9orf78",6,17,23,0.739130434782609,0.260869565217391,1
"2160","C9orf85",7,3,10,0.3,0.7,1
"2161","C9orf92",0,1,1,1,0,1
"2162","CA1",8,31,39,0.794871794871795,0.205128205128205,1
"2163","CA10",44,57,101,0.564356435643564,0.435643564356436,1
"2164","CA11",13,22,35,0.628571428571429,0.371428571428571,1
"2165","CA12",15,15,30,0.5,0.5,1
"2166","CA13",9,14,23,0.608695652173913,0.391304347826087,1
"2167","CA14",11,15,26,0.576923076923077,0.423076923076923,1
"2168","CA2",22,23,45,0.511111111111111,0.488888888888889,1
"2169","CA3",19,28,47,0.595744680851064,0.404255319148936,1
"2170","CA4",15,20,35,0.571428571428571,0.428571428571429,1
"2171","CA5A",6,17,23,0.739130434782609,0.260869565217391,1
"2172","CA5B",6,11,17,0.647058823529412,0.352941176470588,1
"2173","CA5BP1",0,2,2,1,0,1
"2174","CA6",19,25,44,0.568181818181818,0.431818181818182,1
"2175","CA7",11,14,25,0.56,0.44,1
"2176","CA8",16,30,46,0.652173913043478,0.347826086956522,1
"2177","CA9",20,28,48,0.583333333333333,0.416666666666667,1
"2178","CAAP1",11,11,22,0.5,0.5,1
"2179","CAB39",7,14,21,0.666666666666667,0.333333333333333,1
"2180","CAB39L",22,23,45,0.511111111111111,0.488888888888889,1
"2181","CABCOCO1",6,21,27,0.777777777777778,0.222222222222222,1
"2182","CABIN1",59,90,149,0.604026845637584,0.395973154362416,1
"2183","CABLES1",21,12,33,0.363636363636364,0.636363636363636,1
"2184","CABLES2",6,18,24,0.75,0.25,1
"2185","CABP1",12,13,25,0.52,0.48,1
"2186","CABP2",11,15,26,0.576923076923077,0.423076923076923,1
"2187","CABP4",10,27,37,0.72972972972973,0.27027027027027,1
"2188","CABP5",11,25,36,0.694444444444444,0.305555555555556,1
"2189","CABP7",7,11,18,0.611111111111111,0.388888888888889,1
"2190","CABS1",24,51,75,0.68,0.32,1
"2191","CABYR",16,20,36,0.555555555555556,0.444444444444444,1
"2192","CACFD1",6,2,8,0.25,0.75,1
"2193","CACHD1",57,76,133,0.571428571428571,0.428571428571429,1
"2194","CACNA1A",108,198,306,0.647058823529412,0.352941176470588,1
"2195","CACNA1B",104,162,266,0.609022556390977,0.390977443609023,1
"2196","CACNA1C",118,198,316,0.626582278481013,0.373417721518987,1
"2197","CACNA1D",98,158,256,0.6171875,0.3828125,1
"2198","CACNA1E",229,375,604,0.620860927152318,0.379139072847682,1
"2199","CACNA1F",120,78,198,0.393939393939394,0.606060606060606,1
"2200","CACNA1G",82,160,242,0.661157024793388,0.338842975206612,1
"2201","CACNA1H",102,148,250,0.592,0.408,1
"2202","CACNA1I",70,130,200,0.65,0.35,1
"2203","CACNA1S",100,181,281,0.644128113879004,0.355871886120996,1
"2204","CACNA2D1",88,152,240,0.633333333333333,0.366666666666667,1
"2205","CACNA2D2",28,51,79,0.645569620253165,0.354430379746835,1
"2206","CACNA2D3",65,145,210,0.69047619047619,0.30952380952381,1
"2207","CACNA2D4",43,105,148,0.709459459459459,0.290540540540541,1
"2208","CACNB1",16,28,44,0.636363636363636,0.363636363636364,1
"2209","CACNB2",35,69,104,0.663461538461538,0.336538461538462,1
"2210","CACNB3",14,22,36,0.611111111111111,0.388888888888889,1
"2211","CACNB4",19,40,59,0.677966101694915,0.322033898305085,1
"2212","CACNG1",16,11,27,0.407407407407407,0.592592592592593,1
"2213","CACNG2",32,29,61,0.475409836065574,0.524590163934426,1
"2214","CACNG3",41,64,105,0.60952380952381,0.39047619047619,1
"2215","CACNG4",11,24,35,0.685714285714286,0.314285714285714,1
"2216","CACNG5",20,43,63,0.682539682539683,0.317460317460317,1
"2217","CACNG6",18,24,42,0.571428571428571,0.428571428571429,1
"2218","CACNG7",30,42,72,0.583333333333333,0.416666666666667,1
"2219","CACNG8",11,31,42,0.738095238095238,0.261904761904762,1
"2220","CACTIN",24,35,59,0.593220338983051,0.406779661016949,1
"2221","CACUL1",13,23,36,0.638888888888889,0.361111111111111,1
"2222","CACYBP",10,19,29,0.655172413793103,0.344827586206897,1
"2223","CAD",80,99,179,0.553072625698324,0.446927374301676,1
"2224","CADM1",41,45,86,0.523255813953488,0.476744186046512,1
"2225","CADM2",40,94,134,0.701492537313433,0.298507462686567,1
"2226","CADM3",39,70,109,0.642201834862385,0.357798165137615,1
"2227","CADM4",11,24,35,0.685714285714286,0.314285714285714,1
"2228","CADPS",85,145,230,0.630434782608696,0.369565217391304,1
"2229","CADPS2",59,93,152,0.611842105263158,0.388157894736842,1
"2230","CAGE1",16,43,59,0.728813559322034,0.271186440677966,1
"2231","CALB1",16,26,42,0.619047619047619,0.380952380952381,0.86
"2232","CALB2",21,25,46,0.543478260869565,0.456521739130435,0.86
"2233","CALCA",14,19,33,0.575757575757576,0.424242424242424,1
"2234","CALCB",7,15,22,0.681818181818182,0.318181818181818,1
"2235","CALCOCO1",21,33,54,0.611111111111111,0.388888888888889,1
"2236","CALCOCO2",10,11,21,0.523809523809524,0.476190476190476,1
"2237","CALCR",56,82,138,0.594202898550725,0.405797101449275,1
"2238","CALCRL",28,64,92,0.695652173913043,0.304347826086957,1
"2239","CALD1",51,67,118,0.567796610169492,0.432203389830508,1
"2240","CALHM1",14,27,41,0.658536585365854,0.341463414634146,1
"2241","CALHM2",10,19,29,0.655172413793103,0.344827586206897,1
"2242","CALHM3",0,1,1,1,0,1
"2243","CALHM4",7,10,17,0.588235294117647,0.411764705882353,1
"2244","CALHM5",12,28,40,0.7,0.3,1
"2245","CALHM6",4,12,16,0.75,0.25,1
"2246","CALM1",5,14,19,0.736842105263158,0.263157894736842,1
"2247","CALM2",2,10,12,0.833333333333333,0.166666666666667,1
"2248","CALM3",3,3,6,0.5,0.5,1
"2249","CALML3",7,11,18,0.611111111111111,0.388888888888889,1
"2250","CALML4",2,11,13,0.846153846153846,0.153846153846154,1
"2251","CALML5",8,12,20,0.6,0.4,1
"2252","CALML6",2,8,10,0.8,0.2,1
"2253","CALN1",36,54,90,0.6,0.4,1
"2254","CALR",13,14,27,0.518518518518518,0.481481481481481,1
"2255","CALR3",14,20,34,0.588235294117647,0.411764705882353,1
"2256","CALU",10,21,31,0.67741935483871,0.32258064516129,1
"2257","CALY",2,7,9,0.777777777777778,0.222222222222222,1
"2258","CAMK1",14,21,35,0.6,0.4,1
"2259","CAMK1D",25,50,75,0.666666666666667,0.333333333333333,1
"2260","CAMK1G",24,29,53,0.547169811320755,0.452830188679245,1
"2261","CAMK2A",12,32,44,0.727272727272727,0.272727272727273,1
"2262","CAMK2B",27,31,58,0.53448275862069,0.46551724137931,1
"2263","CAMK2D",17,26,43,0.604651162790698,0.395348837209302,1
"2264","CAMK2G",21,26,47,0.553191489361702,0.446808510638298,1
"2265","CAMK2N1",2,9,11,0.818181818181818,0.181818181818182,1
"2266","CAMK2N2",2,1,3,0.333333333333333,0.666666666666667,1
"2267","CAMK4",19,59,78,0.756410256410256,0.243589743589744,1
"2268","CAMKK1",19,25,44,0.568181818181818,0.431818181818182,1
"2269","CAMKK2",19,30,49,0.612244897959184,0.387755102040816,1
"2270","CAMKMT",8,15,23,0.652173913043478,0.347826086956522,1
"2271","CAMKV",22,40,62,0.645161290322581,0.354838709677419,1
"2272","CAMLG",7,18,25,0.72,0.28,1
"2273","CAMP",6,12,18,0.666666666666667,0.333333333333333,1
"2274","CAMSAP1",48,63,111,0.567567567567568,0.432432432432432,1
"2275","CAMSAP2",71,84,155,0.541935483870968,0.458064516129032,1
"2276","CAMSAP3",34,58,92,0.630434782608696,0.369565217391304,1
"2277","CAMTA1",91,137,228,0.600877192982456,0.399122807017544,1
"2278","CAMTA2",54,57,111,0.513513513513513,0.486486486486487,1
"2279","CAND1",59,82,141,0.581560283687943,0.418439716312057,1
"2280","CAND2",33,63,96,0.65625,0.34375,1
"2281","CANT1",9,27,36,0.75,0.25,1
"2282","CANX",16,36,52,0.692307692307692,0.307692307692308,1
"2283","CAP1",9,18,27,0.666666666666667,0.333333333333333,1
"2284","CAP2",19,35,54,0.648148148148148,0.351851851851852,1
"2285","CAPG",6,21,27,0.777777777777778,0.222222222222222,1
"2286","CAPN1",17,20,37,0.540540540540541,0.459459459459459,1
"2287","CAPN10",20,38,58,0.655172413793103,0.344827586206897,1
"2288","CAPN11",31,42,73,0.575342465753425,0.424657534246575,1
"2289","CAPN12",15,29,44,0.659090909090909,0.340909090909091,1
"2290","CAPN13",33,67,100,0.67,0.33,1
"2291","CAPN14",1,6,7,0.857142857142857,0.142857142857143,1
"2292","CAPN15",28,44,72,0.611111111111111,0.388888888888889,1
"2293","CAPN2",25,35,60,0.583333333333333,0.416666666666667,1
"2294","CAPN3",29,50,79,0.632911392405063,0.367088607594937,1
"2295","CAPN5",29,45,74,0.608108108108108,0.391891891891892,1
"2296","CAPN6",52,70,122,0.573770491803279,0.426229508196721,1
"2297","CAPN7",22,32,54,0.592592592592593,0.407407407407407,1
"2298","CAPN8",0,1,1,1,0,1
"2299","CAPN9",23,43,66,0.651515151515151,0.348484848484849,1
"2300","CAPNS1",10,7,17,0.411764705882353,0.588235294117647,1
"2301","CAPNS2",3,12,15,0.8,0.2,1
"2302","CAPRIN1",23,40,63,0.634920634920635,0.365079365079365,1
"2303","CAPRIN2",48,72,120,0.6,0.4,1
"2304","CAPS",5,6,11,0.545454545454545,0.454545454545455,1
"2305","CAPS2",13,37,50,0.74,0.26,1
"2306","CAPSL",16,57,73,0.780821917808219,0.219178082191781,1
"2307","CAPZA1",12,19,31,0.612903225806452,0.387096774193548,1
"2308","CAPZA2",10,15,25,0.6,0.4,1
"2309","CAPZA3",23,52,75,0.693333333333333,0.306666666666667,1
"2310","CAPZB",8,9,17,0.529411764705882,0.470588235294118,1
"2311","CARD10",29,41,70,0.585714285714286,0.414285714285714,0.77
"2312","CARD11",96,172,268,0.641791044776119,0.358208955223881,0.77
"2313","CARD14",31,39,70,0.557142857142857,0.442857142857143,0.77
"2314","CARD16",4,13,17,0.764705882352941,0.235294117647059,0.77
"2315","CARD17",10,5,15,0.333333333333333,0.666666666666667,0.77
"2316","CARD18",5,16,21,0.761904761904762,0.238095238095238,0.77
"2317","CARD19",6,1,7,0.142857142857143,0.857142857142857,0.77
"2318","CARD6",53,90,143,0.629370629370629,0.370629370629371,0.77
"2319","CARD8",15,23,38,0.605263157894737,0.394736842105263,0.77
"2320","CARD9",14,19,33,0.575757575757576,0.424242424242424,0.77
"2321","CARF",20,48,68,0.705882352941177,0.294117647058824,0.77
"2322","CARHSP1",4,7,11,0.636363636363636,0.363636363636364,0.77
"2323","CARM1",19,28,47,0.595744680851064,0.404255319148936,0.77
"2324","CARM1P1",1,2,3,0.666666666666667,0.333333333333333,0.77
"2325","CARMIL1",55,69,124,0.556451612903226,0.443548387096774,0.77
"2326","CARMIL2",54,73,127,0.574803149606299,0.425196850393701,0.77
"2327","CARMIL3",45,74,119,0.621848739495798,0.378151260504202,0.77
"2328","CARNMT1",15,27,42,0.642857142857143,0.357142857142857,0.77
"2329","CARNS1",14,34,48,0.708333333333333,0.291666666666667,0.77
"2330","CARS1",19,39,58,0.672413793103448,0.327586206896552,0.77
"2331","CARS2",22,19,41,0.463414634146341,0.536585365853659,0.77
"2332","CARTPT",7,4,11,0.363636363636364,0.636363636363636,0.77
"2333","CASC3",30,36,66,0.545454545454545,0.454545454545455,1
"2334","CASD1",51,64,115,0.556521739130435,0.443478260869565,1
"2335","CASK",36,26,62,0.419354838709677,0.580645161290323,1
"2336","CASKIN1",32,44,76,0.578947368421053,0.421052631578947,1
"2337","CASKIN2",36,52,88,0.590909090909091,0.409090909090909,1
"2338","CASP1",19,43,62,0.693548387096774,0.306451612903226,1
"2339","CASP10",17,29,46,0.630434782608696,0.369565217391304,1
"2340","CASP14",10,30,40,0.75,0.25,1
"2341","CASP2",20,28,48,0.583333333333333,0.416666666666667,1
"2342","CASP3",13,13,26,0.5,0.5,1
"2343","CASP4",19,37,56,0.660714285714286,0.339285714285714,1
"2344","CASP5",43,52,95,0.547368421052632,0.452631578947368,1
"2345","CASP6",2,14,16,0.875,0.125,1
"2346","CASP7",10,22,32,0.6875,0.3125,1
"2347","CASP8",76,83,159,0.522012578616352,0.477987421383648,1
"2348","CASP8AP2",55,96,151,0.635761589403974,0.364238410596026,1
"2349","CASP9",9,15,24,0.625,0.375,1
"2350","CASQ1",16,31,47,0.659574468085106,0.340425531914894,1
"2351","CASQ2",22,28,50,0.56,0.44,1
"2352","CASR",65,159,224,0.709821428571429,0.290178571428571,1
"2353","CASS4",52,96,148,0.648648648648649,0.351351351351351,1
"2354","CAST",17,32,49,0.653061224489796,0.346938775510204,1
"2355","CASTOR1",0,10,10,1,0,1
"2356","CASTOR2",0,1,1,1,0,1
"2357","CASTOR3",1,6,7,0.857142857142857,0.142857142857143,1
"2358","CASZ1",67,99,166,0.596385542168675,0.403614457831325,1
"2359","CAT",21,28,49,0.571428571428571,0.428571428571429,1
"2360","CATIP",13,18,31,0.580645161290323,0.419354838709677,1
"2361","CATSPER1",33,71,104,0.682692307692308,0.317307692307692,1
"2362","CATSPER2",22,32,54,0.592592592592593,0.407407407407407,1
"2363","CATSPER3",18,21,39,0.538461538461538,0.461538461538462,1
"2364","CATSPER4",20,39,59,0.661016949152542,0.338983050847458,1
"2365","CATSPERB",43,126,169,0.745562130177515,0.254437869822485,1
"2366","CATSPERD",38,99,137,0.722627737226277,0.277372262773723,1
"2367","CATSPERE",37,45,82,0.548780487804878,0.451219512195122,1
"2368","CATSPERG",20,51,71,0.71830985915493,0.28169014084507,1
"2369","CATSPERZ",1,4,5,0.8,0.2,1
"2370","CAV1",3,9,12,0.75,0.25,1
"2371","CAV2",9,5,14,0.357142857142857,0.642857142857143,1
"2372","CAV3",8,20,28,0.714285714285714,0.285714285714286,1
"2373","CAVIN1",14,36,50,0.72,0.28,1
"2374","CAVIN2",30,61,91,0.67032967032967,0.32967032967033,1
"2375","CAVIN3",8,9,17,0.529411764705882,0.470588235294118,1
"2376","CAVIN4",20,28,48,0.583333333333333,0.416666666666667,1
"2377","CBARP",7,18,25,0.72,0.28,0.77
"2378","CBFA2T2",30,42,72,0.583333333333333,0.416666666666667,1
"2379","CBFA2T3",21,51,72,0.708333333333333,0.291666666666667,1
"2380","CBFB",9,14,23,0.608695652173913,0.391304347826087,1
"2381","CBL",24,56,80,0.7,0.3,1
"2382","CBLB",35,71,106,0.669811320754717,0.330188679245283,1
"2383","CBLC",12,31,43,0.720930232558139,0.27906976744186,1
"2384","CBLIF",23,39,62,0.629032258064516,0.370967741935484,1
"2385","CBLL1",25,39,64,0.609375,0.390625,1
"2386","CBLL2",45,29,74,0.391891891891892,0.608108108108108,1
"2387","CBLN1",21,13,34,0.382352941176471,0.617647058823529,1
"2388","CBLN2",30,32,62,0.516129032258065,0.483870967741935,1
"2389","CBLN3",9,16,25,0.64,0.36,1
"2390","CBLN4",17,29,46,0.630434782608696,0.369565217391304,1
"2391","CBR1",6,9,15,0.6,0.4,1
"2392","CBR3",9,5,14,0.357142857142857,0.642857142857143,1
"2393","CBR4",4,16,20,0.8,0.2,1
"2394","CBS",3,3,6,0.5,0.5,1
"2395","CBWD1",7,9,16,0.5625,0.4375,1
"2396","CBWD2",8,14,22,0.636363636363636,0.363636363636364,1
"2397","CBWD3",4,6,10,0.6,0.4,1
"2398","CBWD5",7,15,22,0.681818181818182,0.318181818181818,1
"2399","CBWD6",7,5,12,0.416666666666667,0.583333333333333,1
"2400","CBX1",14,7,21,0.333333333333333,0.666666666666667,1
"2401","CBX2",15,31,46,0.673913043478261,0.326086956521739,1
"2402","CBX3",11,13,24,0.541666666666667,0.458333333333333,1
"2403","CBX4",23,24,47,0.51063829787234,0.48936170212766,1
"2404","CBX5",18,12,30,0.4,0.6,1
"2405","CBX6",14,25,39,0.641025641025641,0.358974358974359,1
"2406","CBX7",6,17,23,0.739130434782609,0.260869565217391,1
"2407","CBX8",21,30,51,0.588235294117647,0.411764705882353,1
"2408","CBY1",3,4,7,0.571428571428571,0.428571428571429,1
"2409","CBY2",25,55,80,0.6875,0.3125,1
"2410","CC2D1A",34,59,93,0.634408602150538,0.365591397849462,1
"2411","CC2D1B",19,40,59,0.677966101694915,0.322033898305085,1
"2412","CC2D2A",32,60,92,0.652173913043478,0.347826086956522,1
"2413","CC2D2B",11,29,40,0.725,0.275,1
"2414","CCAR1",45,61,106,0.575471698113208,0.424528301886792,0.77
"2415","CCAR2",30,48,78,0.615384615384615,0.384615384615385,0.77
"2416","CCBE1",27,54,81,0.666666666666667,0.333333333333333,1
"2417","CCDC102A",11,20,31,0.645161290322581,0.354838709677419,1
"2418","CCDC102B",36,75,111,0.675675675675676,0.324324324324324,1
"2419","CCDC103",7,8,15,0.533333333333333,0.466666666666667,1
"2420","CCDC105",26,46,72,0.638888888888889,0.361111111111111,1
"2421","CCDC106",17,13,30,0.433333333333333,0.566666666666667,1
"2422","CCDC107",4,8,12,0.666666666666667,0.333333333333333,1
"2423","CCDC110",47,59,106,0.556603773584906,0.443396226415094,1
"2424","CCDC112",16,20,36,0.555555555555556,0.444444444444444,1
"2425","CCDC113",17,24,41,0.585365853658537,0.414634146341463,1
"2426","CCDC114",22,23,45,0.511111111111111,0.488888888888889,1
"2427","CCDC115",8,10,18,0.555555555555556,0.444444444444444,1
"2428","CCDC116",29,41,70,0.585714285714286,0.414285714285714,1
"2429","CCDC117",10,13,23,0.565217391304348,0.434782608695652,1
"2430","CCDC12",3,5,8,0.625,0.375,1
"2431","CCDC120",31,6,37,0.162162162162162,0.837837837837838,1
"2432","CCDC121",9,13,22,0.590909090909091,0.409090909090909,1
"2433","CCDC122",9,8,17,0.470588235294118,0.529411764705882,1
"2434","CCDC124",6,7,13,0.538461538461538,0.461538461538462,1
"2435","CCDC125",19,28,47,0.595744680851064,0.404255319148936,1
"2436","CCDC126",10,8,18,0.444444444444444,0.555555555555556,1
"2437","CCDC127",10,12,22,0.545454545454545,0.454545454545455,1
"2438","CCDC13",1,1,2,0.5,0.5,1
"2439","CCDC130",14,17,31,0.548387096774194,0.451612903225806,1
"2440","CCDC134",4,15,19,0.789473684210526,0.210526315789474,1
"2441","CCDC136",27,68,95,0.715789473684211,0.284210526315789,1
"2442","CCDC137",4,9,13,0.692307692307692,0.307692307692308,1
"2443","CCDC138",22,40,62,0.645161290322581,0.354838709677419,1
"2444","CCDC14",17,47,64,0.734375,0.265625,1
"2445","CCDC140",9,17,26,0.653846153846154,0.346153846153846,1
"2446","CCDC141",78,178,256,0.6953125,0.3046875,1
"2447","CCDC142",15,21,36,0.583333333333333,0.416666666666667,1
"2448","CCDC144A",42,80,122,0.655737704918033,0.344262295081967,1
"2449","CCDC144B",5,16,21,0.761904761904762,0.238095238095238,1
"2450","CCDC144NL",3,3,6,0.5,0.5,1
"2451","CCDC146",29,72,101,0.712871287128713,0.287128712871287,1
"2452","CCDC148",29,40,69,0.579710144927536,0.420289855072464,1
"2453","CCDC149",7,19,26,0.730769230769231,0.269230769230769,1
"2454","CCDC15",36,38,74,0.513513513513513,0.486486486486487,1
"2455","CCDC150",40,44,84,0.523809523809524,0.476190476190476,1
"2456","CCDC151",19,38,57,0.666666666666667,0.333333333333333,1
"2457","CCDC153",5,10,15,0.666666666666667,0.333333333333333,1
"2458","CCDC154",0,3,3,1,0,1
"2459","CCDC157",12,22,34,0.647058823529412,0.352941176470588,1
"2460","CCDC158",44,114,158,0.721518987341772,0.278481012658228,1
"2461","CCDC159",5,7,12,0.583333333333333,0.416666666666667,1
"2462","CCDC160",20,12,32,0.375,0.625,1
"2463","CCDC163",7,4,11,0.363636363636364,0.636363636363636,1
"2464","CCDC167",5,2,7,0.285714285714286,0.714285714285714,1
"2465","CCDC168",4,77,81,0.950617283950617,0.0493827160493827,1
"2466","CCDC17",12,15,27,0.555555555555556,0.444444444444444,1
"2467","CCDC170",37,85,122,0.69672131147541,0.30327868852459,1
"2468","CCDC171",49,82,131,0.625954198473282,0.374045801526718,1
"2469","CCDC172",12,36,48,0.75,0.25,1
"2470","CCDC173",26,32,58,0.551724137931034,0.448275862068966,1
"2471","CCDC174",21,23,44,0.522727272727273,0.477272727272727,1
"2472","CCDC178",87,132,219,0.602739726027397,0.397260273972603,1
"2473","CCDC18",43,66,109,0.605504587155963,0.394495412844037,1
"2474","CCDC180",52,84,136,0.617647058823529,0.382352941176471,1
"2475","CCDC181",32,61,93,0.655913978494624,0.344086021505376,1
"2476","CCDC182",0,2,2,1,0,1
"2477","CCDC183",13,21,34,0.617647058823529,0.382352941176471,1
"2478","CCDC184",7,9,16,0.5625,0.4375,1
"2479","CCDC185",28,45,73,0.616438356164384,0.383561643835616,1
"2480","CCDC186",25,39,64,0.609375,0.390625,1
"2481","CCDC188",1,1,2,0.5,0.5,1
"2482","CCDC189",8,8,16,0.5,0.5,1
"2483","CCDC190",16,21,37,0.567567567567568,0.432432432432432,1
"2484","CCDC191",27,66,93,0.709677419354839,0.290322580645161,1
"2485","CCDC197",7,13,20,0.65,0.35,1
"2486","CCDC198",18,26,44,0.590909090909091,0.409090909090909,1
"2487","CCDC22",23,11,34,0.323529411764706,0.676470588235294,1
"2488","CCDC24",11,17,28,0.607142857142857,0.392857142857143,1
"2489","CCDC25",7,12,19,0.631578947368421,0.368421052631579,1
"2490","CCDC27",35,45,80,0.5625,0.4375,1
"2491","CCDC28A",24,27,51,0.529411764705882,0.470588235294118,1
"2492","CCDC28B",6,12,18,0.666666666666667,0.333333333333333,1
"2493","CCDC3",12,19,31,0.612903225806452,0.387096774193548,1
"2494","CCDC30",25,47,72,0.652777777777778,0.347222222222222,1
"2495","CCDC32",5,16,21,0.761904761904762,0.238095238095238,1
"2496","CCDC33",31,61,92,0.66304347826087,0.33695652173913,1
"2497","CCDC34",12,22,34,0.647058823529412,0.352941176470588,1
"2498","CCDC38",23,46,69,0.666666666666667,0.333333333333333,1
"2499","CCDC39",54,115,169,0.680473372781065,0.319526627218935,1
"2500","CCDC40",53,75,128,0.5859375,0.4140625,1
"2501","CCDC42",14,35,49,0.714285714285714,0.285714285714286,1
"2502","CCDC43",11,7,18,0.388888888888889,0.611111111111111,1
"2503","CCDC47",17,29,46,0.630434782608696,0.369565217391304,1
"2504","CCDC50",17,40,57,0.701754385964912,0.298245614035088,1
"2505","CCDC51",11,17,28,0.607142857142857,0.392857142857143,1
"2506","CCDC54",21,57,78,0.730769230769231,0.269230769230769,1
"2507","CCDC57",25,42,67,0.626865671641791,0.373134328358209,1
"2508","CCDC58",12,3,15,0.2,0.8,1
"2509","CCDC59",13,17,30,0.566666666666667,0.433333333333333,1
"2510","CCDC6",26,25,51,0.490196078431373,0.509803921568627,1
"2511","CCDC60",36,83,119,0.697478991596639,0.302521008403361,1
"2512","CCDC61",4,20,24,0.833333333333333,0.166666666666667,1
"2513","CCDC62",32,36,68,0.529411764705882,0.470588235294118,1
"2514","CCDC63",35,56,91,0.615384615384615,0.384615384615385,1
"2515","CCDC65",10,28,38,0.736842105263158,0.263157894736842,1
"2516","CCDC66",24,40,64,0.625,0.375,1
"2517","CCDC68",13,44,57,0.771929824561403,0.228070175438596,1
"2518","CCDC69",7,17,24,0.708333333333333,0.291666666666667,1
"2519","CCDC7",45,64,109,0.587155963302752,0.412844036697248,1
"2520","CCDC70",14,29,43,0.674418604651163,0.325581395348837,1
"2521","CCDC71",10,27,37,0.72972972972973,0.27027027027027,1
"2522","CCDC71L",1,1,2,0.5,0.5,1
"2523","CCDC73",69,114,183,0.622950819672131,0.377049180327869,1
"2524","CCDC74A",17,33,50,0.66,0.34,1
"2525","CCDC74B",21,32,53,0.60377358490566,0.39622641509434,1
"2526","CCDC77",13,24,37,0.648648648648649,0.351351351351351,1
"2527","CCDC78",6,23,29,0.793103448275862,0.206896551724138,1
"2528","CCDC8",28,42,70,0.6,0.4,1
"2529","CCDC80",51,64,115,0.556521739130435,0.443478260869565,1
"2530","CCDC81",32,35,67,0.522388059701492,0.477611940298507,1
"2531","CCDC82",27,17,44,0.386363636363636,0.613636363636364,1
"2532","CCDC83",18,44,62,0.709677419354839,0.290322580645161,1
"2533","CCDC85A",48,56,104,0.538461538461538,0.461538461538462,1
"2534","CCDC85B",2,1,3,0.333333333333333,0.666666666666667,1
"2535","CCDC86",8,17,25,0.68,0.32,1
"2536","CCDC87",33,61,94,0.648936170212766,0.351063829787234,1
"2537","CCDC88A",64,115,179,0.642458100558659,0.357541899441341,1
"2538","CCDC88B",38,74,112,0.660714285714286,0.339285714285714,1
"2539","CCDC88C",60,103,163,0.631901840490798,0.368098159509202,1
"2540","CCDC89",14,23,37,0.621621621621622,0.378378378378378,1
"2541","CCDC9",14,25,39,0.641025641025641,0.358974358974359,1
"2542","CCDC90B",11,20,31,0.645161290322581,0.354838709677419,1
"2543","CCDC91",21,25,46,0.543478260869565,0.456521739130435,1
"2544","CCDC92",21,32,53,0.60377358490566,0.39622641509434,1
"2545","CCDC93",32,41,73,0.561643835616438,0.438356164383562,1
"2546","CCDC96",25,18,43,0.418604651162791,0.581395348837209,1
"2547","CCDC97",13,21,34,0.617647058823529,0.382352941176471,1
"2548","CCDC9B",23,44,67,0.656716417910448,0.343283582089552,1
"2549","CCER1",43,61,104,0.586538461538462,0.413461538461538,1
"2550","CCHCR1",20,39,59,0.661016949152542,0.338983050847458,1
"2551","CCIN",28,28,56,0.5,0.5,1
"2552","CCK",10,17,27,0.62962962962963,0.37037037037037,1
"2553","CCKAR",30,54,84,0.642857142857143,0.357142857142857,0.77
"2554","CCKBR",37,69,106,0.650943396226415,0.349056603773585,1
"2555","CCL1",8,11,19,0.578947368421053,0.421052631578947,1
"2556","CCL11",3,7,10,0.7,0.3,1
"2557","CCL13",7,4,11,0.363636363636364,0.636363636363636,1
"2558","CCL14",9,18,27,0.666666666666667,0.333333333333333,1
"2559","CCL15",4,14,18,0.777777777777778,0.222222222222222,1
"2560","CCL16",6,14,20,0.7,0.3,1
"2561","CCL17",5,2,7,0.285714285714286,0.714285714285714,1
"2562","CCL18",4,6,10,0.6,0.4,1
"2563","CCL19",2,4,6,0.666666666666667,0.333333333333333,1
"2564","CCL2",7,7,14,0.5,0.5,1
"2565","CCL20",3,7,10,0.7,0.3,1
"2566","CCL21",2,10,12,0.833333333333333,0.166666666666667,1
"2567","CCL22",6,10,16,0.625,0.375,1
"2568","CCL23",11,8,19,0.421052631578947,0.578947368421053,1
"2569","CCL24",9,9,18,0.5,0.5,1
"2570","CCL25",3,7,10,0.7,0.3,1
"2571","CCL26",7,5,12,0.416666666666667,0.583333333333333,1
"2572","CCL27",5,9,14,0.642857142857143,0.357142857142857,1
"2573","CCL28",4,7,11,0.636363636363636,0.363636363636364,1
"2574","CCL3",5,8,13,0.615384615384615,0.384615384615385,1
"2575","CCL3L3",4,11,15,0.733333333333333,0.266666666666667,1
"2576","CCL4",6,2,8,0.25,0.75,1
"2577","CCL4L2",4,5,9,0.555555555555556,0.444444444444444,1
"2578","CCL5",4,4,8,0.5,0.5,1
"2579","CCL7",10,12,22,0.545454545454545,0.454545454545455,1
"2580","CCL8",3,8,11,0.727272727272727,0.272727272727273,1
"2581","CCM2",12,22,34,0.647058823529412,0.352941176470588,1
"2582","CCM2L",14,26,40,0.65,0.35,1
"2583","CCN1",8,15,23,0.652173913043478,0.347826086956522,1
"2584","CCN2",13,15,28,0.535714285714286,0.464285714285714,1
"2585","CCN3",14,32,46,0.695652173913043,0.304347826086957,1
"2586","CCN4",35,42,77,0.545454545454545,0.454545454545455,1
"2587","CCN5",13,19,32,0.59375,0.40625,1
"2588","CCN6",16,34,50,0.68,0.32,1
"2589","CCNA1",29,60,89,0.674157303370786,0.325842696629214,1
"2590","CCNA2",14,13,27,0.481481481481481,0.518518518518518,1
"2591","CCNB1",8,21,29,0.724137931034483,0.275862068965517,1
"2592","CCNB1IP1",13,18,31,0.580645161290323,0.419354838709677,1
"2593","CCNB2",10,11,21,0.523809523809524,0.476190476190476,1
"2594","CCNB3",100,78,178,0.438202247191011,0.561797752808989,1
"2595","CCNC",11,9,20,0.45,0.55,1
"2596","CCND1",10,19,29,0.655172413793103,0.344827586206897,1
"2597","CCND2",11,19,30,0.633333333333333,0.366666666666667,1
"2598","CCND3",8,10,18,0.555555555555556,0.444444444444444,1
"2599","CCNDBP1",7,17,24,0.708333333333333,0.291666666666667,1
"2600","CCNE1",18,25,43,0.581395348837209,0.418604651162791,1
"2601","CCNE2",21,16,37,0.432432432432432,0.567567567567568,1
"2602","CCNF",25,44,69,0.63768115942029,0.36231884057971,1
"2603","CCNG1",7,4,11,0.363636363636364,0.636363636363636,1
"2604","CCNG2",10,15,25,0.6,0.4,1
"2605","CCNH",9,14,23,0.608695652173913,0.391304347826087,1
"2606","CCNI",11,13,24,0.541666666666667,0.458333333333333,1
"2607","CCNI2",3,5,8,0.625,0.375,1
"2608","CCNJ",12,8,20,0.4,0.6,1
"2609","CCNJL",13,25,38,0.657894736842105,0.342105263157895,1
"2610","CCNK",13,12,25,0.48,0.52,1
"2611","CCNL1",22,25,47,0.531914893617021,0.468085106382979,1
"2612","CCNL2",22,28,50,0.56,0.44,1
"2613","CCNO",8,10,18,0.555555555555556,0.444444444444444,1
"2614","CCNP",3,7,10,0.7,0.3,1
"2615","CCNQ",14,12,26,0.461538461538462,0.538461538461538,1
"2616","CCNQP1",35,36,71,0.507042253521127,0.492957746478873,1
"2617","CCNT1",21,39,60,0.65,0.35,1
"2618","CCNT2",24,28,52,0.538461538461538,0.461538461538462,1
"2619","CCNY",9,20,29,0.689655172413793,0.310344827586207,1
"2620","CCNYL1",10,10,20,0.5,0.5,1
"2621","CCNYL2",0,2,2,1,0,1
"2622","CCP110",22,57,79,0.721518987341772,0.278481012658228,1
"2623","CCPG1",20,48,68,0.705882352941177,0.294117647058824,1
"2624","CCR1",19,34,53,0.641509433962264,0.358490566037736,1
"2625","CCR10",13,14,27,0.518518518518518,0.481481481481481,1
"2626","CCR2",27,44,71,0.619718309859155,0.380281690140845,1
"2627","CCR3",16,52,68,0.764705882352941,0.235294117647059,1
"2628","CCR4",12,25,37,0.675675675675676,0.324324324324324,1
"2629","CCR5",15,34,49,0.693877551020408,0.306122448979592,1
"2630","CCR6",17,30,47,0.638297872340426,0.361702127659574,1
"2631","CCR7",16,17,33,0.515151515151515,0.484848484848485,1
"2632","CCR8",17,26,43,0.604651162790698,0.395348837209302,1
"2633","CCR9",20,25,45,0.555555555555556,0.444444444444444,1
"2634","CCRL2",11,19,30,0.633333333333333,0.366666666666667,1
"2635","CCS",16,12,28,0.428571428571429,0.571428571428571,1
"2636","CCSAP",6,9,15,0.6,0.4,1
"2637","CCSER1",34,86,120,0.716666666666667,0.283333333333333,1
"2638","CCSER2",29,41,70,0.585714285714286,0.414285714285714,1
"2639","CCT2",15,23,38,0.605263157894737,0.394736842105263,1
"2640","CCT3",15,31,46,0.673913043478261,0.326086956521739,1
"2641","CCT4",17,19,36,0.527777777777778,0.472222222222222,1
"2642","CCT5",22,27,49,0.551020408163265,0.448979591836735,1
"2643","CCT6A",26,33,59,0.559322033898305,0.440677966101695,1
"2644","CCT6B",32,33,65,0.507692307692308,0.492307692307692,1
"2645","CCT7",14,23,37,0.621621621621622,0.378378378378378,1
"2646","CCT8",12,16,28,0.571428571428571,0.428571428571429,1
"2647","CCT8L2",69,130,199,0.653266331658292,0.346733668341709,1
"2648","CCZ1",9,18,27,0.666666666666667,0.333333333333333,1
"2649","CCZ1B",6,19,25,0.76,0.24,1
"2650","CD101",53,64,117,0.547008547008547,0.452991452991453,1
"2651","CD109",63,102,165,0.618181818181818,0.381818181818182,1
"2652","CD14",13,17,30,0.566666666666667,0.433333333333333,1
"2653","CD151",3,11,14,0.785714285714286,0.214285714285714,1
"2654","CD160",6,6,12,0.5,0.5,1
"2655","CD163",114,208,322,0.645962732919255,0.354037267080745,1
"2656","CD163L1",87,205,292,0.702054794520548,0.297945205479452,1
"2657","CD164",3,10,13,0.769230769230769,0.230769230769231,1
"2658","CD164L2",6,8,14,0.571428571428571,0.428571428571429,1
"2659","CD177",23,31,54,0.574074074074074,0.425925925925926,1
"2660","CD180",35,48,83,0.578313253012048,0.421686746987952,1
"2661","CD19",19,38,57,0.666666666666667,0.333333333333333,1
"2662","CD1A",29,60,89,0.674157303370786,0.325842696629214,1
"2663","CD1B",25,55,80,0.6875,0.3125,1
"2664","CD1C",27,69,96,0.71875,0.28125,1
"2665","CD1D",34,46,80,0.575,0.425,1
"2666","CD1E",54,89,143,0.622377622377622,0.377622377622378,1
"2667","CD2",18,41,59,0.694915254237288,0.305084745762712,1
"2668","CD200",13,16,29,0.551724137931034,0.448275862068966,1
"2669","CD200R1",24,36,60,0.6,0.4,1
"2670","CD200R1L",15,30,45,0.666666666666667,0.333333333333333,1
"2671","CD207",22,39,61,0.639344262295082,0.360655737704918,1
"2672","CD209",26,42,68,0.617647058823529,0.382352941176471,1
"2673","CD22",53,77,130,0.592307692307692,0.407692307692308,1
"2674","CD226",16,42,58,0.724137931034483,0.275862068965517,1
"2675","CD244",26,43,69,0.623188405797101,0.376811594202899,1
"2676","CD247",7,22,29,0.758620689655172,0.241379310344828,1
"2677","CD248",24,47,71,0.661971830985915,0.338028169014085,1
"2678","CD27",10,14,24,0.583333333333333,0.416666666666667,1
"2679","CD274",14,9,23,0.391304347826087,0.608695652173913,1
"2680","CD276",20,23,43,0.534883720930233,0.465116279069767,1
"2681","CD28",9,17,26,0.653846153846154,0.346153846153846,1
"2682","CD2AP",21,48,69,0.695652173913043,0.304347826086957,1
"2683","CD2BP2",19,23,42,0.547619047619048,0.452380952380952,1
"2684","CD300A",13,34,47,0.723404255319149,0.276595744680851,1
"2685","CD300C",13,39,52,0.75,0.25,1
"2686","CD300E",19,30,49,0.612244897959184,0.387755102040816,1
"2687","CD300LB",18,28,46,0.608695652173913,0.391304347826087,1
"2688","CD300LD",14,15,29,0.517241379310345,0.482758620689655,1
"2689","CD300LF",11,18,29,0.620689655172414,0.379310344827586,1
"2690","CD300LG",14,29,43,0.674418604651163,0.325581395348837,1
"2691","CD302",0,1,1,1,0,1
"2692","CD320",8,5,13,0.384615384615385,0.615384615384615,1
"2693","CD33",40,55,95,0.578947368421053,0.421052631578947,1
"2694","CD34",18,27,45,0.6,0.4,1
"2695","CD36",13,32,45,0.711111111111111,0.288888888888889,1
"2696","CD37",8,13,21,0.619047619047619,0.380952380952381,1
"2697","CD38",10,27,37,0.72972972972973,0.27027027027027,1
"2698","CD3D",6,12,18,0.666666666666667,0.333333333333333,1
"2699","CD3E",7,11,18,0.611111111111111,0.388888888888889,1
"2700","CD3G",4,8,12,0.666666666666667,0.333333333333333,1
"2701","CD4",34,35,69,0.507246376811594,0.492753623188406,1
"2702","CD40",14,25,39,0.641025641025641,0.358974358974359,1
"2703","CD40LG",18,18,36,0.5,0.5,1
"2704","CD44",27,30,57,0.526315789473684,0.473684210526316,1
"2705","CD46",18,23,41,0.560975609756098,0.439024390243902,1
"2706","CD47",11,14,25,0.56,0.44,1
"2707","CD48",5,17,22,0.772727272727273,0.227272727272727,1
"2708","CD5",20,27,47,0.574468085106383,0.425531914893617,1
"2709","CD52",4,3,7,0.428571428571429,0.571428571428571,1
"2710","CD53",12,17,29,0.586206896551724,0.413793103448276,1
"2711","CD55",14,13,27,0.481481481481481,0.518518518518518,1
"2712","CD58",19,26,45,0.577777777777778,0.422222222222222,1
"2713","CD59",4,4,8,0.5,0.5,1
"2714","CD5L",34,89,123,0.723577235772358,0.276422764227642,1
"2715","CD6",20,49,69,0.710144927536232,0.289855072463768,1
"2716","CD63",11,13,24,0.541666666666667,0.458333333333333,1
"2717","CD68",5,9,14,0.642857142857143,0.357142857142857,1
"2718","CD69",12,16,28,0.571428571428571,0.428571428571429,1
"2719","CD7",10,15,25,0.6,0.4,1
"2720","CD70",14,13,27,0.481481481481481,0.518518518518518,1
"2721","CD72",15,19,34,0.558823529411765,0.441176470588235,1
"2722","CD74",5,13,18,0.722222222222222,0.277777777777778,1
"2723","CD79A",5,17,22,0.772727272727273,0.227272727272727,1
"2724","CD79B",8,11,19,0.578947368421053,0.421052631578947,1
"2725","CD80",14,21,35,0.6,0.4,1
"2726","CD81",8,13,21,0.619047619047619,0.380952380952381,1
"2727","CD82",4,16,20,0.8,0.2,1
"2728","CD83",9,9,18,0.5,0.5,1
"2729","CD84",27,34,61,0.557377049180328,0.442622950819672,1
"2730","CD86",37,42,79,0.531645569620253,0.468354430379747,1
"2731","CD8A",8,18,26,0.692307692307692,0.307692307692308,1
"2732","CD8B",13,23,36,0.638888888888889,0.361111111111111,1
"2733","CD9",7,12,19,0.631578947368421,0.368421052631579,1
"2734","CD93",62,85,147,0.578231292517007,0.421768707482993,1
"2735","CD96",42,56,98,0.571428571428571,0.428571428571429,1
"2736","CD99",5,9,14,0.642857142857143,0.357142857142857,1
"2737","CD99L2",21,16,37,0.432432432432432,0.567567567567568,1
"2738","CDA",5,9,14,0.642857142857143,0.357142857142857,1
"2739","CDADC1",23,18,41,0.439024390243902,0.560975609756098,1
"2740","CDAN1",45,39,84,0.464285714285714,0.535714285714286,1
"2741","CDC123",7,19,26,0.730769230769231,0.269230769230769,1
"2742","CDC14A",41,55,96,0.572916666666667,0.427083333333333,1
"2743","CDC14B",11,31,42,0.738095238095238,0.261904761904762,1
"2744","CDC16",12,36,48,0.75,0.25,1
"2745","CDC20",13,21,34,0.617647058823529,0.382352941176471,1
"2746","CDC20B",27,45,72,0.625,0.375,1
"2747","CDC23",23,25,48,0.520833333333333,0.479166666666667,1
"2748","CDC25A",18,24,42,0.571428571428571,0.428571428571429,1
"2749","CDC25B",19,29,48,0.604166666666667,0.395833333333333,1
"2750","CDC25C",19,33,52,0.634615384615385,0.365384615384615,1
"2751","CDC26",2,4,6,0.666666666666667,0.333333333333333,1
"2752","CDC27",26,40,66,0.606060606060606,0.393939393939394,1
"2753","CDC34",11,12,23,0.521739130434783,0.478260869565217,1
"2754","CDC37",19,12,31,0.387096774193548,0.612903225806452,1
"2755","CDC37L1",7,16,23,0.695652173913043,0.304347826086957,1
"2756","CDC37P1",0,7,7,1,0,1
"2757","CDC40",18,39,57,0.684210526315789,0.315789473684211,1
"2758","CDC42",5,18,23,0.782608695652174,0.217391304347826,1
"2759","CDC42BPA",47,105,152,0.690789473684211,0.309210526315789,1
"2760","CDC42BPB",47,77,124,0.620967741935484,0.379032258064516,1
"2761","CDC42BPG",56,60,116,0.517241379310345,0.482758620689655,1
"2762","CDC42EP1",17,16,33,0.484848484848485,0.515151515151515,1
"2763","CDC42EP2",11,8,19,0.421052631578947,0.578947368421053,1
"2764","CDC42EP3",8,10,18,0.555555555555556,0.444444444444444,1
"2765","CDC42EP4",12,23,35,0.657142857142857,0.342857142857143,1
"2766","CDC42EP5",1,2,3,0.666666666666667,0.333333333333333,1
"2767","CDC42SE1",1,2,3,0.666666666666667,0.333333333333333,1
"2768","CDC42SE2",4,1,5,0.2,0.8,1
"2769","CDC45",22,32,54,0.592592592592593,0.407407407407407,1
"2770","CDC5L",27,47,74,0.635135135135135,0.364864864864865,1
"2771","CDC6",12,31,43,0.720930232558139,0.27906976744186,1
"2772","CDC7",28,45,73,0.616438356164384,0.383561643835616,1
"2773","CDC73",40,39,79,0.493670886075949,0.506329113924051,1
"2774","CDCA2",30,53,83,0.63855421686747,0.36144578313253,1
"2775","CDCA3",11,8,19,0.421052631578947,0.578947368421053,1
"2776","CDCA4",15,14,29,0.482758620689655,0.517241379310345,1
"2777","CDCA5",8,13,21,0.619047619047619,0.380952380952381,1
"2778","CDCA7",18,35,53,0.660377358490566,0.339622641509434,1
"2779","CDCA7L",18,40,58,0.689655172413793,0.310344827586207,1
"2780","CDCA8",9,14,23,0.608695652173913,0.391304347826087,1
"2781","CDCP1",36,56,92,0.608695652173913,0.391304347826087,1
"2782","CDCP2",15,33,48,0.6875,0.3125,1
"2783","CDH1",53,84,137,0.613138686131387,0.386861313868613,1
"2784","CDH10",179,317,496,0.639112903225806,0.360887096774194,1
"2785","CDH11",63,143,206,0.694174757281553,0.305825242718447,1
"2786","CDH12",115,187,302,0.619205298013245,0.380794701986755,1
"2787","CDH13",48,74,122,0.60655737704918,0.39344262295082,1
"2788","CDH15",23,50,73,0.684931506849315,0.315068493150685,1
"2789","CDH16",50,75,125,0.6,0.4,1
"2790","CDH17",50,72,122,0.590163934426229,0.409836065573771,1
"2791","CDH18",142,214,356,0.601123595505618,0.398876404494382,1
"2792","CDH19",66,83,149,0.557046979865772,0.442953020134228,1
"2793","CDH2",78,122,200,0.61,0.39,1
"2794","CDH20",73,91,164,0.554878048780488,0.445121951219512,1
"2795","CDH22",38,56,94,0.595744680851064,0.404255319148936,1
"2796","CDH23",106,213,319,0.667711598746082,0.332288401253919,1
"2797","CDH24",32,49,81,0.604938271604938,0.395061728395062,1
"2798","CDH26",34,60,94,0.638297872340426,0.361702127659574,1
"2799","CDH3",15,42,57,0.736842105263158,0.263157894736842,1
"2800","CDH4",80,132,212,0.622641509433962,0.377358490566038,1
"2801","CDH5",38,57,95,0.6,0.4,1
"2802","CDH6",82,171,253,0.675889328063241,0.324110671936759,1
"2803","CDH7",82,134,216,0.62037037037037,0.37962962962963,1
"2804","CDH8",113,207,320,0.646875,0.353125,1
"2805","CDH9",143,236,379,0.622691292875989,0.377308707124011,1
"2806","CDHR1",46,59,105,0.561904761904762,0.438095238095238,1
"2807","CDHR2",76,95,171,0.555555555555556,0.444444444444444,1
"2808","CDHR3",30,54,84,0.642857142857143,0.357142857142857,1
"2809","CDHR4",10,5,15,0.333333333333333,0.666666666666667,1
"2810","CDHR5",25,52,77,0.675324675324675,0.324675324675325,1
"2811","CDIN1",2,16,18,0.888888888888889,0.111111111111111,1
"2812","CDIP1",3,9,12,0.75,0.25,1
"2813","CDIPT",4,11,15,0.733333333333333,0.266666666666667,1
"2814","CDK1",12,20,32,0.625,0.375,1
"2815","CDK10",11,7,18,0.388888888888889,0.611111111111111,1
"2816","CDK11A",8,22,30,0.733333333333333,0.266666666666667,1
"2817","CDK11B",16,31,47,0.659574468085106,0.340425531914894,1
"2818","CDK12",80,120,200,0.6,0.4,1
"2819","CDK13",44,70,114,0.614035087719298,0.385964912280702,1
"2820","CDK14",26,61,87,0.701149425287356,0.298850574712644,1
"2821","CDK15",18,32,50,0.64,0.36,1
"2822","CDK16",14,19,33,0.575757575757576,0.424242424242424,1
"2823","CDK17",17,31,48,0.645833333333333,0.354166666666667,1
"2824","CDK18",14,31,45,0.688888888888889,0.311111111111111,1
"2825","CDK19",12,27,39,0.692307692307692,0.307692307692308,1
"2826","CDK2",12,8,20,0.4,0.6,1
"2827","CDK20",14,12,26,0.461538461538462,0.538461538461538,1
"2828","CDK2AP1",5,2,7,0.285714285714286,0.714285714285714,1
"2829","CDK2AP2",2,5,7,0.714285714285714,0.285714285714286,1
"2830","CDK3",12,18,30,0.6,0.4,1
"2831","CDK4",13,19,32,0.59375,0.40625,1
"2832","CDK5",8,17,25,0.68,0.32,1
"2833","CDK5R1",11,8,19,0.421052631578947,0.578947368421053,1
"2834","CDK5R2",9,4,13,0.307692307692308,0.692307692307692,1
"2835","CDK5RAP1",15,33,48,0.6875,0.3125,1
"2836","CDK5RAP2",62,94,156,0.602564102564103,0.397435897435897,1
"2837","CDK5RAP3",9,18,27,0.666666666666667,0.333333333333333,1
"2838","CDK6",12,13,25,0.52,0.48,1
"2839","CDK7",11,13,24,0.541666666666667,0.458333333333333,1
"2840","CDK8",23,43,66,0.651515151515151,0.348484848484849,1
"2841","CDK9",10,21,31,0.67741935483871,0.32258064516129,1
"2842","CDKAL1",26,33,59,0.559322033898305,0.440677966101695,1
"2843","CDKL1",10,18,28,0.642857142857143,0.357142857142857,1
"2844","CDKL2",18,35,53,0.660377358490566,0.339622641509434,1
"2845","CDKL3",18,20,38,0.526315789473684,0.473684210526316,1
"2846","CDKL4",21,24,45,0.533333333333333,0.466666666666667,1
"2847","CDKL5",72,40,112,0.357142857142857,0.642857142857143,1
"2848","CDKN1A",23,58,81,0.716049382716049,0.283950617283951,1
"2849","CDKN1B",12,21,33,0.636363636363636,0.363636363636364,1
"2850","CDKN1C",1,1,2,0.5,0.5,1
"2851","CDKN2A",119,263,382,0.68848167539267,0.31151832460733,1
"2852","CDKN2AIP",18,20,38,0.526315789473684,0.473684210526316,1
"2853","CDKN2AIPNL",1,3,4,0.75,0.25,1
"2854","CDKN2B",1,6,7,0.857142857142857,0.142857142857143,1
"2855","CDKN2C",6,14,20,0.7,0.3,1
"2856","CDKN2D",3,7,10,0.7,0.3,1
"2857","CDKN3",3,6,9,0.666666666666667,0.333333333333333,1
"2858","CDNF",10,16,26,0.615384615384615,0.384615384615385,1
"2859","CDO1",7,12,19,0.631578947368421,0.368421052631579,1
"2860","CDON",46,83,129,0.643410852713178,0.356589147286822,1
"2861","CDPF1",4,7,11,0.636363636363636,0.363636363636364,1
"2862","CDR1",35,36,71,0.507042253521127,0.492957746478873,1
"2863","CDR2",9,30,39,0.769230769230769,0.230769230769231,1
"2864","CDR2L",5,14,19,0.736842105263158,0.263157894736842,1
"2865","CDRT1",21,52,73,0.712328767123288,0.287671232876712,1
"2866","CDRT15",7,8,15,0.533333333333333,0.466666666666667,1
"2867","CDRT15L2",0,2,2,1,0,1
"2868","CDRT15P3",0,5,5,1,0,1
"2869","CDRT4",3,7,10,0.7,0.3,1
"2870","CDS1",14,39,53,0.735849056603774,0.264150943396226,1
"2871","CDS2",23,18,41,0.439024390243902,0.560975609756098,1
"2872","CDSN",11,28,39,0.717948717948718,0.282051282051282,1
"2873","CDT1",9,18,27,0.666666666666667,0.333333333333333,1
"2874","CDV3",3,1,4,0.25,0.75,1
"2875","CDX1",4,12,16,0.75,0.25,1
"2876","CDX2",13,18,31,0.580645161290323,0.419354838709677,1
"2877","CDX4",31,34,65,0.523076923076923,0.476923076923077,1
"2878","CDYL",42,47,89,0.528089887640449,0.471910112359551,1
"2879","CDYL2",36,49,85,0.576470588235294,0.423529411764706,1
"2880","CEACAM1",16,21,37,0.567567567567568,0.432432432432432,1
"2881","CEACAM16",15,12,27,0.444444444444444,0.555555555555556,1
"2882","CEACAM18",23,46,69,0.666666666666667,0.333333333333333,1
"2883","CEACAM19",9,15,24,0.625,0.375,1
"2884","CEACAM20",28,44,72,0.611111111111111,0.388888888888889,1
"2885","CEACAM21",13,22,35,0.628571428571429,0.371428571428571,1
"2886","CEACAM3",11,35,46,0.760869565217391,0.239130434782609,1
"2887","CEACAM4",16,30,46,0.652173913043478,0.347826086956522,1
"2888","CEACAM5",40,67,107,0.626168224299065,0.373831775700935,1
"2889","CEACAM6",12,29,41,0.707317073170732,0.292682926829268,1
"2890","CEACAM7",19,28,47,0.595744680851064,0.404255319148936,1
"2891","CEACAM8",22,28,50,0.56,0.44,1
"2892","CEBPA",2,9,11,0.818181818181818,0.181818181818182,1
"2893","CEBPB",1,4,5,0.8,0.2,1
"2894","CEBPD",1,2,3,0.666666666666667,0.333333333333333,1
"2895","CEBPE",15,20,35,0.571428571428571,0.428571428571429,1
"2896","CEBPG",6,5,11,0.454545454545455,0.545454545454545,1
"2897","CEBPZ",45,42,87,0.482758620689655,0.517241379310345,1
"2898","CECR2",63,104,167,0.622754491017964,0.377245508982036,1
"2899","CEL",34,43,77,0.558441558441558,0.441558441558442,1
"2900","CELA1",6,17,23,0.739130434782609,0.260869565217391,1
"2901","CELA2A",10,18,28,0.642857142857143,0.357142857142857,1
"2902","CELA2B",8,15,23,0.652173913043478,0.347826086956522,1
"2903","CELA3A",13,17,30,0.566666666666667,0.433333333333333,1
"2904","CELA3B",7,29,36,0.805555555555556,0.194444444444444,1
"2905","CELF1",14,20,34,0.588235294117647,0.411764705882353,1
"2906","CELF2",23,28,51,0.549019607843137,0.450980392156863,1
"2907","CELF3",12,37,49,0.755102040816326,0.244897959183673,1
"2908","CELF4",28,55,83,0.662650602409639,0.337349397590361,1
"2909","CELF5",10,18,28,0.642857142857143,0.357142857142857,1
"2910","CELF6",9,19,28,0.678571428571429,0.321428571428571,1
"2911","CELSR1",98,169,267,0.632958801498127,0.367041198501873,1
"2912","CELSR2",96,145,241,0.601659751037344,0.398340248962656,1
"2913","CELSR3",101,176,277,0.635379061371841,0.364620938628159,1
"2914","CEMIP",61,102,163,0.625766871165644,0.374233128834356,1
"2915","CEMIP2",74,96,170,0.564705882352941,0.435294117647059,1
"2916","CEMP1",6,9,15,0.6,0.4,1
"2917","CENATAC",7,13,20,0.65,0.35,1
"2918","CEND1",2,8,10,0.8,0.2,1
"2919","CENPA",4,11,15,0.733333333333333,0.266666666666667,1
"2920","CENPB",14,27,41,0.658536585365854,0.341463414634146,1
"2921","CENPBD1",8,4,12,0.333333333333333,0.666666666666667,1
"2922","CENPC",30,44,74,0.594594594594595,0.405405405405405,1
"2923","CENPE",97,167,264,0.632575757575758,0.367424242424242,1
"2924","CENPF",122,190,312,0.608974358974359,0.391025641025641,1
"2925","CENPH",10,22,32,0.6875,0.3125,1
"2926","CENPI",40,25,65,0.384615384615385,0.615384615384615,1
"2927","CENPJ",48,80,128,0.625,0.375,1
"2928","CENPK",11,20,31,0.645161290322581,0.354838709677419,1
"2929","CENPL",10,15,25,0.6,0.4,1
"2930","CENPM",1,8,9,0.888888888888889,0.111111111111111,1
"2931","CENPN",10,21,31,0.67741935483871,0.32258064516129,1
"2932","CENPO",5,11,16,0.6875,0.3125,1
"2933","CENPP",5,14,19,0.736842105263158,0.263157894736842,1
"2934","CENPQ",6,17,23,0.739130434782609,0.260869565217391,1
"2935","CENPS",2,1,3,0.333333333333333,0.666666666666667,1
"2936","CENPS-CORT",5,8,13,0.615384615384615,0.384615384615385,1
"2937","CENPT",15,25,40,0.625,0.375,1
"2938","CENPU",20,17,37,0.459459459459459,0.540540540540541,1
"2939","CENPV",6,2,8,0.25,0.75,1
"2940","CENPW",4,10,14,0.714285714285714,0.285714285714286,1
"2941","CENPX",1,3,4,0.75,0.25,1
"2942","CEP104",33,62,95,0.652631578947368,0.347368421052632,1
"2943","CEP112",44,60,104,0.576923076923077,0.423076923076923,1
"2944","CEP120",41,44,85,0.517647058823529,0.482352941176471,1
"2945","CEP126",51,104,155,0.670967741935484,0.329032258064516,1
"2946","CEP128",63,80,143,0.559440559440559,0.440559440559441,1
"2947","CEP131",30,48,78,0.615384615384615,0.384615384615385,1
"2948","CEP135",43,71,114,0.62280701754386,0.37719298245614,1
"2949","CEP152",50,91,141,0.645390070921986,0.354609929078014,1
"2950","CEP162",40,81,121,0.669421487603306,0.330578512396694,1
"2951","CEP164",64,72,136,0.529411764705882,0.470588235294118,1
"2952","CEP170",61,111,172,0.645348837209302,0.354651162790698,1
"2953","CEP170B",38,49,87,0.563218390804598,0.436781609195402,1
"2954","CEP19",4,11,15,0.733333333333333,0.266666666666667,1
"2955","CEP192",67,139,206,0.674757281553398,0.325242718446602,1
"2956","CEP20",10,15,25,0.6,0.4,1
"2957","CEP250",62,133,195,0.682051282051282,0.317948717948718,1
"2958","CEP290",67,122,189,0.645502645502645,0.354497354497354,1
"2959","CEP295",1,6,7,0.857142857142857,0.142857142857143,1
"2960","CEP295NL",1,3,4,0.75,0.25,1
"2961","CEP350",79,139,218,0.637614678899083,0.362385321100917,1
"2962","CEP41",23,24,47,0.51063829787234,0.48936170212766,1
"2963","CEP43",16,13,29,0.448275862068966,0.551724137931034,1
"2964","CEP44",13,23,36,0.638888888888889,0.361111111111111,1
"2965","CEP55",17,27,44,0.613636363636364,0.386363636363636,1
"2966","CEP57",21,33,54,0.611111111111111,0.388888888888889,1
"2967","CEP57L1",12,20,32,0.625,0.375,1
"2968","CEP63",27,54,81,0.666666666666667,0.333333333333333,1
"2969","CEP68",19,41,60,0.683333333333333,0.316666666666667,1
"2970","CEP70",30,36,66,0.545454545454545,0.454545454545455,1
"2971","CEP72",27,23,50,0.46,0.54,1
"2972","CEP76",14,30,44,0.681818181818182,0.318181818181818,1
"2973","CEP78",29,25,54,0.462962962962963,0.537037037037037,1
"2974","CEP83",33,50,83,0.602409638554217,0.397590361445783,1
"2975","CEP85",20,37,57,0.649122807017544,0.350877192982456,1
"2976","CEP85L",38,44,82,0.536585365853659,0.463414634146341,1
"2977","CEP89",32,45,77,0.584415584415584,0.415584415584416,1
"2978","CEP95",36,39,75,0.52,0.48,1
"2979","CEP97",27,45,72,0.625,0.375,1
"2980","CEPT1",10,20,30,0.666666666666667,0.333333333333333,1
"2981","CER1",14,39,53,0.735849056603774,0.264150943396226,1
"2982","CERCAM",16,29,45,0.644444444444444,0.355555555555556,1
"2983","CERK",19,22,41,0.536585365853659,0.463414634146341,1
"2984","CERKL",30,73,103,0.70873786407767,0.29126213592233,1
"2985","CERS1",8,10,18,0.555555555555556,0.444444444444444,1
"2986","CERS2",10,13,23,0.565217391304348,0.434782608695652,1
"2987","CERS3",34,49,83,0.590361445783133,0.409638554216867,1
"2988","CERS4",13,18,31,0.580645161290323,0.419354838709677,1
"2989","CERS5",14,17,31,0.548387096774194,0.451612903225806,1
"2990","CERS6",17,20,37,0.540540540540541,0.459459459459459,1
"2991","CERT1",25,39,64,0.609375,0.390625,1
"2992","CES1",34,53,87,0.609195402298851,0.390804597701149,1
"2993","CES2",17,21,38,0.552631578947368,0.447368421052632,1
"2994","CES3",26,39,65,0.6,0.4,1
"2995","CES4A",14,21,35,0.6,0.4,1
"2996","CES5A",39,55,94,0.585106382978723,0.414893617021277,1
"2997","CETN1",15,36,51,0.705882352941177,0.294117647058824,1
"2998","CETN2",14,8,22,0.363636363636364,0.636363636363636,1
"2999","CETN3",12,19,31,0.612903225806452,0.387096774193548,1
"3000","CETP",16,33,49,0.673469387755102,0.326530612244898,1
"3001","CFAP100",35,53,88,0.602272727272727,0.397727272727273,1
"3002","CFAP126",8,6,14,0.428571428571429,0.571428571428571,1
"3003","CFAP157",8,9,17,0.529411764705882,0.470588235294118,1
"3004","CFAP161",18,18,36,0.5,0.5,1
"3005","CFAP20",2,12,14,0.857142857142857,0.142857142857143,1
"3006","CFAP206",45,63,108,0.583333333333333,0.416666666666667,1
"3007","CFAP20DC",20,39,59,0.661016949152542,0.338983050847458,1
"3008","CFAP221",26,53,79,0.670886075949367,0.329113924050633,1
"3009","CFAP251",54,75,129,0.581395348837209,0.418604651162791,1
"3010","CFAP298",1,3,4,0.75,0.25,1
"3011","CFAP298-TCP10L",13,24,37,0.648648648648649,0.351351351351351,1
"3012","CFAP299",29,41,70,0.585714285714286,0.414285714285714,1
"3013","CFAP300",16,18,34,0.529411764705882,0.470588235294118,1
"3014","CFAP36",15,19,34,0.558823529411765,0.441176470588235,1
"3015","CFAP410",7,4,11,0.363636363636364,0.636363636363636,1
"3016","CFAP43",64,120,184,0.652173913043478,0.347826086956522,1
"3017","CFAP44",48,70,118,0.593220338983051,0.406779661016949,1
"3018","CFAP45",34,58,92,0.630434782608696,0.369565217391304,1
"3019","CFAP46",49,95,144,0.659722222222222,0.340277777777778,1
"3020","CFAP47",129,169,298,0.567114093959732,0.432885906040268,1
"3021","CFAP52",30,60,90,0.666666666666667,0.333333333333333,1
"3022","CFAP53",25,40,65,0.615384615384615,0.384615384615385,1
"3023","CFAP54",80,163,243,0.670781893004115,0.329218106995885,1
"3024","CFAP57",20,54,74,0.72972972972973,0.27027027027027,1
"3025","CFAP58",43,101,144,0.701388888888889,0.298611111111111,1
"3026","CFAP61",73,138,211,0.654028436018957,0.345971563981043,1
"3027","CFAP65",78,158,236,0.669491525423729,0.330508474576271,1
"3028","CFAP69",46,72,118,0.610169491525424,0.389830508474576,1
"3029","CFAP70",40,66,106,0.622641509433962,0.377358490566038,1
"3030","CFAP73",0,1,1,1,0,1
"3031","CFAP74",49,80,129,0.62015503875969,0.37984496124031,1
"3032","CFAP77",17,33,50,0.66,0.34,1
"3033","CFAP91",43,88,131,0.67175572519084,0.32824427480916,1
"3034","CFAP92",17,41,58,0.706896551724138,0.293103448275862,1
"3035","CFAP94",35,47,82,0.573170731707317,0.426829268292683,1
"3036","CFAP97",17,18,35,0.514285714285714,0.485714285714286,1
"3037","CFB",2,1,3,0.333333333333333,0.666666666666667,1
"3038","CFC1",9,14,23,0.608695652173913,0.391304347826087,1
"3039","CFD",2,1,3,0.333333333333333,0.666666666666667,1
"3040","CFDP1",8,6,14,0.428571428571429,0.571428571428571,1
"3041","CFH",105,183,288,0.635416666666667,0.364583333333333,1
"3042","CFHR1",14,36,50,0.72,0.28,1
"3043","CFHR2",36,57,93,0.612903225806452,0.387096774193548,1
"3044","CFHR3",22,47,69,0.681159420289855,0.318840579710145,1
"3045","CFHR4",30,75,105,0.714285714285714,0.285714285714286,1
"3046","CFHR5",33,116,149,0.778523489932886,0.221476510067114,1
"3047","CFI",9,18,27,0.666666666666667,0.333333333333333,1
"3048","CFL1",9,12,21,0.571428571428571,0.428571428571429,1
"3049","CFL2",4,13,17,0.764705882352941,0.235294117647059,1
"3050","CFLAR",9,23,32,0.71875,0.28125,0.77
"3051","CFP",19,17,36,0.472222222222222,0.527777777777778,1
"3052","CFTR",67,162,229,0.707423580786026,0.292576419213974,1
"3053","CGA",11,13,24,0.541666666666667,0.458333333333333,1
"3054","CGAS",16,23,39,0.58974358974359,0.41025641025641,1
"3055","CGB1",9,9,18,0.5,0.5,1
"3056","CGB2",3,5,8,0.625,0.375,1
"3057","CGB3",1,6,7,0.857142857142857,0.142857142857143,1
"3058","CGB5",5,19,24,0.791666666666667,0.208333333333333,1
"3059","CGB7",6,9,15,0.6,0.4,1
"3060","CGB8",3,10,13,0.769230769230769,0.230769230769231,1
"3061","CGGBP1",8,10,18,0.555555555555556,0.444444444444444,1
"3062","CGN",39,58,97,0.597938144329897,0.402061855670103,1
"3063","CGNL1",52,89,141,0.631205673758865,0.368794326241135,1
"3064","CGREF1",5,13,18,0.722222222222222,0.277777777777778,1
"3065","CGRRF1",7,12,19,0.631578947368421,0.368421052631579,1
"3066","CH25H",18,12,30,0.4,0.6,1
"3067","CHAC1",7,9,16,0.5625,0.4375,1
"3068","CHAC2",5,9,14,0.642857142857143,0.357142857142857,1
"3069","CHAD",20,17,37,0.459459459459459,0.540540540540541,1
"3070","CHADL",0,1,1,1,0,1
"3071","CHAF1A",24,74,98,0.755102040816326,0.244897959183673,1
"3072","CHAF1B",19,27,46,0.58695652173913,0.41304347826087,1
"3073","CHAMP1",19,51,70,0.728571428571429,0.271428571428571,1
"3074","CHAT",47,94,141,0.666666666666667,0.333333333333333,1
"3075","CHCHD1",3,6,9,0.666666666666667,0.333333333333333,1
"3076","CHCHD10",0,2,2,1,0,1
"3077","CHCHD2",4,11,15,0.733333333333333,0.266666666666667,1
"3078","CHCHD2P9",21,35,56,0.625,0.375,1
"3079","CHCHD3",8,10,18,0.555555555555556,0.444444444444444,1
"3080","CHCHD4",5,5,10,0.5,0.5,1
"3081","CHCHD5",8,5,13,0.384615384615385,0.615384615384615,1
"3082","CHCHD6",4,15,19,0.789473684210526,0.210526315789474,1
"3083","CHCHD7",2,5,7,0.714285714285714,0.285714285714286,1
"3084","CHD1",51,87,138,0.630434782608696,0.369565217391304,1
"3085","CHD1L",27,46,73,0.63013698630137,0.36986301369863,1
"3086","CHD2",72,92,164,0.560975609756098,0.439024390243902,1
"3087","CHD3",75,107,182,0.587912087912088,0.412087912087912,1
"3088","CHD4",94,132,226,0.584070796460177,0.415929203539823,1
"3089","CHD5",97,165,262,0.629770992366412,0.370229007633588,1
"3090","CHD6",122,164,286,0.573426573426573,0.426573426573427,1
"3091","CHD7",121,191,312,0.612179487179487,0.387820512820513,1
"3092","CHD8",111,134,245,0.546938775510204,0.453061224489796,1
"3093","CHD9",87,165,252,0.654761904761905,0.345238095238095,1
"3094","CHDH",4,28,32,0.875,0.125,1
"3095","CHEK1",21,38,59,0.644067796610169,0.355932203389831,1
"3096","CHEK2",25,44,69,0.63768115942029,0.36231884057971,1
"3097","CHERP",28,41,69,0.594202898550725,0.405797101449275,1
"3098","CHFR",18,44,62,0.709677419354839,0.290322580645161,1
"3099","CHGA",6,22,28,0.785714285714286,0.214285714285714,1
"3100","CHGB",60,99,159,0.622641509433962,0.377358490566038,1
"3101","CHI3L1",18,25,43,0.581395348837209,0.418604651162791,1
"3102","CHI3L2",23,32,55,0.581818181818182,0.418181818181818,1
"3103","CHIA",25,48,73,0.657534246575342,0.342465753424658,1
"3104","CHIC1",8,3,11,0.272727272727273,0.727272727272727,1
"3105","CHIC2",4,8,12,0.666666666666667,0.333333333333333,1
"3106","CHID1",9,14,23,0.608695652173913,0.391304347826087,1
"3107","CHIT1",33,42,75,0.56,0.44,1
"3108","CHKA",9,19,28,0.678571428571429,0.321428571428571,1
"3109","CHKB",8,20,28,0.714285714285714,0.285714285714286,1
"3110","CHL1",85,175,260,0.673076923076923,0.326923076923077,1
"3111","CHM",30,23,53,0.433962264150943,0.566037735849057,1
"3112","CHML",29,37,66,0.560606060606061,0.439393939393939,1
"3113","CHMP1A",8,5,13,0.384615384615385,0.615384615384615,1
"3114","CHMP1B",3,11,14,0.785714285714286,0.214285714285714,1
"3115","CHMP2A",7,13,20,0.65,0.35,1
"3116","CHMP2B",11,14,25,0.56,0.44,1
"3117","CHMP3",8,18,26,0.692307692307692,0.307692307692308,1
"3118","CHMP4A",1,1,2,0.5,0.5,1
"3119","CHMP4B",9,8,17,0.470588235294118,0.529411764705882,1
"3120","CHMP4C",14,14,28,0.5,0.5,1
"3121","CHMP5",1,11,12,0.916666666666667,0.0833333333333333,1
"3122","CHMP6",9,9,18,0.5,0.5,1
"3123","CHMP7",20,23,43,0.534883720930233,0.465116279069767,1
"3124","CHN1",16,27,43,0.627906976744186,0.372093023255814,1
"3125","CHN2",3,1,4,0.25,0.75,1
"3126","CHODL",17,27,44,0.613636363636364,0.386363636363636,1
"3127","CHORDC1",15,24,39,0.615384615384615,0.384615384615385,1
"3128","CHP1",3,12,15,0.8,0.2,1
"3129","CHP2",11,21,32,0.65625,0.34375,1
"3130","CHPF",18,38,56,0.678571428571429,0.321428571428571,1
"3131","CHPF2",21,39,60,0.65,0.35,1
"3132","CHPT1",12,16,28,0.571428571428571,0.428571428571429,1
"3133","CHRAC1",3,7,10,0.7,0.3,1
"3134","CHRD",51,86,137,0.627737226277372,0.372262773722628,1
"3135","CHRDL1",47,43,90,0.477777777777778,0.522222222222222,1
"3136","CHRDL2",23,29,52,0.557692307692308,0.442307692307692,1
"3137","CHRFAM7A",12,16,28,0.571428571428571,0.428571428571429,1
"3138","CHRM1",14,22,36,0.611111111111111,0.388888888888889,1
"3139","CHRM2",60,135,195,0.692307692307692,0.307692307692308,1
"3140","CHRM3",63,133,196,0.678571428571429,0.321428571428571,1
"3141","CHRM4",21,22,43,0.511627906976744,0.488372093023256,1
"3142","CHRM5",20,30,50,0.6,0.4,1
"3143","CHRNA1",37,32,69,0.463768115942029,0.536231884057971,1
"3144","CHRNA10",19,19,38,0.5,0.5,1
"3145","CHRNA2",27,38,65,0.584615384615385,0.415384615384615,1
"3146","CHRNA3",26,38,64,0.59375,0.40625,1
"3147","CHRNA4",32,76,108,0.703703703703704,0.296296296296296,1
"3148","CHRNA5",22,17,39,0.435897435897436,0.564102564102564,1
"3149","CHRNA6",32,35,67,0.522388059701492,0.477611940298507,1
"3150","CHRNA7",18,33,51,0.647058823529412,0.352941176470588,1
"3151","CHRNA9",20,46,66,0.696969696969697,0.303030303030303,1
"3152","CHRNB1",14,29,43,0.674418604651163,0.325581395348837,1
"3153","CHRNB2",23,39,62,0.629032258064516,0.370967741935484,1
"3154","CHRNB3",22,74,96,0.770833333333333,0.229166666666667,1
"3155","CHRNB4",29,40,69,0.579710144927536,0.420289855072464,1
"3156","CHRND",32,51,83,0.614457831325301,0.385542168674699,1
"3157","CHRNE",10,14,24,0.583333333333333,0.416666666666667,1
"3158","CHRNG",18,27,45,0.6,0.4,1
"3159","CHST1",46,62,108,0.574074074074074,0.425925925925926,1
"3160","CHST10",25,29,54,0.537037037037037,0.462962962962963,1
"3161","CHST11",12,37,49,0.755102040816326,0.244897959183673,1
"3162","CHST12",22,22,44,0.5,0.5,1
"3163","CHST13",17,18,35,0.514285714285714,0.485714285714286,1
"3164","CHST14",8,10,18,0.555555555555556,0.444444444444444,1
"3165","CHST15",30,62,92,0.673913043478261,0.326086956521739,1
"3166","CHST2",32,43,75,0.573333333333333,0.426666666666667,1
"3167","CHST3",17,21,38,0.552631578947368,0.447368421052632,1
"3168","CHST4",21,34,55,0.618181818181818,0.381818181818182,1
"3169","CHST5",19,42,61,0.688524590163934,0.311475409836066,1
"3170","CHST6",18,36,54,0.666666666666667,0.333333333333333,1
"3171","CHST7",17,7,24,0.291666666666667,0.708333333333333,1
"3172","CHST8",28,43,71,0.605633802816901,0.394366197183099,1
"3173","CHST9",25,35,60,0.583333333333333,0.416666666666667,1
"3174","CHSY1",25,43,68,0.632352941176471,0.367647058823529,1
"3175","CHSY3",43,62,105,0.59047619047619,0.40952380952381,1
"3176","CHTF18",26,35,61,0.573770491803279,0.426229508196721,1
"3177","CHTF8",4,5,9,0.555555555555556,0.444444444444444,1
"3178","CHTOP",5,20,25,0.8,0.2,1
"3179","CHUK",26,43,69,0.623188405797101,0.376811594202899,1
"3180","CHURC1",4,8,12,0.666666666666667,0.333333333333333,1
"3181","CIAO1",7,16,23,0.695652173913043,0.304347826086957,1
"3182","CIAO2A",9,6,15,0.4,0.6,1
"3183","CIAO2B",2,2,4,0.5,0.5,1
"3184","CIAO3",16,21,37,0.567567567567568,0.432432432432432,1
"3185","CIAPIN1",15,11,26,0.423076923076923,0.576923076923077,1
"3186","CIART",17,25,42,0.595238095238095,0.404761904761905,0.77
"3187","CIB1",6,8,14,0.571428571428571,0.428571428571429,1
"3188","CIB2",7,9,16,0.5625,0.4375,1
"3189","CIB3",25,23,48,0.479166666666667,0.520833333333333,1
"3190","CIB4",7,19,26,0.730769230769231,0.269230769230769,1
"3191","CIBAR1",7,11,18,0.611111111111111,0.388888888888889,0.77
"3192","CIBAR2",12,21,33,0.636363636363636,0.363636363636364,0.77
"3193","CIC",136,159,295,0.538983050847458,0.461016949152542,1
"3194","CIDEA",17,17,34,0.5,0.5,1
"3195","CIDEB",4,7,11,0.636363636363636,0.363636363636364,1
"3196","CIDEC",6,8,14,0.571428571428571,0.428571428571429,1
"3197","CIITA",64,96,160,0.6,0.4,1
"3198","CILK1",15,51,66,0.772727272727273,0.227272727272727,1
"3199","CILP",46,93,139,0.669064748201439,0.330935251798561,1
"3200","CILP2",48,101,149,0.677852348993289,0.322147651006711,1
"3201","CINP",2,8,10,0.8,0.2,1
"3202","CIP2A",31,56,87,0.64367816091954,0.35632183908046,1
"3203","CIPC",6,19,25,0.76,0.24,1
"3204","CIR1",9,27,36,0.75,0.25,1
"3205","CIRBP",2,16,18,0.888888888888889,0.111111111111111,1
"3206","CISD1",1,5,6,0.833333333333333,0.166666666666667,1
"3207","CISD2",4,4,8,0.5,0.5,1
"3208","CISD3",0,2,2,1,0,1
"3209","CISH",9,15,24,0.625,0.375,1
"3210","CIT",68,130,198,0.656565656565657,0.343434343434343,1
"3211","CITED1",2,2,4,0.5,0.5,1
"3212","CITED2",8,16,24,0.666666666666667,0.333333333333333,1
"3213","CIZ1",34,28,62,0.451612903225806,0.548387096774194,1
"3214","CKAP2",29,41,70,0.585714285714286,0.414285714285714,1
"3215","CKAP2L",26,36,62,0.580645161290323,0.419354838709677,1
"3216","CKAP4",16,29,45,0.644444444444444,0.355555555555556,1
"3217","CKAP5",48,95,143,0.664335664335664,0.335664335664336,1
"3218","CKB",9,12,21,0.571428571428571,0.428571428571429,1
"3219","CKLF",5,7,12,0.583333333333333,0.416666666666667,1
"3220","CKLF-CMTM1",2,3,5,0.6,0.4,1
"3221","CKM",23,26,49,0.530612244897959,0.469387755102041,1
"3222","CKMT1A",4,13,17,0.764705882352941,0.235294117647059,1
"3223","CKMT1B",10,8,18,0.444444444444444,0.555555555555556,1
"3224","CKMT2",23,31,54,0.574074074074074,0.425925925925926,1
"3225","CKS1B",5,8,13,0.615384615384615,0.384615384615385,1
"3226","CKS2",4,8,12,0.666666666666667,0.333333333333333,1
"3227","CLASP1",37,81,118,0.686440677966102,0.313559322033898,1
"3228","CLASP2",33,71,104,0.682692307692308,0.317307692307692,1
"3229","CLASRP",32,25,57,0.43859649122807,0.56140350877193,1
"3230","CLBA1",7,12,19,0.631578947368421,0.368421052631579,1
"3231","CLC",9,13,22,0.590909090909091,0.409090909090909,1
"3232","CLCA1",40,68,108,0.62962962962963,0.37037037037037,1
"3233","CLCA2",35,62,97,0.639175257731959,0.360824742268041,1
"3234","CLCA3P",18,24,42,0.571428571428571,0.428571428571429,1
"3235","CLCA4",64,92,156,0.58974358974359,0.41025641025641,1
"3236","CLCC1",11,22,33,0.666666666666667,0.333333333333333,1
"3237","CLCF1",6,9,15,0.6,0.4,1
"3238","CLCN1",68,116,184,0.630434782608696,0.369565217391304,1
"3239","CLCN2",37,55,92,0.597826086956522,0.402173913043478,1
"3240","CLCN3",37,56,93,0.602150537634409,0.397849462365591,1
"3241","CLCN4",52,50,102,0.490196078431373,0.509803921568627,1
"3242","CLCN5",47,24,71,0.338028169014085,0.661971830985915,1
"3243","CLCN6",37,54,91,0.593406593406593,0.406593406593407,1
"3244","CLCN7",22,35,57,0.614035087719298,0.385964912280702,1
"3245","CLCNKA",30,36,66,0.545454545454545,0.454545454545455,1
"3246","CLCNKB",30,48,78,0.615384615384615,0.384615384615385,1
"3247","CLDN1",5,16,21,0.761904761904762,0.238095238095238,1
"3248","CLDN10",16,29,45,0.644444444444444,0.355555555555556,1
"3249","CLDN11",6,14,20,0.7,0.3,1
"3250","CLDN12",11,18,29,0.620689655172414,0.379310344827586,1
"3251","CLDN14",3,25,28,0.892857142857143,0.107142857142857,1
"3252","CLDN15",7,7,14,0.5,0.5,1
"3253","CLDN16",20,28,48,0.583333333333333,0.416666666666667,1
"3254","CLDN17",18,22,40,0.55,0.45,1
"3255","CLDN18",20,27,47,0.574468085106383,0.425531914893617,1
"3256","CLDN19",9,12,21,0.571428571428571,0.428571428571429,1
"3257","CLDN2",15,12,27,0.444444444444444,0.555555555555556,1
"3258","CLDN20",6,4,10,0.4,0.6,1
"3259","CLDN22",8,12,20,0.6,0.4,1
"3260","CLDN23",3,4,7,0.571428571428571,0.428571428571429,1
"3261","CLDN25",10,26,36,0.722222222222222,0.277777777777778,1
"3262","CLDN3",6,2,8,0.25,0.75,1
"3263","CLDN4",10,23,33,0.696969696969697,0.303030303030303,1
"3264","CLDN5",5,11,16,0.6875,0.3125,1
"3265","CLDN6",20,19,39,0.487179487179487,0.512820512820513,1
"3266","CLDN7",5,6,11,0.545454545454545,0.454545454545455,1
"3267","CLDN8",20,22,42,0.523809523809524,0.476190476190476,1
"3268","CLDN9",12,12,24,0.5,0.5,1
"3269","CLDND1",11,10,21,0.476190476190476,0.523809523809524,1
"3270","CLDND2",5,4,9,0.444444444444444,0.555555555555556,1
"3271","CLEC10A",3,27,30,0.9,0.1,1
"3272","CLEC11A",3,12,15,0.8,0.2,1
"3273","CLEC12A",14,22,36,0.611111111111111,0.388888888888889,1
"3274","CLEC12B",13,13,26,0.5,0.5,1
"3275","CLEC14A",45,63,108,0.583333333333333,0.416666666666667,1
"3276","CLEC16A",56,48,104,0.461538461538462,0.538461538461538,1
"3277","CLEC17A",15,24,39,0.615384615384615,0.384615384615385,1
"3278","CLEC18A",4,9,13,0.692307692307692,0.307692307692308,1
"3279","CLEC18B",20,32,52,0.615384615384615,0.384615384615385,1
"3280","CLEC18C",6,9,15,0.6,0.4,1
"3281","CLEC1A",18,37,55,0.672727272727273,0.327272727272727,1
"3282","CLEC1B",13,26,39,0.666666666666667,0.333333333333333,1
"3283","CLEC2A",0,3,3,1,0,1
"3284","CLEC2B",7,20,27,0.740740740740741,0.259259259259259,1
"3285","CLEC2D",7,12,19,0.631578947368421,0.368421052631579,1
"3286","CLEC2L",2,5,7,0.714285714285714,0.285714285714286,1
"3287","CLEC3A",22,33,55,0.6,0.4,1
"3288","CLEC3B",10,12,22,0.545454545454545,0.454545454545455,1
"3289","CLEC4A",16,10,26,0.384615384615385,0.615384615384615,1
"3290","CLEC4C",16,36,52,0.692307692307692,0.307692307692308,1
"3291","CLEC4D",16,28,44,0.636363636363636,0.363636363636364,1
"3292","CLEC4E",16,33,49,0.673469387755102,0.326530612244898,1
"3293","CLEC4F",36,59,95,0.621052631578947,0.378947368421053,1
"3294","CLEC4G",13,13,26,0.5,0.5,1
"3295","CLEC4M",15,39,54,0.722222222222222,0.277777777777778,1
"3296","CLEC5A",20,28,48,0.583333333333333,0.416666666666667,1
"3297","CLEC6A",16,28,44,0.636363636363636,0.363636363636364,1
"3298","CLEC7A",10,21,31,0.67741935483871,0.32258064516129,1
"3299","CLEC9A",23,31,54,0.574074074074074,0.425925925925926,1
"3300","CLECL1",5,10,15,0.666666666666667,0.333333333333333,1
"3301","CLGN",23,51,74,0.689189189189189,0.310810810810811,1
"3302","CLHC1",15,34,49,0.693877551020408,0.306122448979592,1
"3303","CLIC1",5,14,19,0.736842105263158,0.263157894736842,1
"3304","CLIC2",12,12,24,0.5,0.5,1
"3305","CLIC3",4,5,9,0.555555555555556,0.444444444444444,1
"3306","CLIC4",5,17,22,0.772727272727273,0.227272727272727,1
"3307","CLIC5",14,27,41,0.658536585365854,0.341463414634146,1
"3308","CLIC6",17,24,41,0.585365853658537,0.414634146341463,1
"3309","CLINT1",21,25,46,0.543478260869565,0.456521739130435,1
"3310","CLIP1",55,72,127,0.566929133858268,0.433070866141732,1
"3311","CLIP2",51,60,111,0.540540540540541,0.459459459459459,1
"3312","CLIP3",32,25,57,0.43859649122807,0.56140350877193,1
"3313","CLIP4",34,57,91,0.626373626373626,0.373626373626374,1
"3314","CLK1",22,38,60,0.633333333333333,0.366666666666667,1
"3315","CLK2",25,52,77,0.675324675324675,0.324675324675325,1
"3316","CLK3",23,29,52,0.557692307692308,0.442307692307692,1
"3317","CLK4",16,21,37,0.567567567567568,0.432432432432432,1
"3318","CLLU1",2,8,10,0.8,0.2,1
"3319","CLMN",45,64,109,0.587155963302752,0.412844036697248,1
"3320","CLMP",18,27,45,0.6,0.4,1
"3321","CLN3",14,34,48,0.708333333333333,0.291666666666667,1
"3322","CLN5",7,8,15,0.533333333333333,0.466666666666667,1
"3323","CLN6",8,13,21,0.619047619047619,0.380952380952381,1
"3324","CLN8",15,17,32,0.53125,0.46875,1
"3325","CLNK",25,28,53,0.528301886792453,0.471698113207547,1
"3326","CLNS1A",8,9,17,0.529411764705882,0.470588235294118,1
"3327","CLOCK",37,53,90,0.588888888888889,0.411111111111111,1
"3328","CLP1",10,22,32,0.6875,0.3125,1
"3329","CLPB",22,34,56,0.607142857142857,0.392857142857143,1
"3330","CLPP",11,8,19,0.421052631578947,0.578947368421053,1
"3331","CLPS",5,10,15,0.666666666666667,0.333333333333333,1
"3332","CLPSL1",7,4,11,0.363636363636364,0.636363636363636,1
"3333","CLPSL2",2,4,6,0.666666666666667,0.333333333333333,1
"3334","CLPTM1",22,46,68,0.676470588235294,0.323529411764706,1
"3335","CLPTM1L",13,37,50,0.74,0.26,1
"3336","CLPX",17,20,37,0.540540540540541,0.459459459459459,1
"3337","CLRN1",8,28,36,0.777777777777778,0.222222222222222,1
"3338","CLRN2",10,27,37,0.72972972972973,0.27027027027027,1
"3339","CLRN3",7,10,17,0.588235294117647,0.411764705882353,1
"3340","CLSPN",40,61,101,0.603960396039604,0.396039603960396,1
"3341","CLSTN1",35,40,75,0.533333333333333,0.466666666666667,1
"3342","CLSTN2",65,142,207,0.685990338164251,0.314009661835749,1
"3343","CLSTN3",32,67,99,0.676767676767677,0.323232323232323,1
"3344","CLTA",10,11,21,0.523809523809524,0.476190476190476,1
"3345","CLTB",9,8,17,0.470588235294118,0.529411764705882,1
"3346","CLTC",50,82,132,0.621212121212121,0.378787878787879,1
"3347","CLTCL1",46,71,117,0.606837606837607,0.393162393162393,1
"3348","CLTRN",7,6,13,0.461538461538462,0.538461538461538,1
"3349","CLU",19,30,49,0.612244897959184,0.387755102040816,1
"3350","CLUAP1",6,24,30,0.8,0.2,1
"3351","CLUH",47,71,118,0.601694915254237,0.398305084745763,1
"3352","CLUL1",18,24,42,0.571428571428571,0.428571428571429,1
"3353","CLVS1",30,77,107,0.719626168224299,0.280373831775701,1
"3354","CLVS2",36,54,90,0.6,0.4,1
"3355","CLYBL",13,35,48,0.729166666666667,0.270833333333333,1
"3356","CMA1",6,26,32,0.8125,0.1875,1
"3357","CMAHP",0,2,2,1,0,1
"3358","CMAS",21,29,50,0.58,0.42,1
"3359","CMBL",11,16,27,0.592592592592593,0.407407407407407,1
"3360","CMC1",4,5,9,0.555555555555556,0.444444444444444,1
"3361","CMC2",4,4,8,0.5,0.5,1
"3362","CMC4",6,3,9,0.333333333333333,0.666666666666667,1
"3363","CMIP",18,36,54,0.666666666666667,0.333333333333333,1
"3364","CMKLR1",32,46,78,0.58974358974359,0.41025641025641,1
"3365","CMPK1",5,13,18,0.722222222222222,0.277777777777778,1
"3366","CMPK2",12,18,30,0.6,0.4,1
"3367","CMSS1",17,25,42,0.595238095238095,0.404761904761905,1
"3368","CMTM1",7,11,18,0.611111111111111,0.388888888888889,1
"3369","CMTM2",6,12,18,0.666666666666667,0.333333333333333,1
"3370","CMTM3",8,3,11,0.272727272727273,0.727272727272727,1
"3371","CMTM4",4,7,11,0.636363636363636,0.363636363636364,1
"3372","CMTM5",18,20,38,0.526315789473684,0.473684210526316,1
"3373","CMTM6",4,4,8,0.5,0.5,1
"3374","CMTM7",6,11,17,0.647058823529412,0.352941176470588,1
"3375","CMTM8",10,7,17,0.411764705882353,0.588235294117647,1
"3376","CMTR1",32,34,66,0.515151515151515,0.484848484848485,1
"3377","CMTR2",48,61,109,0.559633027522936,0.440366972477064,1
"3378","CMYA5",171,324,495,0.654545454545455,0.345454545454545,1
"3379","CNBD1",47,65,112,0.580357142857143,0.419642857142857,1
"3380","CNBD2",16,42,58,0.724137931034483,0.275862068965517,1
"3381","CNBP",5,9,14,0.642857142857143,0.357142857142857,1
"3382","CNDP1",29,41,70,0.585714285714286,0.414285714285714,1
"3383","CNDP2",25,31,56,0.553571428571429,0.446428571428571,1
"3384","CNEP1R1",1,0,1,0,1,1
"3385","CNFN",3,4,7,0.571428571428571,0.428571428571429,1
"3386","CNGA1",27,79,106,0.745283018867924,0.254716981132075,1
"3387","CNGA2",48,74,122,0.60655737704918,0.39344262295082,1
"3388","CNGA3",52,70,122,0.573770491803279,0.426229508196721,1
"3389","CNGA4",37,66,103,0.640776699029126,0.359223300970874,1
"3390","CNGB1",54,81,135,0.6,0.4,1
"3391","CNGB3",51,158,209,0.755980861244019,0.244019138755981,1
"3392","CNIH1",7,10,17,0.588235294117647,0.411764705882353,1
"3393","CNIH2",5,8,13,0.615384615384615,0.384615384615385,1
"3394","CNIH3",6,15,21,0.714285714285714,0.285714285714286,1
"3395","CNIH4",4,6,10,0.6,0.4,1
"3396","CNKSR1",38,50,88,0.568181818181818,0.431818181818182,1
"3397","CNKSR2",73,91,164,0.554878048780488,0.445121951219512,1
"3398","CNKSR3",16,38,54,0.703703703703704,0.296296296296296,1
"3399","CNMD",11,30,41,0.731707317073171,0.268292682926829,1
"3400","CNN1",11,29,40,0.725,0.275,1
"3401","CNN2",13,15,28,0.535714285714286,0.464285714285714,1
"3402","CNN3",8,10,18,0.555555555555556,0.444444444444444,1
"3403","CNNM1",32,46,78,0.58974358974359,0.41025641025641,1
"3404","CNNM2",30,48,78,0.615384615384615,0.384615384615385,1
"3405","CNNM3",16,15,31,0.483870967741935,0.516129032258065,1
"3406","CNNM4",23,44,67,0.656716417910448,0.343283582089552,1
"3407","CNOT1",119,162,281,0.576512455516014,0.423487544483986,1
"3408","CNOT10",31,29,60,0.483333333333333,0.516666666666667,1
"3409","CNOT11",15,25,40,0.625,0.375,1
"3410","CNOT2",17,40,57,0.701754385964912,0.298245614035088,1
"3411","CNOT3",18,52,70,0.742857142857143,0.257142857142857,1
"3412","CNOT4",40,43,83,0.518072289156627,0.481927710843373,1
"3413","CNOT6",22,26,48,0.541666666666667,0.458333333333333,1
"3414","CNOT6L",17,31,48,0.645833333333333,0.354166666666667,1
"3415","CNOT7",9,14,23,0.608695652173913,0.391304347826087,1
"3416","CNOT8",14,13,27,0.481481481481481,0.518518518518518,1
"3417","CNOT9",17,21,38,0.552631578947368,0.447368421052632,1
"3418","CNP",8,11,19,0.578947368421053,0.421052631578947,1
"3419","CNPPD1",13,21,34,0.617647058823529,0.382352941176471,1
"3420","CNPY1",6,14,20,0.7,0.3,1
"3421","CNPY2",9,10,19,0.526315789473684,0.473684210526316,1
"3422","CNPY3",3,10,13,0.769230769230769,0.230769230769231,1
"3423","CNPY4",11,11,22,0.5,0.5,1
"3424","CNR1",34,67,101,0.663366336633663,0.336633663366337,1
"3425","CNR2",12,25,37,0.675675675675676,0.324324324324324,1
"3426","CNRIP1",6,13,19,0.684210526315789,0.315789473684211,1
"3427","CNST",29,55,84,0.654761904761905,0.345238095238095,1
"3428","CNTD1",12,17,29,0.586206896551724,0.413793103448276,1
"3429","CNTF",14,17,31,0.548387096774194,0.451612903225806,1
"3430","CNTFR",13,22,35,0.628571428571429,0.371428571428571,1
"3431","CNTLN",72,103,175,0.588571428571429,0.411428571428571,1
"3432","CNTN1",86,137,223,0.614349775784753,0.385650224215247,1
"3433","CNTN2",49,82,131,0.625954198473282,0.374045801526718,1
"3434","CNTN3",65,132,197,0.67005076142132,0.32994923857868,1
"3435","CNTN4",75,164,239,0.686192468619247,0.313807531380753,1
"3436","CNTN5",97,213,310,0.687096774193548,0.312903225806452,1
"3437","CNTN6",96,174,270,0.644444444444444,0.355555555555556,1
"3438","CNTNAP1",47,78,125,0.624,0.376,1
"3439","CNTNAP2",177,303,480,0.63125,0.36875,1
"3440","CNTNAP3",39,65,104,0.625,0.375,1
"3441","CNTNAP3P2",1,1,2,0.5,0.5,1
"3442","CNTNAP4",95,239,334,0.715568862275449,0.284431137724551,1
"3443","CNTNAP5",146,292,438,0.666666666666667,0.333333333333333,1
"3444","CNTRL",55,101,156,0.647435897435897,0.352564102564103,1
"3445","CNTROB",24,48,72,0.666666666666667,0.333333333333333,1
"3446","COA1",3,4,7,0.571428571428571,0.428571428571429,1
"3447","COA3",2,2,4,0.5,0.5,1
"3448","COA4",3,5,8,0.625,0.375,1
"3449","COA5",1,6,7,0.857142857142857,0.142857142857143,1
"3450","COA6",2,11,13,0.846153846153846,0.153846153846154,1
"3451","COA7",9,12,21,0.571428571428571,0.428571428571429,1
"3452","COA8",7,11,18,0.611111111111111,0.388888888888889,1
"3453","COASY",13,22,35,0.628571428571429,0.371428571428571,1
"3454","COBL",69,111,180,0.616666666666667,0.383333333333333,1
"3455","COBLL1",65,95,160,0.59375,0.40625,1
"3456","COCH",18,31,49,0.63265306122449,0.36734693877551,1
"3457","COG1",29,32,61,0.524590163934426,0.475409836065574,1
"3458","COG2",27,31,58,0.53448275862069,0.46551724137931,1
"3459","COG3",22,27,49,0.551020408163265,0.448979591836735,1
"3460","COG4",26,39,65,0.6,0.4,1
"3461","COG5",29,57,86,0.662790697674419,0.337209302325581,1
"3462","COG6",22,42,64,0.65625,0.34375,1
"3463","COG7",25,36,61,0.590163934426229,0.409836065573771,1
"3464","COG8",17,32,49,0.653061224489796,0.346938775510204,1
"3465","COIL",27,27,54,0.5,0.5,1
"3466","COL10A1",26,23,49,0.469387755102041,0.530612244897959,1
"3467","COL11A1",238,411,649,0.633281972265023,0.366718027734977,1
"3468","COL11A2",88,159,247,0.643724696356275,0.356275303643725,1
"3469","COL12A1",188,280,468,0.598290598290598,0.401709401709402,1
"3470","COL13A1",36,65,101,0.643564356435644,0.356435643564356,1
"3471","COL14A1",118,238,356,0.668539325842697,0.331460674157303,1
"3472","COL15A1",80,141,221,0.638009049773756,0.361990950226244,1
"3473","COL16A1",51,91,142,0.640845070422535,0.359154929577465,1
"3474","COL17A1",60,76,136,0.558823529411765,0.441176470588235,1
"3475","COL18A1",55,78,133,0.586466165413534,0.413533834586466,1
"3476","COL18A1-AS1",3,14,17,0.823529411764706,0.176470588235294,1
"3477","COL19A1",90,178,268,0.664179104477612,0.335820895522388,1
"3478","COL1A1",72,125,197,0.634517766497462,0.365482233502538,1
"3479","COL1A2",103,199,302,0.658940397350993,0.341059602649007,1
"3480","COL20A1",50,95,145,0.655172413793103,0.344827586206897,1
"3481","COL21A1",67,166,233,0.71244635193133,0.28755364806867,1
"3482","COL22A1",145,334,479,0.697286012526096,0.302713987473904,1
"3483","COL23A1",26,37,63,0.587301587301587,0.412698412698413,1
"3484","COL24A1",105,173,278,0.622302158273381,0.377697841726619,1
"3485","COL25A1",59,93,152,0.611842105263158,0.388157894736842,1
"3486","COL26A1",21,39,60,0.65,0.35,1
"3487","COL27A1",86,140,226,0.619469026548673,0.380530973451327,1
"3488","COL28A1",62,101,163,0.619631901840491,0.380368098159509,1
"3489","COL2A1",75,141,216,0.652777777777778,0.347222222222222,1
"3490","COL3A1",128,226,354,0.638418079096045,0.361581920903955,1
"3491","COL4A1",108,187,295,0.633898305084746,0.366101694915254,1
"3492","COL4A2",90,141,231,0.61038961038961,0.38961038961039,1
"3493","COL4A3",57,142,199,0.71356783919598,0.28643216080402,1
"3494","COL4A4",113,242,355,0.68169014084507,0.31830985915493,1
"3495","COL4A5",139,142,281,0.505338078291815,0.494661921708185,1
"3496","COL4A6",122,90,212,0.424528301886792,0.575471698113208,1
"3497","COL5A1",145,248,393,0.631043256997455,0.368956743002545,1
"3498","COL5A2",105,191,296,0.64527027027027,0.35472972972973,1
"3499","COL5A3",95,193,288,0.670138888888889,0.329861111111111,1
"3500","COL6A1",42,57,99,0.575757575757576,0.424242424242424,1
"3501","COL6A2",60,102,162,0.62962962962963,0.37037037037037,1
"3502","COL6A3",210,316,526,0.600760456273764,0.399239543726236,1
"3503","COL6A5",35,76,111,0.684684684684685,0.315315315315315,1
"3504","COL6A6",136,270,406,0.665024630541872,0.334975369458128,1
"3505","COL7A1",152,228,380,0.6,0.4,1
"3506","COL8A1",34,80,114,0.701754385964912,0.298245614035088,1
"3507","COL8A2",26,39,65,0.6,0.4,1
"3508","COL9A1",73,149,222,0.671171171171171,0.328828828828829,1
"3509","COL9A2",32,63,95,0.663157894736842,0.336842105263158,1
"3510","COL9A3",36,56,92,0.608695652173913,0.391304347826087,1
"3511","COLCA2",0,1,1,1,0,1
"3512","COLEC10",12,27,39,0.692307692307692,0.307692307692308,1
"3513","COLEC11",22,30,52,0.576923076923077,0.423076923076923,1
"3514","COLEC12",46,75,121,0.619834710743802,0.380165289256198,1
"3515","COLGALT1",21,34,55,0.618181818181818,0.381818181818182,1
"3516","COLGALT2",29,53,82,0.646341463414634,0.353658536585366,1
"3517","COLQ",26,26,52,0.5,0.5,1
"3518","COMMD1",4,6,10,0.6,0.4,1
"3519","COMMD10",7,8,15,0.533333333333333,0.466666666666667,1
"3520","COMMD2",10,12,22,0.545454545454545,0.454545454545455,1
"3521","COMMD3",2,3,5,0.6,0.4,1
"3522","COMMD3-BMI1",2,5,7,0.714285714285714,0.285714285714286,1
"3523","COMMD4",4,6,10,0.6,0.4,1
"3524","COMMD5",7,10,17,0.588235294117647,0.411764705882353,1
"3525","COMMD6",4,4,8,0.5,0.5,1
"3526","COMMD7",3,1,4,0.25,0.75,1
"3527","COMMD8",5,12,17,0.705882352941177,0.294117647058824,1
"3528","COMMD9",8,3,11,0.272727272727273,0.727272727272727,1
"3529","COMP",18,42,60,0.7,0.3,1
"3530","COMT",3,13,16,0.8125,0.1875,1
"3531","COMTD1",2,4,6,0.666666666666667,0.333333333333333,1
"3532","COP1",29,60,89,0.674157303370786,0.325842696629214,1
"3533","COPA",43,81,124,0.653225806451613,0.346774193548387,1
"3534","COPB1",31,51,82,0.621951219512195,0.378048780487805,1
"3535","COPB2",30,39,69,0.565217391304348,0.434782608695652,1
"3536","COPE",7,12,19,0.631578947368421,0.368421052631579,1
"3537","COPG1",27,42,69,0.608695652173913,0.391304347826087,1
"3538","COPG2",9,18,27,0.666666666666667,0.333333333333333,1
"3539","COPRS",6,9,15,0.6,0.4,1
"3540","COPS2",20,38,58,0.655172413793103,0.344827586206897,1
"3541","COPS3",10,26,36,0.722222222222222,0.277777777777778,1
"3542","COPS4",16,30,46,0.652173913043478,0.347826086956522,1
"3543","COPS5",5,24,29,0.827586206896552,0.172413793103448,1
"3544","COPS6",15,14,29,0.482758620689655,0.517241379310345,1
"3545","COPS7A",12,15,27,0.555555555555556,0.444444444444444,1
"3546","COPS7B",5,8,13,0.615384615384615,0.384615384615385,1
"3547","COPS8",5,6,11,0.545454545454545,0.454545454545455,1
"3548","COPS9",6,2,8,0.25,0.75,1
"3549","COPZ1",3,10,13,0.769230769230769,0.230769230769231,1
"3550","COPZ2",2,7,9,0.777777777777778,0.222222222222222,1
"3551","COQ10A",4,10,14,0.714285714285714,0.285714285714286,1
"3552","COQ10B",4,13,17,0.764705882352941,0.235294117647059,1
"3553","COQ2",8,8,16,0.5,0.5,1
"3554","COQ3",5,21,26,0.807692307692308,0.192307692307692,1
"3555","COQ4",8,6,14,0.428571428571429,0.571428571428571,1
"3556","COQ5",13,15,28,0.535714285714286,0.464285714285714,1
"3557","COQ6",12,23,35,0.657142857142857,0.342857142857143,1
"3558","COQ7",9,12,21,0.571428571428571,0.428571428571429,1
"3559","COQ8A",24,30,54,0.555555555555556,0.444444444444444,1
"3560","COQ8B",18,32,50,0.64,0.36,1
"3561","COQ9",14,15,29,0.517241379310345,0.482758620689655,1
"3562","CORIN",81,100,181,0.552486187845304,0.447513812154696,1
"3563","CORO1A",16,20,36,0.555555555555556,0.444444444444444,1
"3564","CORO1B",13,16,29,0.551724137931034,0.448275862068966,1
"3565","CORO1C",22,31,53,0.584905660377358,0.415094339622642,1
"3566","CORO2A",20,34,54,0.62962962962963,0.37037037037037,1
"3567","CORO2B",20,34,54,0.62962962962963,0.37037037037037,1
"3568","CORO6",16,21,37,0.567567567567568,0.432432432432432,1
"3569","CORO7",32,35,67,0.522388059701492,0.477611940298507,1
"3570","CORO7-PAM16",3,9,12,0.75,0.25,1
"3571","CORT",0,2,2,1,0,1
"3572","COTL1",6,7,13,0.538461538461538,0.461538461538462,1
"3573","COX10",18,29,47,0.617021276595745,0.382978723404255,1
"3574","COX11",10,8,18,0.444444444444444,0.555555555555556,1
"3575","COX14",0,2,2,1,0,1
"3576","COX15",10,18,28,0.642857142857143,0.357142857142857,1
"3577","COX16",5,5,10,0.5,0.5,1
"3578","COX17",2,2,4,0.5,0.5,1
"3579","COX18",9,15,24,0.625,0.375,1
"3580","COX19",7,6,13,0.461538461538462,0.538461538461538,1
"3581","COX20",5,5,10,0.5,0.5,1
"3582","COX4I1",8,5,13,0.384615384615385,0.615384615384615,1
"3583","COX4I2",3,16,19,0.842105263157895,0.157894736842105,1
"3584","COX5A",7,6,13,0.461538461538462,0.538461538461538,1
"3585","COX5B",6,3,9,0.333333333333333,0.666666666666667,1
"3586","COX6A1",1,5,6,0.833333333333333,0.166666666666667,1
"3587","COX6A2",2,2,4,0.5,0.5,1
"3588","COX6B1",1,11,12,0.916666666666667,0.0833333333333333,1
"3589","COX6B2",3,2,5,0.4,0.6,1
"3590","COX6C",1,8,9,0.888888888888889,0.111111111111111,1
"3591","COX7A1",1,5,6,0.833333333333333,0.166666666666667,1
"3592","COX7A2",0,3,3,1,0,1
"3593","COX7A2L",4,8,12,0.666666666666667,0.333333333333333,1
"3594","COX7B",7,4,11,0.363636363636364,0.636363636363636,1
"3595","COX7B2",7,15,22,0.681818181818182,0.318181818181818,1
"3596","COX7C",3,3,6,0.5,0.5,1
"3597","COX8A",2,4,6,0.666666666666667,0.333333333333333,1
"3598","COX8C",6,5,11,0.454545454545455,0.545454545454545,1
"3599","CP",38,60,98,0.612244897959184,0.387755102040816,1
"3600","CPA1",22,44,66,0.666666666666667,0.333333333333333,1
"3601","CPA2",15,33,48,0.6875,0.3125,1
"3602","CPA3",24,67,91,0.736263736263736,0.263736263736264,1
"3603","CPA4",37,27,64,0.421875,0.578125,1
"3604","CPA5",22,38,60,0.633333333333333,0.366666666666667,1
"3605","CPA6",32,45,77,0.584415584415584,0.415584415584416,1
"3606","CPAMD8",95,178,273,0.652014652014652,0.347985347985348,1
"3607","CPB1",26,49,75,0.653333333333333,0.346666666666667,1
"3608","CPB2",25,35,60,0.583333333333333,0.416666666666667,1
"3609","CPD",43,66,109,0.605504587155963,0.394495412844037,1
"3610","CPE",33,43,76,0.565789473684211,0.434210526315789,1
"3611","CPEB1",31,50,81,0.617283950617284,0.382716049382716,1
"3612","CPEB2",22,40,62,0.645161290322581,0.354838709677419,1
"3613","CPEB3",17,31,48,0.645833333333333,0.354166666666667,1
"3614","CPEB4",38,41,79,0.518987341772152,0.481012658227848,1
"3615","CPED1",71,133,204,0.651960784313726,0.348039215686274,1
"3616","CPLANE1",27,43,70,0.614285714285714,0.385714285714286,1
"3617","CPLANE2",8,11,19,0.578947368421053,0.421052631578947,1
"3618","CPLX1",5,12,17,0.705882352941177,0.294117647058824,1
"3619","CPLX2",8,15,23,0.652173913043478,0.347826086956522,1
"3620","CPLX3",7,14,21,0.666666666666667,0.333333333333333,1
"3621","CPLX4",13,15,28,0.535714285714286,0.464285714285714,1
"3622","CPM",18,30,48,0.625,0.375,1
"3623","CPN1",21,46,67,0.686567164179104,0.313432835820896,1
"3624","CPN2",26,37,63,0.587301587301587,0.412698412698413,1
"3625","CPNE1",13,34,47,0.723404255319149,0.276595744680851,1
"3626","CPNE2",18,24,42,0.571428571428571,0.428571428571429,1
"3627","CPNE3",22,35,57,0.614035087719298,0.385964912280702,1
"3628","CPNE4",49,79,128,0.6171875,0.3828125,1
"3629","CPNE5",17,32,49,0.653061224489796,0.346938775510204,1
"3630","CPNE6",32,39,71,0.549295774647887,0.450704225352113,1
"3631","CPNE7",15,29,44,0.659090909090909,0.340909090909091,1
"3632","CPNE8",22,52,74,0.702702702702703,0.297297297297297,1
"3633","CPNE9",24,29,53,0.547169811320755,0.452830188679245,1
"3634","CPO",27,27,54,0.5,0.5,1
"3635","CPOX",9,17,26,0.653846153846154,0.346153846153846,1
"3636","CPPED1",13,23,36,0.638888888888889,0.361111111111111,1
"3637","CPQ",31,45,76,0.592105263157895,0.407894736842105,1
"3638","CPS1",114,194,308,0.62987012987013,0.37012987012987,1
"3639","CPSF1",52,64,116,0.551724137931034,0.448275862068966,1
"3640","CPSF2",20,30,50,0.6,0.4,1
"3641","CPSF3",20,30,50,0.6,0.4,1
"3642","CPSF4",8,11,19,0.578947368421053,0.421052631578947,1
"3643","CPSF4L",0,3,3,1,0,1
"3644","CPSF6",24,39,63,0.619047619047619,0.380952380952381,1
"3645","CPSF7",16,15,31,0.483870967741935,0.516129032258065,1
"3646","CPT1A",48,54,102,0.529411764705882,0.470588235294118,1
"3647","CPT1B",19,38,57,0.666666666666667,0.333333333333333,1
"3648","CPT1C",34,61,95,0.642105263157895,0.357894736842105,1
"3649","CPT2",21,19,40,0.475,0.525,1
"3650","CPTP",4,9,13,0.692307692307692,0.307692307692308,1
"3651","CPVL",17,43,60,0.716666666666667,0.283333333333333,1
"3652","CPXCR1",57,47,104,0.451923076923077,0.548076923076923,1
"3653","CPXM1",48,56,104,0.538461538461538,0.461538461538462,1
"3654","CPXM2",65,83,148,0.560810810810811,0.439189189189189,1
"3655","CPZ",49,68,117,0.581196581196581,0.418803418803419,1
"3656","CR1",77,153,230,0.665217391304348,0.334782608695652,1
"3657","CR1L",35,57,92,0.619565217391304,0.380434782608696,1
"3658","CR2",83,144,227,0.634361233480176,0.365638766519824,1
"3659","CRABP1",6,8,14,0.571428571428571,0.428571428571429,1
"3660","CRABP2",7,11,18,0.611111111111111,0.388888888888889,1
"3661","CRACD",72,126,198,0.636363636363636,0.363636363636364,0.63
"3662","CRACDL",31,48,79,0.607594936708861,0.392405063291139,0.63
"3663","CRACR2A",17,31,48,0.645833333333333,0.354166666666667,0.37
"3664","CRACR2B",7,9,16,0.5625,0.4375,0.37
"3665","CRADD",8,20,28,0.714285714285714,0.285714285714286,1
"3666","CRAMP1",28,39,67,0.582089552238806,0.417910447761194,1
"3667","CRAT",25,40,65,0.615384615384615,0.384615384615385,1
"3668","CRB1",119,248,367,0.67574931880109,0.32425068119891,1
"3669","CRB2",37,65,102,0.637254901960784,0.362745098039216,1
"3670","CRB3",6,4,10,0.4,0.6,1
"3671","CRBN",14,19,33,0.575757575757576,0.424242424242424,1
"3672","CRCP",7,5,12,0.416666666666667,0.583333333333333,1
"3673","CRCT1",4,10,14,0.714285714285714,0.285714285714286,1
"3674","CREB1",7,12,19,0.631578947368421,0.368421052631579,1
"3675","CREB3",13,23,36,0.638888888888889,0.361111111111111,1
"3676","CREB3L1",13,27,40,0.675,0.325,1
"3677","CREB3L2",15,45,60,0.75,0.25,1
"3678","CREB3L3",24,53,77,0.688311688311688,0.311688311688312,1
"3679","CREB3L4",11,28,39,0.717948717948718,0.282051282051282,1
"3680","CREB5",28,44,72,0.611111111111111,0.388888888888889,1
"3681","CREBBP",138,222,360,0.616666666666667,0.383333333333333,1
"3682","CREBL2",4,3,7,0.428571428571429,0.571428571428571,1
"3683","CREBRF",22,35,57,0.614035087719298,0.385964912280702,1
"3684","CREBZF",10,15,25,0.6,0.4,1
"3685","CREG1",4,5,9,0.555555555555556,0.444444444444444,1
"3686","CREG2",5,13,18,0.722222222222222,0.277777777777778,1
"3687","CRELD1",10,18,28,0.642857142857143,0.357142857142857,1
"3688","CRELD2",11,9,20,0.45,0.55,1
"3689","CREM",8,14,22,0.636363636363636,0.363636363636364,1
"3690","CRH",0,9,9,1,0,1
"3691","CRHBP",16,25,41,0.609756097560976,0.390243902439024,1
"3692","CRHR1",12,20,32,0.625,0.375,1
"3693","CRHR2",22,26,48,0.541666666666667,0.458333333333333,1
"3694","CRIM1",39,69,108,0.638888888888889,0.361111111111111,1
"3695","CRIP1",2,5,7,0.714285714285714,0.285714285714286,1
"3696","CRIP2",2,7,9,0.777777777777778,0.222222222222222,1
"3697","CRIP3",3,20,23,0.869565217391304,0.130434782608696,1
"3698","CRIPT",3,6,9,0.666666666666667,0.333333333333333,1
"3699","CRISP1",24,39,63,0.619047619047619,0.380952380952381,1
"3700","CRISP2",25,36,61,0.590163934426229,0.409836065573771,1
"3701","CRISP3",23,42,65,0.646153846153846,0.353846153846154,1
"3702","CRISPLD1",31,57,88,0.647727272727273,0.352272727272727,1
"3703","CRISPLD2",15,31,46,0.673913043478261,0.326086956521739,1
"3704","CRK",5,9,14,0.642857142857143,0.357142857142857,1
"3705","CRKL",7,14,21,0.666666666666667,0.333333333333333,1
"3706","CRLF1",16,14,30,0.466666666666667,0.533333333333333,1
"3707","CRLF2",8,34,42,0.80952380952381,0.19047619047619,1
"3708","CRLF3",13,29,42,0.69047619047619,0.30952380952381,1
"3709","CRMP1",24,72,96,0.75,0.25,1
"3710","CRNKL1",47,52,99,0.525252525252525,0.474747474747475,1
"3711","CRNN",31,52,83,0.626506024096386,0.373493975903614,1
"3712","CROCC",45,79,124,0.637096774193548,0.362903225806452,1
"3713","CROCC2",1,6,7,0.857142857142857,0.142857142857143,1
"3714","CROT",30,61,91,0.67032967032967,0.32967032967033,1
"3715","CRP",16,32,48,0.666666666666667,0.333333333333333,1
"3716","CRPPA",10,30,40,0.75,0.25,1
"3717","CRTAC1",34,35,69,0.507246376811594,0.492753623188406,1
"3718","CRTAM",22,27,49,0.551020408163265,0.448979591836735,1
"3719","CRTAP",6,12,18,0.666666666666667,0.333333333333333,1
"3720","CRTC1",25,44,69,0.63768115942029,0.36231884057971,1
"3721","CRTC2",21,41,62,0.661290322580645,0.338709677419355,1
"3722","CRTC3",11,34,45,0.755555555555556,0.244444444444444,1
"3723","CRX",29,43,72,0.597222222222222,0.402777777777778,1
"3724","CRY1",16,44,60,0.733333333333333,0.266666666666667,1
"3725","CRY2",18,29,47,0.617021276595745,0.382978723404255,1
"3726","CRYAA",1,1,2,0.5,0.5,1
"3727","CRYAB",5,5,10,0.5,0.5,1
"3728","CRYBA1",14,14,28,0.5,0.5,1
"3729","CRYBA2",8,9,17,0.529411764705882,0.470588235294118,1
"3730","CRYBA4",12,30,42,0.714285714285714,0.285714285714286,1
"3731","CRYBB1",21,35,56,0.625,0.375,1
"3732","CRYBB2",12,23,35,0.657142857142857,0.342857142857143,1
"3733","CRYBB3",5,14,19,0.736842105263158,0.263157894736842,1
"3734","CRYBG1",56,109,165,0.660606060606061,0.339393939393939,1
"3735","CRYBG2",44,61,105,0.580952380952381,0.419047619047619,1
"3736","CRYBG3",45,61,106,0.575471698113208,0.424528301886792,1
"3737","CRYGA",19,30,49,0.612244897959184,0.387755102040816,1
"3738","CRYGB",13,16,29,0.551724137931034,0.448275862068966,1
"3739","CRYGC",11,20,31,0.645161290322581,0.354838709677419,1
"3740","CRYGD",13,11,24,0.458333333333333,0.541666666666667,1
"3741","CRYGN",7,15,22,0.681818181818182,0.318181818181818,1
"3742","CRYGS",7,18,25,0.72,0.28,1
"3743","CRYL1",9,13,22,0.590909090909091,0.409090909090909,1
"3744","CRYM",10,23,33,0.696969696969697,0.303030303030303,1
"3745","CRYM-AS1",7,9,16,0.5625,0.4375,1
"3746","CRYZ",17,28,45,0.622222222222222,0.377777777777778,1
"3747","CRYZL1",10,18,28,0.642857142857143,0.357142857142857,1
"3748","CS",14,17,31,0.548387096774194,0.451612903225806,1
"3749","CSAD",17,30,47,0.638297872340426,0.361702127659574,1
"3750","CSAG1",8,9,17,0.529411764705882,0.470588235294118,1
"3751","CSAG2",1,7,8,0.875,0.125,1
"3752","CSAG3",10,17,27,0.62962962962963,0.37037037037037,1
"3753","CSDC2",3,4,7,0.571428571428571,0.428571428571429,1
"3754","CSDE1",37,58,95,0.610526315789474,0.389473684210526,1
"3755","CSE1L",24,48,72,0.666666666666667,0.333333333333333,1
"3756","CSF1",17,32,49,0.653061224489796,0.346938775510204,1
"3757","CSF1R",49,62,111,0.558558558558559,0.441441441441441,1
"3758","CSF2",2,7,9,0.777777777777778,0.222222222222222,1
"3759","CSF2RA",35,76,111,0.684684684684685,0.315315315315315,1
"3760","CSF2RB",59,78,137,0.569343065693431,0.430656934306569,1
"3761","CSF3",5,6,11,0.545454545454545,0.454545454545455,1
"3762","CSF3R",36,65,101,0.643564356435644,0.356435643564356,1
"3763","CSGALNACT1",29,36,65,0.553846153846154,0.446153846153846,1
"3764","CSGALNACT2",30,31,61,0.508196721311475,0.491803278688525,1
"3765","CSH1",10,12,22,0.545454545454545,0.454545454545455,1
"3766","CSH2",14,19,33,0.575757575757576,0.424242424242424,1
"3767","CSHL1",11,33,44,0.75,0.25,1
"3768","CSK",16,22,38,0.578947368421053,0.421052631578947,1
"3769","CSKMT",7,10,17,0.588235294117647,0.411764705882353,1
"3770","CSMD1",340,621,961,0.646201873048907,0.353798126951093,1
"3771","CSMD2",245,465,710,0.654929577464789,0.345070422535211,1
"3772","CSMD3",603,1034,1637,0.631643249847282,0.368356750152718,1
"3773","CSN1S1",10,19,29,0.655172413793103,0.344827586206897,1
"3774","CSN2",16,22,38,0.578947368421053,0.421052631578947,1
"3775","CSN3",10,30,40,0.75,0.25,1
"3776","CSNK1A1",10,19,29,0.655172413793103,0.344827586206897,1
"3777","CSNK1A1L",34,35,69,0.507246376811594,0.492753623188406,1
"3778","CSNK1D",11,29,40,0.725,0.275,1
"3779","CSNK1E",23,29,52,0.557692307692308,0.442307692307692,1
"3780","CSNK1G1",22,20,42,0.476190476190476,0.523809523809524,1
"3781","CSNK1G2",14,21,35,0.6,0.4,1
"3782","CSNK1G3",29,26,55,0.472727272727273,0.527272727272727,1
"3783","CSNK2A1",21,38,59,0.644067796610169,0.355932203389831,1
"3784","CSNK2A2",13,20,33,0.606060606060606,0.393939393939394,1
"3785","CSNK2B",0,2,2,1,0,1
"3786","CSPG4",73,95,168,0.56547619047619,0.43452380952381,1
"3787","CSPG5",25,20,45,0.444444444444444,0.555555555555556,1
"3788","CSPP1",47,93,140,0.664285714285714,0.335714285714286,1
"3789","CSRNP1",15,27,42,0.642857142857143,0.357142857142857,1
"3790","CSRNP2",15,22,37,0.594594594594595,0.405405405405405,1
"3791","CSRNP3",44,55,99,0.555555555555556,0.444444444444444,1
"3792","CSRP1",5,10,15,0.666666666666667,0.333333333333333,1
"3793","CSRP2",10,4,14,0.285714285714286,0.714285714285714,1
"3794","CSRP3",5,17,22,0.772727272727273,0.227272727272727,1
"3795","CST1",19,19,38,0.5,0.5,1
"3796","CST11",13,19,32,0.59375,0.40625,1
"3797","CST2",2,11,13,0.846153846153846,0.153846153846154,1
"3798","CST3",5,5,10,0.5,0.5,1
"3799","CST4",19,15,34,0.441176470588235,0.558823529411765,1
"3800","CST5",8,17,25,0.68,0.32,1
"3801","CST6",5,12,17,0.705882352941177,0.294117647058824,1
"3802","CST7",5,6,11,0.545454545454545,0.454545454545455,1
"3803","CST8",12,16,28,0.571428571428571,0.428571428571429,1
"3804","CST9",12,12,24,0.5,0.5,1
"3805","CST9L",5,21,26,0.807692307692308,0.192307692307692,1
"3806","CSTA",4,8,12,0.666666666666667,0.333333333333333,1
"3807","CSTB",1,6,7,0.857142857142857,0.142857142857143,1
"3808","CSTF1",16,28,44,0.636363636363636,0.363636363636364,1
"3809","CSTF2",29,20,49,0.408163265306122,0.591836734693878,1
"3810","CSTF2T",21,37,58,0.637931034482759,0.362068965517241,1
"3811","CSTF3",32,28,60,0.466666666666667,0.533333333333333,1
"3812","CSTL1",11,22,33,0.666666666666667,0.333333333333333,1
"3813","CT45A1",4,11,15,0.733333333333333,0.266666666666667,1
"3814","CT45A10",5,11,16,0.6875,0.3125,1
"3815","CT45A3",2,2,4,0.5,0.5,1
"3816","CT45A9",1,1,2,0.5,0.5,1
"3817","CT47A6",2,2,4,0.5,0.5,1
"3818","CT55",14,15,29,0.517241379310345,0.482758620689655,1
"3819","CT83",7,16,23,0.695652173913043,0.304347826086957,1
"3820","CTAG2",17,11,28,0.392857142857143,0.607142857142857,1
"3821","CTAGE1",53,79,132,0.598484848484849,0.401515151515151,1
"3822","CTAGE15",7,18,25,0.72,0.28,1
"3823","CTAGE4",0,3,3,1,0,1
"3824","CTAGE6",18,39,57,0.684210526315789,0.315789473684211,1
"3825","CTAGE9",1,2,3,0.666666666666667,0.333333333333333,1
"3826","CTBP1",14,20,34,0.588235294117647,0.411764705882353,1
"3827","CTBP2",12,17,29,0.586206896551724,0.413793103448276,1
"3828","CTBS",14,12,26,0.461538461538462,0.538461538461538,1
"3829","CTC1",42,51,93,0.548387096774194,0.451612903225806,1
"3830","CTCF",59,62,121,0.512396694214876,0.487603305785124,1
"3831","CTCFL",43,71,114,0.62280701754386,0.37719298245614,1
"3832","CTDNEP1",8,9,17,0.529411764705882,0.470588235294118,1
"3833","CTDP1",33,54,87,0.620689655172414,0.379310344827586,1
"3834","CTDSP1",14,16,30,0.533333333333333,0.466666666666667,1
"3835","CTDSP2",14,16,30,0.533333333333333,0.466666666666667,1
"3836","CTDSPL",8,12,20,0.6,0.4,1
"3837","CTDSPL2",13,23,36,0.638888888888889,0.361111111111111,1
"3838","CTF1",2,2,4,0.5,0.5,1
"3839","CTH",11,19,30,0.633333333333333,0.366666666666667,1
"3840","CTHRC1",6,19,25,0.76,0.24,1
"3841","CTIF",27,44,71,0.619718309859155,0.380281690140845,1
"3842","CTLA4",5,25,30,0.833333333333333,0.166666666666667,1
"3843","CTNNA1",51,67,118,0.567796610169492,0.432203389830508,1
"3844","CTNNA2",134,229,363,0.630853994490358,0.369146005509642,1
"3845","CTNNA3",86,142,228,0.62280701754386,0.37719298245614,1
"3846","CTNNAL1",19,26,45,0.577777777777778,0.422222222222222,1
"3847","CTNNB1",89,197,286,0.688811188811189,0.311188811188811,1
"3848","CTNNBIP1",0,2,2,1,0,1
"3849","CTNNBL1",23,34,57,0.596491228070175,0.403508771929825,1
"3850","CTNND1",45,73,118,0.61864406779661,0.38135593220339,1
"3851","CTNND2",123,232,355,0.653521126760563,0.346478873239437,1
"3852","CTNS",5,16,21,0.761904761904762,0.238095238095238,1
"3853","CTPS1",21,28,49,0.571428571428571,0.428571428571429,1
"3854","CTPS2",27,10,37,0.27027027027027,0.72972972972973,1
"3855","CTR9",47,74,121,0.611570247933884,0.388429752066116,1
"3856","CTRB1",2,5,7,0.714285714285714,0.285714285714286,1
"3857","CTRB2",2,10,12,0.833333333333333,0.166666666666667,1
"3858","CTRC",12,13,25,0.52,0.48,1
"3859","CTRL",9,11,20,0.55,0.45,1
"3860","CTSA",15,20,35,0.571428571428571,0.428571428571429,1
"3861","CTSB",12,22,34,0.647058823529412,0.352941176470588,1
"3862","CTSC",29,33,62,0.532258064516129,0.467741935483871,1
"3863","CTSD",2,7,9,0.777777777777778,0.222222222222222,1
"3864","CTSE",17,34,51,0.666666666666667,0.333333333333333,1
"3865","CTSF",14,40,54,0.740740740740741,0.259259259259259,1
"3866","CTSG",28,29,57,0.508771929824561,0.491228070175439,1
"3867","CTSH",14,15,29,0.517241379310345,0.482758620689655,1
"3868","CTSK",9,11,20,0.55,0.45,1
"3869","CTSL",12,12,24,0.5,0.5,1
"3870","CTSL3P",22,17,39,0.435897435897436,0.564102564102564,1
"3871","CTSO",10,21,31,0.67741935483871,0.32258064516129,1
"3872","CTSS",10,22,32,0.6875,0.3125,1
"3873","CTSV",13,33,46,0.717391304347826,0.282608695652174,1
"3874","CTSW",21,25,46,0.543478260869565,0.456521739130435,1
"3875","CTSZ",3,14,17,0.823529411764706,0.176470588235294,1
"3876","CTTN",23,35,58,0.603448275862069,0.396551724137931,1
"3877","CTTNBP2",95,104,199,0.522613065326633,0.477386934673367,1
"3878","CTTNBP2NL",15,42,57,0.736842105263158,0.263157894736842,1
"3879","CTU1",2,0,2,0,1,1
"3880","CTU2",15,15,30,0.5,0.5,1
"3881","CTXN1",0,1,1,1,0,1
"3882","CTXN3",11,4,15,0.266666666666667,0.733333333333333,1
"3883","CUBN",178,405,583,0.694682675814751,0.305317324185249,1
"3884","CUEDC1",19,27,46,0.58695652173913,0.41304347826087,1
"3885","CUEDC2",4,17,21,0.80952380952381,0.19047619047619,1
"3886","CUL1",65,60,125,0.48,0.52,1
"3887","CUL2",34,30,64,0.46875,0.53125,1
"3888","CUL3",40,75,115,0.652173913043478,0.347826086956522,1
"3889","CUL4A",18,22,40,0.55,0.45,1
"3890","CUL4B",61,27,88,0.306818181818182,0.693181818181818,1
"3891","CUL5",38,51,89,0.573033707865168,0.426966292134831,1
"3892","CUL7",49,53,102,0.519607843137255,0.480392156862745,1
"3893","CUL9",98,119,217,0.548387096774194,0.451612903225806,1
"3894","CUTA",3,10,13,0.769230769230769,0.230769230769231,1
"3895","CUTC",13,19,32,0.59375,0.40625,1
"3896","CUX1",90,112,202,0.554455445544555,0.445544554455446,1
"3897","CUX2",89,139,228,0.609649122807018,0.390350877192982,1
"3898","CUZD1",23,43,66,0.651515151515151,0.348484848484849,1
"3899","CWC15",7,8,15,0.533333333333333,0.466666666666667,1
"3900","CWC22",19,42,61,0.688524590163934,0.311475409836066,1
"3901","CWC25",15,15,30,0.5,0.5,1
"3902","CWC27",27,31,58,0.53448275862069,0.46551724137931,1
"3903","CWF19L1",16,21,37,0.567567567567568,0.432432432432432,1
"3904","CWF19L2",44,66,110,0.6,0.4,1
"3905","CWH43",52,101,153,0.660130718954248,0.339869281045752,1
"3906","CX3CL1",15,32,47,0.680851063829787,0.319148936170213,1
"3907","CX3CR1",25,38,63,0.603174603174603,0.396825396825397,1
"3908","CXADR",16,26,42,0.619047619047619,0.380952380952381,1
"3909","CXCL1",2,7,9,0.777777777777778,0.222222222222222,1
"3910","CXCL10",3,10,13,0.769230769230769,0.230769230769231,1
"3911","CXCL11",3,6,9,0.666666666666667,0.333333333333333,1
"3912","CXCL12",1,11,12,0.916666666666667,0.0833333333333333,1
"3913","CXCL13",6,5,11,0.454545454545455,0.545454545454545,1
"3914","CXCL14",3,12,15,0.8,0.2,1
"3915","CXCL16",9,10,19,0.526315789473684,0.473684210526316,1
"3916","CXCL17",1,6,7,0.857142857142857,0.142857142857143,1
"3917","CXCL2",5,3,8,0.375,0.625,1
"3918","CXCL3",1,1,2,0.5,0.5,1
"3919","CXCL5",10,11,21,0.523809523809524,0.476190476190476,1
"3920","CXCL6",7,7,14,0.5,0.5,1
"3921","CXCL8",3,10,13,0.769230769230769,0.230769230769231,1
"3922","CXCL9",8,22,30,0.733333333333333,0.266666666666667,1
"3923","CXCR1",17,31,48,0.645833333333333,0.354166666666667,1
"3924","CXCR2",34,34,68,0.5,0.5,1
"3925","CXCR3",19,10,29,0.344827586206897,0.655172413793103,1
"3926","CXCR4",17,30,47,0.638297872340426,0.361702127659574,1
"3927","CXCR5",13,18,31,0.580645161290323,0.419354838709677,1
"3928","CXCR6",5,19,24,0.791666666666667,0.208333333333333,1
"3929","CXorf21",22,28,50,0.56,0.44,1
"3930","CXorf38",13,12,25,0.48,0.52,1
"3931","CXorf56",21,7,28,0.25,0.75,1
"3932","CXorf58",27,20,47,0.425531914893617,0.574468085106383,1
"3933","CXorf65",16,3,19,0.157894736842105,0.842105263157895,1
"3934","CXorf66",33,37,70,0.528571428571429,0.471428571428571,1
"3935","CXXC1",32,44,76,0.578947368421053,0.421052631578947,1
"3936","CXXC4",7,13,20,0.65,0.35,1
"3937","CXXC5",8,20,28,0.714285714285714,0.285714285714286,1
"3938","CYB561",11,9,20,0.45,0.55,1
"3939","CYB561A3",4,10,14,0.714285714285714,0.285714285714286,1
"3940","CYB561D1",3,6,9,0.666666666666667,0.333333333333333,1
"3941","CYB561D2",2,4,6,0.666666666666667,0.333333333333333,1
"3942","CYB5A",5,5,10,0.5,0.5,1
"3943","CYB5B",5,6,11,0.545454545454545,0.454545454545455,1
"3944","CYB5D1",3,8,11,0.727272727272727,0.272727272727273,1
"3945","CYB5D2",7,10,17,0.588235294117647,0.411764705882353,1
"3946","CYB5R1",6,13,19,0.684210526315789,0.315789473684211,1
"3947","CYB5R2",12,13,25,0.52,0.48,1
"3948","CYB5R3",10,14,24,0.583333333333333,0.416666666666667,1
"3949","CYB5R4",25,38,63,0.603174603174603,0.396825396825397,1
"3950","CYB5RL",7,12,19,0.631578947368421,0.368421052631579,1
"3951","CYBA",3,7,10,0.7,0.3,1
"3952","CYBB",50,37,87,0.425287356321839,0.574712643678161,1
"3953","CYBC1",6,7,13,0.538461538461538,0.461538461538462,1
"3954","CYBRD1",11,15,26,0.576923076923077,0.423076923076923,1
"3955","CYC1",29,34,63,0.53968253968254,0.46031746031746,1
"3956","CYCS",5,4,9,0.444444444444444,0.555555555555556,1
"3957","CYFIP1",40,57,97,0.587628865979381,0.412371134020619,1
"3958","CYFIP2",57,96,153,0.627450980392157,0.372549019607843,1
"3959","CYGB",7,8,15,0.533333333333333,0.466666666666667,1
"3960","CYHR1",4,6,10,0.6,0.4,1
"3961","CYLC1",86,87,173,0.502890173410405,0.497109826589595,1
"3962","CYLC2",57,91,148,0.614864864864865,0.385135135135135,1
"3963","CYLD",37,71,108,0.657407407407407,0.342592592592593,1
"3964","CYP11A1",21,41,62,0.661290322580645,0.338709677419355,1
"3965","CYP11B1",55,73,128,0.5703125,0.4296875,1
"3966","CYP11B2",35,77,112,0.6875,0.3125,1
"3967","CYP17A1",26,23,49,0.469387755102041,0.530612244897959,1
"3968","CYP19A1",30,44,74,0.594594594594595,0.405405405405405,1
"3969","CYP1A1",22,40,62,0.645161290322581,0.354838709677419,1
"3970","CYP1A2",21,38,59,0.644067796610169,0.355932203389831,1
"3971","CYP1B1",26,24,50,0.48,0.52,1
"3972","CYP20A1",16,29,45,0.644444444444444,0.355555555555556,1
"3973","CYP21A2",13,27,40,0.675,0.325,1
"3974","CYP24A1",11,40,51,0.784313725490196,0.215686274509804,1
"3975","CYP26A1",23,33,56,0.589285714285714,0.410714285714286,1
"3976","CYP26B1",29,50,79,0.632911392405063,0.367088607594937,1
"3977","CYP26C1",7,17,24,0.708333333333333,0.291666666666667,1
"3978","CYP27A1",16,27,43,0.627906976744186,0.372093023255814,1
"3979","CYP27B1",20,27,47,0.574468085106383,0.425531914893617,1
"3980","CYP27C1",21,43,64,0.671875,0.328125,1
"3981","CYP2A13",36,51,87,0.586206896551724,0.413793103448276,1
"3982","CYP2A6",25,41,66,0.621212121212121,0.378787878787879,1
"3983","CYP2A7",19,43,62,0.693548387096774,0.306451612903226,1
"3984","CYP2B6",25,55,80,0.6875,0.3125,1
"3985","CYP2C18",26,66,92,0.717391304347826,0.282608695652174,1
"3986","CYP2C19",30,88,118,0.745762711864407,0.254237288135593,1
"3987","CYP2C8",20,70,90,0.777777777777778,0.222222222222222,1
"3988","CYP2C9",37,71,108,0.657407407407407,0.342592592592593,1
"3989","CYP2D6",12,30,42,0.714285714285714,0.285714285714286,1
"3990","CYP2E1",21,48,69,0.695652173913043,0.304347826086957,1
"3991","CYP2F1",22,40,62,0.645161290322581,0.354838709677419,1
"3992","CYP2J2",11,22,33,0.666666666666667,0.333333333333333,1
"3993","CYP2R1",20,29,49,0.591836734693878,0.408163265306122,1
"3994","CYP2S1",20,34,54,0.62962962962963,0.37037037037037,1
"3995","CYP2U1",19,11,30,0.366666666666667,0.633333333333333,1
"3996","CYP2W1",13,20,33,0.606060606060606,0.393939393939394,1
"3997","CYP39A1",12,31,43,0.720930232558139,0.27906976744186,1
"3998","CYP3A4",24,50,74,0.675675675675676,0.324324324324324,1
"3999","CYP3A43",14,53,67,0.791044776119403,0.208955223880597,1
"4000","CYP3A5",19,31,50,0.62,0.38,1
"4001","CYP3A7",37,47,84,0.55952380952381,0.44047619047619,1
"4002","CYP3A7-CYP3A51P",3,7,10,0.7,0.3,1
"4003","CYP46A1",23,42,65,0.646153846153846,0.353846153846154,1
"4004","CYP4A11",29,75,104,0.721153846153846,0.278846153846154,1
"4005","CYP4A22",27,56,83,0.674698795180723,0.325301204819277,1
"4006","CYP4B1",32,68,100,0.68,0.32,1
"4007","CYP4F11",33,56,89,0.629213483146067,0.370786516853933,1
"4008","CYP4F12",32,65,97,0.670103092783505,0.329896907216495,1
"4009","CYP4F2",42,71,113,0.628318584070796,0.371681415929204,1
"4010","CYP4F22",24,54,78,0.692307692307692,0.307692307692308,1
"4011","CYP4F3",36,69,105,0.657142857142857,0.342857142857143,1
"4012","CYP4F8",24,59,83,0.710843373493976,0.289156626506024,1
"4013","CYP4V2",20,29,49,0.591836734693878,0.408163265306122,1
"4014","CYP4X1",27,46,73,0.63013698630137,0.36986301369863,1
"4015","CYP4Z1",31,53,84,0.630952380952381,0.369047619047619,1
"4016","CYP51A1",15,27,42,0.642857142857143,0.357142857142857,1
"4017","CYP7A1",16,54,70,0.771428571428571,0.228571428571429,1
"4018","CYP7B1",30,75,105,0.714285714285714,0.285714285714286,1
"4019","CYP8B1",33,41,74,0.554054054054054,0.445945945945946,1
"4020","CYREN",8,10,18,0.555555555555556,0.444444444444444,1
"4021","CYRIA",17,46,63,0.73015873015873,0.26984126984127,1
"4022","CYRIB",15,18,33,0.545454545454545,0.454545454545455,1
"4023","CYS1",1,2,3,0.666666666666667,0.333333333333333,1
"4024","CYSLTR1",28,25,53,0.471698113207547,0.528301886792453,1
"4025","CYSLTR2",19,36,55,0.654545454545455,0.345454545454545,1
"4026","CYSRT1",0,1,1,1,0,1
"4027","CYSTM1",8,3,11,0.272727272727273,0.727272727272727,1
"4028","CYTH1",21,18,39,0.461538461538462,0.538461538461538,1
"4029","CYTH2",16,22,38,0.578947368421053,0.421052631578947,1
"4030","CYTH3",17,20,37,0.540540540540541,0.459459459459459,1
"4031","CYTH4",17,32,49,0.653061224489796,0.346938775510204,1
"4032","CYTIP",16,61,77,0.792207792207792,0.207792207792208,1
"4033","CYTL1",11,10,21,0.476190476190476,0.523809523809524,1
"4034","CYYR1",19,29,48,0.604166666666667,0.395833333333333,1
"4035","CZIB",3,11,14,0.785714285714286,0.214285714285714,1
"4036","D2HGDH",19,16,35,0.457142857142857,0.542857142857143,1
"4037","DAAM1",39,60,99,0.606060606060606,0.393939393939394,1
"4038","DAAM2",38,76,114,0.666666666666667,0.333333333333333,1
"4039","DAB1",66,111,177,0.627118644067797,0.372881355932203,1
"4040","DAB2",33,74,107,0.691588785046729,0.308411214953271,1
"4041","DAB2IP",37,61,98,0.622448979591837,0.377551020408163,1
"4042","DACH1",47,93,140,0.664285714285714,0.335714285714286,1
"4043","DACH2",74,70,144,0.486111111111111,0.513888888888889,1
"4044","DACT1",50,80,130,0.615384615384615,0.384615384615385,1
"4045","DACT2",1,1,2,0.5,0.5,1
"4046","DACT3",5,5,10,0.5,0.5,1
"4047","DAD1",3,1,4,0.25,0.75,1
"4048","DAG1",24,43,67,0.641791044776119,0.358208955223881,1
"4049","DAGLA",43,74,117,0.632478632478632,0.367521367521368,0.62
"4050","DAGLB",18,31,49,0.63265306122449,0.36734693877551,0.62
"4051","DALRD3",16,17,33,0.515151515151515,0.484848484848485,1
"4052","DAND5",8,16,24,0.666666666666667,0.333333333333333,1
"4053","DAO",28,47,75,0.626666666666667,0.373333333333333,1
"4054","DAOA",17,22,39,0.564102564102564,0.435897435897436,1
"4055","DAP",2,7,9,0.777777777777778,0.222222222222222,1
"4056","DAP3",13,19,32,0.59375,0.40625,1
"4057","DAPK1",73,95,168,0.56547619047619,0.43452380952381,1
"4058","DAPK2",12,21,33,0.636363636363636,0.363636363636364,1
"4059","DAPK3",20,19,39,0.487179487179487,0.512820512820513,1
"4060","DAPL1",3,12,15,0.8,0.2,1
"4061","DAPP1",13,18,31,0.580645161290323,0.419354838709677,1
"4062","DARS1",9,25,34,0.735294117647059,0.264705882352941,0.77
"4063","DARS2",20,27,47,0.574468085106383,0.425531914893617,0.77
"4064","DAW1",26,47,73,0.643835616438356,0.356164383561644,1
"4065","DAXX",40,50,90,0.555555555555556,0.444444444444444,1
"4066","DAZ2",0,2,2,1,0,1
"4067","DAZAP1",29,35,64,0.546875,0.453125,1
"4068","DAZAP2",5,9,14,0.642857142857143,0.357142857142857,1
"4069","DAZL",12,12,24,0.5,0.5,1
"4070","DBF4",36,35,71,0.492957746478873,0.507042253521127,1
"4071","DBF4B",21,39,60,0.65,0.35,1
"4072","DBH",32,47,79,0.594936708860759,0.40506329113924,1
"4073","DBI",3,14,17,0.823529411764706,0.176470588235294,1
"4074","DBN1",22,35,57,0.614035087719298,0.385964912280702,1
"4075","DBNDD1",9,10,19,0.526315789473684,0.473684210526316,1
"4076","DBNDD2",6,10,16,0.625,0.375,1
"4077","DBNL",13,16,29,0.551724137931034,0.448275862068966,1
"4078","DBP",11,10,21,0.476190476190476,0.523809523809524,1
"4079","DBR1",24,29,53,0.547169811320755,0.452830188679245,1
"4080","DBT",15,35,50,0.7,0.3,1
"4081","DBX1",15,21,36,0.583333333333333,0.416666666666667,1
"4082","DBX2",23,32,55,0.581818181818182,0.418181818181818,1
"4083","DCAF1",40,53,93,0.56989247311828,0.43010752688172,1
"4084","DCAF10",11,18,29,0.620689655172414,0.379310344827586,1
"4085","DCAF11",29,34,63,0.53968253968254,0.46031746031746,1
"4086","DCAF12",14,28,42,0.666666666666667,0.333333333333333,1
"4087","DCAF12L1",81,69,150,0.46,0.54,1
"4088","DCAF12L2",104,74,178,0.415730337078652,0.584269662921348,1
"4089","DCAF13",25,38,63,0.603174603174603,0.396825396825397,1
"4090","DCAF15",12,20,32,0.625,0.375,1
"4091","DCAF16",12,14,26,0.538461538461538,0.461538461538462,1
"4092","DCAF17",16,21,37,0.567567567567568,0.432432432432432,1
"4093","DCAF4",19,32,51,0.627450980392157,0.372549019607843,1
"4094","DCAF4L1",22,40,62,0.645161290322581,0.354838709677419,1
"4095","DCAF4L2",91,130,221,0.588235294117647,0.411764705882353,1
"4096","DCAF5",30,40,70,0.571428571428571,0.428571428571429,1
"4097","DCAF6",28,63,91,0.692307692307692,0.307692307692308,1
"4098","DCAF7",13,18,31,0.580645161290323,0.419354838709677,1
"4099","DCAF8",18,29,47,0.617021276595745,0.382978723404255,1
"4100","DCAF8L1",67,64,131,0.488549618320611,0.511450381679389,1
"4101","DCAF8L2",2,1,3,0.333333333333333,0.666666666666667,1
"4102","DCAKD",13,11,24,0.458333333333333,0.541666666666667,1
"4103","DCANP1",9,28,37,0.756756756756757,0.243243243243243,1
"4104","DCBLD1",12,32,44,0.727272727272727,0.272727272727273,1
"4105","DCBLD2",15,40,55,0.727272727272727,0.272727272727273,1
"4106","DCC",163,279,442,0.631221719457014,0.368778280542986,1
"4107","DCD",6,17,23,0.739130434782609,0.260869565217391,1
"4108","DCDC1",117,208,325,0.64,0.36,1
"4109","DCDC2",24,43,67,0.641791044776119,0.358208955223881,1
"4110","DCDC2B",8,13,21,0.619047619047619,0.380952380952381,1
"4111","DCDC2C",0,3,3,1,0,1
"4112","DCHS1",130,148,278,0.532374100719424,0.467625899280576,1
"4113","DCHS2",208,456,664,0.686746987951807,0.313253012048193,1
"4114","DCK",8,16,24,0.666666666666667,0.333333333333333,1
"4115","DCLK1",62,115,177,0.649717514124294,0.350282485875706,1
"4116","DCLK2",22,51,73,0.698630136986301,0.301369863013699,1
"4117","DCLK3",52,71,123,0.577235772357724,0.422764227642276,1
"4118","DCLRE1A",30,52,82,0.634146341463415,0.365853658536585,1
"4119","DCLRE1B",19,34,53,0.641509433962264,0.358490566037736,1
"4120","DCLRE1C",23,34,57,0.596491228070175,0.403508771929825,1
"4121","DCN",38,40,78,0.512820512820513,0.487179487179487,1
"4122","DCP1A",11,19,30,0.633333333333333,0.366666666666667,1
"4123","DCP1B",21,30,51,0.588235294117647,0.411764705882353,1
"4124","DCP2",16,26,42,0.619047619047619,0.380952380952381,1
"4125","DCPS",13,15,28,0.535714285714286,0.464285714285714,1
"4126","DCST1",32,45,77,0.584415584415584,0.415584415584416,1
"4127","DCST2",32,41,73,0.561643835616438,0.438356164383562,1
"4128","DCSTAMP",49,84,133,0.631578947368421,0.368421052631579,1
"4129","DCT",35,73,108,0.675925925925926,0.324074074074074,1
"4130","DCTD",6,10,16,0.625,0.375,1
"4131","DCTN1",39,74,113,0.654867256637168,0.345132743362832,1
"4132","DCTN2",11,26,37,0.702702702702703,0.297297297297297,1
"4133","DCTN3",3,9,12,0.75,0.25,1
"4134","DCTN4",14,19,33,0.575757575757576,0.424242424242424,1
"4135","DCTN5",13,8,21,0.380952380952381,0.619047619047619,1
"4136","DCTN6",3,5,8,0.625,0.375,1
"4137","DCTPP1",6,5,11,0.454545454545455,0.545454545454545,1
"4138","DCUN1D1",13,22,35,0.628571428571429,0.371428571428571,1
"4139","DCUN1D2",6,14,20,0.7,0.3,1
"4140","DCUN1D3",8,24,32,0.75,0.25,1
"4141","DCUN1D4",14,19,33,0.575757575757576,0.424242424242424,1
"4142","DCUN1D5",3,12,15,0.8,0.2,1
"4143","DCX",47,53,100,0.53,0.47,1
"4144","DCXR",2,6,8,0.75,0.25,1
"4145","DDA1",3,11,14,0.785714285714286,0.214285714285714,1
"4146","DDAH1",9,16,25,0.64,0.36,1
"4147","DDAH2",11,7,18,0.388888888888889,0.611111111111111,1
"4148","DDB1",40,57,97,0.587628865979381,0.412371134020619,1
"4149","DDB2",11,22,33,0.666666666666667,0.333333333333333,1
"4150","DDC",34,54,88,0.613636363636364,0.386363636363636,1
"4151","DDHD1",20,41,61,0.672131147540984,0.327868852459016,1
"4152","DDHD2",21,39,60,0.65,0.35,1
"4153","DDI1",50,82,132,0.621212121212121,0.378787878787879,1
"4154","DDI2",12,22,34,0.647058823529412,0.352941176470588,1
"4155","DDIAS",31,62,93,0.666666666666667,0.333333333333333,1
"4156","DDIT3",9,9,18,0.5,0.5,1
"4157","DDIT4",5,16,21,0.761904761904762,0.238095238095238,1
"4158","DDIT4L",18,21,39,0.538461538461538,0.461538461538462,1
"4159","DDN",21,23,44,0.522727272727273,0.477272727272727,1
"4160","DDO",14,21,35,0.6,0.4,1
"4161","DDOST",7,7,14,0.5,0.5,1
"4162","DDR1",39,49,88,0.556818181818182,0.443181818181818,1
"4163","DDR2",47,73,120,0.608333333333333,0.391666666666667,1
"4164","DDRGK1",7,12,19,0.631578947368421,0.368421052631579,1
"4165","DDTL",0,2,2,1,0,1
"4166","DDX1",20,39,59,0.661016949152542,0.338983050847458,1
"4167","DDX10",38,54,92,0.58695652173913,0.41304347826087,1
"4168","DDX11",39,44,83,0.530120481927711,0.469879518072289,1
"4169","DDX12P",0,2,2,1,0,1
"4170","DDX17",31,49,80,0.6125,0.3875,1
"4171","DDX18",26,49,75,0.653333333333333,0.346666666666667,1
"4172","DDX19A",15,16,31,0.516129032258065,0.483870967741935,1
"4173","DDX19B",16,13,29,0.448275862068966,0.551724137931034,1
"4174","DDX20",23,39,62,0.629032258064516,0.370967741935484,1
"4175","DDX21",16,30,46,0.652173913043478,0.347826086956522,1
"4176","DDX23",27,58,85,0.682352941176471,0.317647058823529,1
"4177","DDX24",27,40,67,0.597014925373134,0.402985074626866,1
"4178","DDX25",7,18,25,0.72,0.28,1
"4179","DDX27",50,66,116,0.568965517241379,0.431034482758621,1
"4180","DDX28",11,15,26,0.576923076923077,0.423076923076923,1
"4181","DDX31",35,28,63,0.444444444444444,0.555555555555556,1
"4182","DDX39A",15,10,25,0.4,0.6,1
"4183","DDX39B",26,34,60,0.566666666666667,0.433333333333333,1
"4184","DDX3X",36,72,108,0.666666666666667,0.333333333333333,1
"4185","DDX3Y",0,21,21,1,0,1
"4186","DDX4",47,64,111,0.576576576576577,0.423423423423423,1
"4187","DDX41",3,19,22,0.863636363636364,0.136363636363636,1
"4188","DDX42",44,53,97,0.54639175257732,0.45360824742268,1
"4189","DDX43",35,40,75,0.533333333333333,0.466666666666667,1
"4190","DDX46",34,51,85,0.6,0.4,1
"4191","DDX47",15,22,37,0.594594594594595,0.405405405405405,1
"4192","DDX49",13,20,33,0.606060606060606,0.393939393939394,1
"4193","DDX5",21,38,59,0.644067796610169,0.355932203389831,1
"4194","DDX50",34,44,78,0.564102564102564,0.435897435897436,1
"4195","DDX51",13,20,33,0.606060606060606,0.393939393939394,1
"4196","DDX52",20,23,43,0.534883720930233,0.465116279069767,1
"4197","DDX53",30,33,63,0.523809523809524,0.476190476190476,1
"4198","DDX54",36,41,77,0.532467532467532,0.467532467532468,1
"4199","DDX55",17,23,40,0.575,0.425,1
"4200","DDX56",13,23,36,0.638888888888889,0.361111111111111,1
"4201","DDX58",27,54,81,0.666666666666667,0.333333333333333,1
"4202","DDX59",23,39,62,0.629032258064516,0.370967741935484,1
"4203","DDX6",11,23,34,0.676470588235294,0.323529411764706,1
"4204","DDX60",59,111,170,0.652941176470588,0.347058823529412,1
"4205","DDX60L",60,115,175,0.657142857142857,0.342857142857143,1
"4206","DEAF1",22,35,57,0.614035087719298,0.385964912280702,1
"4207","DECR1",18,16,34,0.470588235294118,0.529411764705882,1
"4208","DECR2",17,13,30,0.433333333333333,0.566666666666667,1
"4209","DEDD",12,17,29,0.586206896551724,0.413793103448276,1
"4210","DEDD2",12,14,26,0.538461538461538,0.461538461538462,1
"4211","DEF6",14,29,43,0.674418604651163,0.325581395348837,1
"4212","DEF8",21,23,44,0.522727272727273,0.477272727272727,1
"4213","DEFA3",4,10,14,0.714285714285714,0.285714285714286,1
"4214","DEFA4",9,15,24,0.625,0.375,1
"4215","DEFA5",2,10,12,0.833333333333333,0.166666666666667,1
"4216","DEFA6",5,15,20,0.75,0.25,1
"4217","DEFB1",1,7,8,0.875,0.125,1
"4218","DEFB104A",0,5,5,1,0,1
"4219","DEFB105A",1,6,7,0.857142857142857,0.142857142857143,1
"4220","DEFB106A",0,1,1,1,0,1
"4221","DEFB106B",3,10,13,0.769230769230769,0.230769230769231,1
"4222","DEFB108B",1,3,4,0.75,0.25,1
"4223","DEFB110",8,26,34,0.764705882352941,0.235294117647059,1
"4224","DEFB112",7,20,27,0.740740740740741,0.259259259259259,1
"4225","DEFB113",9,14,23,0.608695652173913,0.391304347826087,1
"4226","DEFB114",7,16,23,0.695652173913043,0.304347826086957,1
"4227","DEFB115",3,25,28,0.892857142857143,0.107142857142857,1
"4228","DEFB116",11,26,37,0.702702702702703,0.297297297297297,1
"4229","DEFB118",13,32,45,0.711111111111111,0.288888888888889,1
"4230","DEFB119",7,13,20,0.65,0.35,1
"4231","DEFB121",7,9,16,0.5625,0.4375,1
"4232","DEFB123",4,7,11,0.636363636363636,0.363636363636364,1
"4233","DEFB124",4,5,9,0.555555555555556,0.444444444444444,1
"4234","DEFB125",9,17,26,0.653846153846154,0.346153846153846,1
"4235","DEFB126",6,10,16,0.625,0.375,1
"4236","DEFB127",4,8,12,0.666666666666667,0.333333333333333,1
"4237","DEFB128",4,4,8,0.5,0.5,1
"4238","DEFB129",5,17,22,0.772727272727273,0.227272727272727,1
"4239","DEFB131A",1,5,6,0.833333333333333,0.166666666666667,1
"4240","DEFB132",3,4,7,0.571428571428571,0.428571428571429,1
"4241","DEFB134",0,3,3,1,0,1
"4242","DEFB135",4,4,8,0.5,0.5,1
"4243","DEFB136",4,13,17,0.764705882352941,0.235294117647059,1
"4244","DEFB4A",0,1,1,1,0,1
"4245","DEGS1",15,13,28,0.464285714285714,0.535714285714286,1
"4246","DEGS2",11,12,23,0.521739130434783,0.478260869565217,1
"4247","DEK",13,24,37,0.648648648648649,0.351351351351351,1
"4248","DELE1",17,26,43,0.604651162790698,0.395348837209302,1
"4249","DELEC1",8,5,13,0.384615384615385,0.615384615384615,1
"4250","DENND10",5,12,17,0.705882352941177,0.294117647058824,1
"4251","DENND10P1",23,34,57,0.596491228070175,0.403508771929825,1
"4252","DENND11",7,21,28,0.75,0.25,1
"4253","DENND1A",28,53,81,0.654320987654321,0.345679012345679,1
"4254","DENND1B",22,43,65,0.661538461538462,0.338461538461538,1
"4255","DENND1C",31,61,92,0.66304347826087,0.33695652173913,1
"4256","DENND2A",41,84,125,0.672,0.328,1
"4257","DENND2B",33,59,92,0.641304347826087,0.358695652173913,1
"4258","DENND2C",41,91,132,0.689393939393939,0.310606060606061,1
"4259","DENND2D",13,28,41,0.682926829268293,0.317073170731707,1
"4260","DENND3",58,78,136,0.573529411764706,0.426470588235294,1
"4261","DENND4A",53,88,141,0.624113475177305,0.375886524822695,1
"4262","DENND4B",55,86,141,0.609929078014184,0.390070921985816,1
"4263","DENND4C",36,84,120,0.7,0.3,1
"4264","DENND5A",55,58,113,0.513274336283186,0.486725663716814,1
"4265","DENND5B",43,65,108,0.601851851851852,0.398148148148148,1
"4266","DENND6A",23,41,64,0.640625,0.359375,1
"4267","DENND6B",9,14,23,0.608695652173913,0.391304347826087,1
"4268","DENR",3,12,15,0.8,0.2,1
"4269","DEPDC1",22,52,74,0.702702702702703,0.297297297297297,1
"4270","DEPDC1B",19,33,52,0.634615384615385,0.365384615384615,1
"4271","DEPDC4",15,22,37,0.594594594594595,0.405405405405405,1
"4272","DEPDC5",41,85,126,0.674603174603175,0.325396825396825,1
"4273","DEPDC7",13,34,47,0.723404255319149,0.276595744680851,1
"4274","DEPP1",8,14,22,0.636363636363636,0.363636363636364,1
"4275","DEPTOR",13,32,45,0.711111111111111,0.288888888888889,1
"4276","DERA",8,16,24,0.666666666666667,0.333333333333333,1
"4277","DERL1",5,19,24,0.791666666666667,0.208333333333333,1
"4278","DERL2",7,11,18,0.611111111111111,0.388888888888889,1
"4279","DERL3",2,4,6,0.666666666666667,0.333333333333333,1
"4280","DES",23,30,53,0.566037735849057,0.433962264150943,1
"4281","DESI1",5,11,16,0.6875,0.3125,1
"4282","DESI2",2,13,15,0.866666666666667,0.133333333333333,1
"4283","DET1",0,1,1,1,0,1
"4284","DEUP1",36,48,84,0.571428571428571,0.428571428571429,1
"4285","DEXI",0,2,2,1,0,1
"4286","DFFA",6,17,23,0.739130434782609,0.260869565217391,1
"4287","DFFB",10,16,26,0.615384615384615,0.384615384615385,1
"4288","DGAT1",16,17,33,0.515151515151515,0.484848484848485,1
"4289","DGAT2",11,23,34,0.676470588235294,0.323529411764706,1
"4290","DGAT2L6",28,29,57,0.508771929824561,0.491228070175439,1
"4291","DGCR2",25,38,63,0.603174603174603,0.396825396825397,1
"4292","DGCR6L",5,5,10,0.5,0.5,1
"4293","DGCR8",31,51,82,0.621951219512195,0.378048780487805,1
"4294","DGKA",33,39,72,0.541666666666667,0.458333333333333,1
"4295","DGKB",68,120,188,0.638297872340426,0.361702127659574,1
"4296","DGKD",54,60,114,0.526315789473684,0.473684210526316,1
"4297","DGKE",18,51,69,0.739130434782609,0.260869565217391,1
"4298","DGKG",37,86,123,0.699186991869919,0.300813008130081,1
"4299","DGKH",35,73,108,0.675925925925926,0.324074074074074,1
"4300","DGKI",76,137,213,0.643192488262911,0.356807511737089,1
"4301","DGKK",96,82,178,0.460674157303371,0.539325842696629,1
"4302","DGKQ",16,26,42,0.619047619047619,0.380952380952381,1
"4303","DGKZ",36,42,78,0.538461538461538,0.461538461538462,1
"4304","DGLUCY",16,26,42,0.619047619047619,0.380952380952381,1
"4305","DGUOK",2,14,16,0.875,0.125,1
"4306","DHCR24",12,18,30,0.6,0.4,1
"4307","DHCR7",18,35,53,0.660377358490566,0.339622641509434,1
"4308","DHDDS",12,18,30,0.6,0.4,1
"4309","DHDH",5,20,25,0.8,0.2,1
"4310","DHFR",7,8,15,0.533333333333333,0.466666666666667,1
"4311","DHFR2",10,11,21,0.523809523809524,0.476190476190476,1
"4312","DHH",9,16,25,0.64,0.36,1
"4313","DHODH",17,17,34,0.5,0.5,1
"4314","DHPS",7,8,15,0.533333333333333,0.466666666666667,1
"4315","DHRS1",10,11,21,0.523809523809524,0.476190476190476,1
"4316","DHRS11",6,5,11,0.454545454545455,0.545454545454545,1
"4317","DHRS12",6,9,15,0.6,0.4,1
"4318","DHRS13",9,7,16,0.4375,0.5625,1
"4319","DHRS2",19,23,42,0.547619047619048,0.452380952380952,1
"4320","DHRS3",13,11,24,0.458333333333333,0.541666666666667,1
"4321","DHRS4",11,7,18,0.388888888888889,0.611111111111111,1
"4322","DHRS4L1",0,6,6,1,0,1
"4323","DHRS4L2",5,10,15,0.666666666666667,0.333333333333333,1
"4324","DHRS7",8,15,23,0.652173913043478,0.347826086956522,1
"4325","DHRS7B",7,8,15,0.533333333333333,0.466666666666667,1
"4326","DHRS7C",20,34,54,0.62962962962963,0.37037037037037,1
"4327","DHRS9",21,41,62,0.661290322580645,0.338709677419355,1
"4328","DHRSX",10,27,37,0.72972972972973,0.27027027027027,1
"4329","DHTKD1",27,53,80,0.6625,0.3375,1
"4330","DHX15",28,63,91,0.692307692307692,0.307692307692308,1
"4331","DHX16",52,54,106,0.509433962264151,0.490566037735849,1
"4332","DHX29",39,59,98,0.602040816326531,0.397959183673469,1
"4333","DHX30",55,65,120,0.541666666666667,0.458333333333333,1
"4334","DHX32",23,45,68,0.661764705882353,0.338235294117647,1
"4335","DHX33",13,27,40,0.675,0.325,1
"4336","DHX34",38,58,96,0.604166666666667,0.395833333333333,1
"4337","DHX35",29,43,72,0.597222222222222,0.402777777777778,1
"4338","DHX36",44,85,129,0.65891472868217,0.341085271317829,1
"4339","DHX37",43,62,105,0.59047619047619,0.40952380952381,1
"4340","DHX38",46,50,96,0.520833333333333,0.479166666666667,1
"4341","DHX40",26,33,59,0.559322033898305,0.440677966101695,1
"4342","DHX57",42,69,111,0.621621621621622,0.378378378378378,1
"4343","DHX58",18,24,42,0.571428571428571,0.428571428571429,1
"4344","DHX8",42,71,113,0.628318584070796,0.371681415929204,1
"4345","DHX9",48,90,138,0.652173913043478,0.347826086956522,1
"4346","DIABLO",4,9,13,0.692307692307692,0.307692307692308,1
"4347","DIAPH1",44,51,95,0.536842105263158,0.463157894736842,1
"4348","DIAPH2",68,66,134,0.492537313432836,0.507462686567164,1
"4349","DIAPH3",50,88,138,0.63768115942029,0.36231884057971,1
"4350","DICER1",80,116,196,0.591836734693878,0.408163265306122,1
"4351","DIDO1",122,194,316,0.613924050632911,0.386075949367089,1
"4352","DIMT1",7,10,17,0.588235294117647,0.411764705882353,1
"4353","DIO1",3,17,20,0.85,0.15,1
"4354","DIO2",24,42,66,0.636363636363636,0.363636363636364,1
"4355","DIO3",20,34,54,0.62962962962963,0.37037037037037,1
"4356","DIP2A",40,79,119,0.663865546218487,0.336134453781513,1
"4357","DIP2B",67,77,144,0.534722222222222,0.465277777777778,1
"4358","DIP2C",72,119,191,0.62303664921466,0.37696335078534,1
"4359","DIPK1A",4,2,6,0.333333333333333,0.666666666666667,1
"4360","DIPK1B",9,15,24,0.625,0.375,1
"4361","DIPK1C",7,10,17,0.588235294117647,0.411764705882353,1
"4362","DIPK2A",19,30,49,0.612244897959184,0.387755102040816,1
"4363","DIPK2B",21,22,43,0.511627906976744,0.488372093023256,1
"4364","DIRAS1",4,20,24,0.833333333333333,0.166666666666667,1
"4365","DIRAS2",9,26,35,0.742857142857143,0.257142857142857,1
"4366","DIRAS3",4,19,23,0.826086956521739,0.173913043478261,1
"4367","DIRC1",9,12,21,0.571428571428571,0.428571428571429,1
"4368","DIS3",29,53,82,0.646341463414634,0.353658536585366,1
"4369","DIS3L",29,39,68,0.573529411764706,0.426470588235294,1
"4370","DIS3L2",35,56,91,0.615384615384615,0.384615384615385,1
"4371","DISC1",39,60,99,0.606060606060606,0.393939393939394,1
"4372","DISP1",76,75,151,0.496688741721854,0.503311258278146,1
"4373","DISP2",49,57,106,0.537735849056604,0.462264150943396,1
"4374","DISP3",96,153,249,0.614457831325301,0.385542168674699,1
"4375","DIXDC1",16,29,45,0.644444444444444,0.355555555555556,1
"4376","DKC1",31,13,44,0.295454545454545,0.704545454545455,1
"4377","DKK1",21,29,50,0.58,0.42,1
"4378","DKK2",20,70,90,0.777777777777778,0.222222222222222,1
"4379","DKK3",9,18,27,0.666666666666667,0.333333333333333,1
"4380","DKK4",11,19,30,0.633333333333333,0.366666666666667,1
"4381","DKKL1",8,22,30,0.733333333333333,0.266666666666667,1
"4382","DLAT",29,34,63,0.53968253968254,0.46031746031746,1
"4383","DLC1",95,173,268,0.645522388059702,0.354477611940299,1
"4384","DLD",27,32,59,0.542372881355932,0.457627118644068,1
"4385","DLEC1",63,102,165,0.618181818181818,0.381818181818182,1
"4386","DLEU7",0,4,4,1,0,1
"4387","DLG1",26,66,92,0.717391304347826,0.282608695652174,1
"4388","DLG2",73,125,198,0.631313131313131,0.368686868686869,1
"4389","DLG3",42,19,61,0.311475409836066,0.688524590163934,1
"4390","DLG4",24,37,61,0.60655737704918,0.39344262295082,1
"4391","DLG5",65,91,156,0.583333333333333,0.416666666666667,1
"4392","DLGAP1",53,84,137,0.613138686131387,0.386861313868613,1
"4393","DLGAP2",78,120,198,0.606060606060606,0.393939393939394,1
"4394","DLGAP3",62,100,162,0.617283950617284,0.382716049382716,1
"4395","DLGAP4",37,83,120,0.691666666666667,0.308333333333333,1
"4396","DLGAP5",21,38,59,0.644067796610169,0.355932203389831,1
"4397","DLK1",25,39,64,0.609375,0.390625,1
"4398","DLK2",13,21,34,0.617647058823529,0.382352941176471,1
"4399","DLL1",37,44,81,0.54320987654321,0.45679012345679,1
"4400","DLL3",16,35,51,0.686274509803922,0.313725490196078,1
"4401","DLL4",17,35,52,0.673076923076923,0.326923076923077,1
"4402","DLST",12,23,35,0.657142857142857,0.342857142857143,1
"4403","DLX1",3,10,13,0.769230769230769,0.230769230769231,1
"4404","DLX2",15,11,26,0.423076923076923,0.576923076923077,1
"4405","DLX3",11,21,32,0.65625,0.34375,1
"4406","DLX4",12,10,22,0.454545454545455,0.545454545454545,1
"4407","DLX5",32,33,65,0.507692307692308,0.492307692307692,1
"4408","DLX6",7,15,22,0.681818181818182,0.318181818181818,1
"4409","DMAC1",6,4,10,0.4,0.6,1
"4410","DMAC2",3,15,18,0.833333333333333,0.166666666666667,1
"4411","DMAC2L",6,9,15,0.6,0.4,1
"4412","DMAP1",9,22,31,0.709677419354839,0.290322580645161,1
"4413","DMBT1",111,237,348,0.681034482758621,0.318965517241379,1
"4414","DMBX1",26,48,74,0.648648648648649,0.351351351351351,1
"4415","DMC1",20,17,37,0.459459459459459,0.540540540540541,1
"4416","DMD",339,267,606,0.440594059405941,0.559405940594059,1
"4417","DMGDH",25,81,106,0.764150943396226,0.235849056603774,1
"4418","DMKN",26,50,76,0.657894736842105,0.342105263157895,1
"4419","DMP1",28,49,77,0.636363636363636,0.363636363636364,1
"4420","DMPK",23,18,41,0.439024390243902,0.560975609756098,1
"4421","DMRT1",17,27,44,0.613636363636364,0.386363636363636,1
"4422","DMRT2",15,19,34,0.558823529411765,0.441176470588235,1
"4423","DMRT3",26,39,65,0.6,0.4,1
"4424","DMRTA1",14,20,34,0.588235294117647,0.411764705882353,1
"4425","DMRTA2",9,7,16,0.4375,0.5625,1
"4426","DMRTB1",22,34,56,0.607142857142857,0.392857142857143,1
"4427","DMRTC1",2,2,4,0.5,0.5,1
"4428","DMRTC2",14,22,36,0.611111111111111,0.388888888888889,1
"4429","DMTF1",22,41,63,0.650793650793651,0.349206349206349,1
"4430","DMTN",23,29,52,0.557692307692308,0.442307692307692,1
"4431","DMWD",32,27,59,0.457627118644068,0.542372881355932,1
"4432","DMXL1",98,161,259,0.621621621621622,0.378378378378378,1
"4433","DMXL2",107,187,294,0.636054421768708,0.363945578231293,1
"4434","DNA2",50,46,96,0.479166666666667,0.520833333333333,1
"4435","DNAAF1",20,58,78,0.743589743589744,0.256410256410256,1
"4436","DNAAF2",14,36,50,0.72,0.28,1
"4437","DNAAF3",26,30,56,0.535714285714286,0.464285714285714,1
"4438","DNAAF4",21,28,49,0.571428571428571,0.428571428571429,1
"4439","DNAAF5",18,38,56,0.678571428571429,0.321428571428571,1
"4440","DNAAF6",10,10,20,0.5,0.5,1
"4441","DNAH1",127,190,317,0.599369085173502,0.400630914826498,1
"4442","DNAH10",209,357,566,0.630742049469965,0.369257950530035,1
"4443","DNAH11",256,436,692,0.630057803468208,0.369942196531792,1
"4444","DNAH12",28,63,91,0.692307692307692,0.307692307692308,1
"4445","DNAH14",9,33,42,0.785714285714286,0.214285714285714,1
"4446","DNAH17",155,300,455,0.659340659340659,0.340659340659341,1
"4447","DNAH2",193,288,481,0.598752598752599,0.401247401247401,1
"4448","DNAH3",220,413,633,0.652448657187994,0.347551342812006,1
"4449","DNAH5",419,889,1308,0.679663608562691,0.320336391437309,1
"4450","DNAH6",28,75,103,0.728155339805825,0.271844660194175,1
"4451","DNAH7",269,529,798,0.662907268170426,0.337092731829574,1
"4452","DNAH8",286,531,817,0.649938800489596,0.350061199510404,1
"4453","DNAH9",301,498,799,0.623279098873592,0.376720901126408,1
"4454","DNAI1",25,53,78,0.67948717948718,0.320512820512821,1
"4455","DNAI2",37,60,97,0.618556701030928,0.381443298969072,1
"4456","DNAI3",44,54,98,0.551020408163265,0.448979591836735,1
"4457","DNAI4",45,71,116,0.612068965517241,0.387931034482759,1
"4458","DNAJA1",14,17,31,0.548387096774194,0.451612903225806,1
"4459","DNAJA2",12,22,34,0.647058823529412,0.352941176470588,1
"4460","DNAJA3",15,18,33,0.545454545454545,0.454545454545455,1
"4461","DNAJA4",8,21,29,0.724137931034483,0.275862068965517,1
"4462","DNAJB1",5,20,25,0.8,0.2,1
"4463","DNAJB11",11,24,35,0.685714285714286,0.314285714285714,1
"4464","DNAJB12",8,12,20,0.6,0.4,1
"4465","DNAJB13",11,33,44,0.75,0.25,1
"4466","DNAJB14",7,16,23,0.695652173913043,0.304347826086957,1
"4467","DNAJB2",17,20,37,0.540540540540541,0.459459459459459,1
"4468","DNAJB4",7,28,35,0.8,0.2,1
"4469","DNAJB5",15,17,32,0.53125,0.46875,1
"4470","DNAJB6",8,24,32,0.75,0.25,1
"4471","DNAJB7",20,20,40,0.5,0.5,1
"4472","DNAJB8",20,33,53,0.622641509433962,0.377358490566038,1
"4473","DNAJB9",9,18,27,0.666666666666667,0.333333333333333,1
"4474","DNAJC1",20,39,59,0.661016949152542,0.338983050847458,1
"4475","DNAJC10",41,53,94,0.563829787234043,0.436170212765957,1
"4476","DNAJC11",21,29,50,0.58,0.42,1
"4477","DNAJC12",7,15,22,0.681818181818182,0.318181818181818,1
"4478","DNAJC13",76,115,191,0.602094240837696,0.397905759162304,1
"4479","DNAJC14",28,48,76,0.631578947368421,0.368421052631579,1
"4480","DNAJC15",9,3,12,0.25,0.75,1
"4481","DNAJC16",16,44,60,0.733333333333333,0.266666666666667,1
"4482","DNAJC17",15,14,29,0.482758620689655,0.517241379310345,1
"4483","DNAJC18",8,22,30,0.733333333333333,0.266666666666667,1
"4484","DNAJC19",8,8,16,0.5,0.5,1
"4485","DNAJC2",21,35,56,0.625,0.375,1
"4486","DNAJC21",25,31,56,0.553571428571429,0.446428571428571,1
"4487","DNAJC22",20,24,44,0.545454545454545,0.454545454545455,1
"4488","DNAJC24",5,14,19,0.736842105263158,0.263157894736842,1
"4489","DNAJC25",7,17,24,0.708333333333333,0.291666666666667,1
"4490","DNAJC25-GNG10",1,1,2,0.5,0.5,1
"4491","DNAJC27",7,14,21,0.666666666666667,0.333333333333333,1
"4492","DNAJC28",24,19,43,0.441860465116279,0.558139534883721,1
"4493","DNAJC3",23,19,42,0.452380952380952,0.547619047619048,1
"4494","DNAJC30",7,6,13,0.461538461538462,0.538461538461538,1
"4495","DNAJC4",8,3,11,0.272727272727273,0.727272727272727,1
"4496","DNAJC5",7,15,22,0.681818181818182,0.318181818181818,1
"4497","DNAJC5B",27,31,58,0.53448275862069,0.46551724137931,1
"4498","DNAJC5G",10,28,38,0.736842105263158,0.263157894736842,1
"4499","DNAJC6",32,65,97,0.670103092783505,0.329896907216495,1
"4500","DNAJC7",17,11,28,0.392857142857143,0.607142857142857,1
"4501","DNAJC8",16,18,34,0.529411764705882,0.470588235294118,1
"4502","DNAJC9",13,9,22,0.409090909090909,0.590909090909091,1
"4503","DNAL1",6,6,12,0.5,0.5,1
"4504","DNAL4",3,6,9,0.666666666666667,0.333333333333333,1
"4505","DNALI1",7,10,17,0.588235294117647,0.411764705882353,1
"4506","DNASE1",6,10,16,0.625,0.375,1
"4507","DNASE1L1",15,4,19,0.210526315789474,0.789473684210526,1
"4508","DNASE1L2",5,8,13,0.615384615384615,0.384615384615385,1
"4509","DNASE1L3",15,20,35,0.571428571428571,0.428571428571429,1
"4510","DNASE2",13,14,27,0.518518518518518,0.481481481481481,1
"4511","DNASE2B",9,20,29,0.689655172413793,0.310344827586207,1
"4512","DND1",4,6,10,0.6,0.4,1
"4513","DNER",39,87,126,0.69047619047619,0.30952380952381,1
"4514","DNHD1",61,98,159,0.616352201257862,0.383647798742138,1
"4515","DNLZ",2,6,8,0.75,0.25,1
"4516","DNM1",34,46,80,0.575,0.425,1
"4517","DNM1L",22,30,52,0.576923076923077,0.423076923076923,1
"4518","DNM1P46",11,22,33,0.666666666666667,0.333333333333333,1
"4519","DNM2",39,62,101,0.613861386138614,0.386138613861386,1
"4520","DNM3",36,100,136,0.735294117647059,0.264705882352941,1
"4521","DNMBP",49,85,134,0.634328358208955,0.365671641791045,1
"4522","DNMT1",47,84,131,0.641221374045801,0.358778625954198,1
"4523","DNMT3A",53,90,143,0.629370629370629,0.370629370629371,1
"4524","DNMT3B",54,71,125,0.568,0.432,1
"4525","DNMT3L",4,22,26,0.846153846153846,0.153846153846154,1
"4526","DNPEP",11,25,36,0.694444444444444,0.305555555555556,1
"4527","DNPH1",3,6,9,0.666666666666667,0.333333333333333,1
"4528","DNTT",29,47,76,0.618421052631579,0.381578947368421,1
"4529","DNTTIP1",17,17,34,0.5,0.5,1
"4530","DNTTIP2",21,34,55,0.618181818181818,0.381818181818182,1
"4531","DOC2A",24,30,54,0.555555555555556,0.444444444444444,1
"4532","DOCK1",70,73,143,0.510489510489511,0.48951048951049,1
"4533","DOCK10",92,149,241,0.618257261410788,0.381742738589212,1
"4534","DOCK11",120,78,198,0.393939393939394,0.606060606060606,1
"4535","DOCK2",151,252,403,0.62531017369727,0.37468982630273,1
"4536","DOCK3",143,216,359,0.601671309192201,0.398328690807799,1
"4537","DOCK4",87,143,230,0.621739130434783,0.378260869565217,1
"4538","DOCK5",66,115,181,0.635359116022099,0.364640883977901,1
"4539","DOCK6",43,87,130,0.669230769230769,0.330769230769231,1
"4540","DOCK7",68,115,183,0.628415300546448,0.371584699453552,1
"4541","DOCK8",85,110,195,0.564102564102564,0.435897435897436,1
"4542","DOCK9",61,95,156,0.608974358974359,0.391025641025641,1
"4543","DOHH",6,6,12,0.5,0.5,1
"4544","DOK1",22,21,43,0.488372093023256,0.511627906976744,1
"4545","DOK2",8,23,31,0.741935483870968,0.258064516129032,1
"4546","DOK3",11,17,28,0.607142857142857,0.392857142857143,1
"4547","DOK4",16,16,32,0.5,0.5,1
"4548","DOK5",35,39,74,0.527027027027027,0.472972972972973,1
"4549","DOK6",27,57,84,0.678571428571429,0.321428571428571,1
"4550","DOK7",15,24,39,0.615384615384615,0.384615384615385,1
"4551","DOLK",13,18,31,0.580645161290323,0.419354838709677,1
"4552","DOLPP1",5,7,12,0.583333333333333,0.416666666666667,1
"4553","DONSON",12,20,32,0.625,0.375,1
"4554","DOP1A",71,131,202,0.648514851485149,0.351485148514851,1
"4555","DOP1B",84,123,207,0.594202898550725,0.405797101449275,1
"4556","DOT1L",45,78,123,0.634146341463415,0.365853658536585,1
"4557","DPAGT1",16,23,39,0.58974358974359,0.41025641025641,0.88
"4558","DPCD",13,7,20,0.35,0.65,1
"4559","DPEP1",15,22,37,0.594594594594595,0.405405405405405,1
"4560","DPEP2",10,33,43,0.767441860465116,0.232558139534884,1
"4561","DPEP3",14,35,49,0.714285714285714,0.285714285714286,1
"4562","DPF1",12,22,34,0.647058823529412,0.352941176470588,1
"4563","DPF2",23,33,56,0.589285714285714,0.410714285714286,1
"4564","DPF3",23,41,64,0.640625,0.359375,1
"4565","DPH1",15,19,34,0.558823529411765,0.441176470588235,1
"4566","DPH2",21,35,56,0.625,0.375,1
"4567","DPH3",4,1,5,0.2,0.8,1
"4568","DPH5",8,10,18,0.555555555555556,0.444444444444444,1
"4569","DPH6",9,16,25,0.64,0.36,1
"4570","DPH7",9,11,20,0.55,0.45,1
"4571","DPM1",8,16,24,0.666666666666667,0.333333333333333,1
"4572","DPM2",2,4,6,0.666666666666667,0.333333333333333,1
"4573","DPM3",3,2,5,0.4,0.6,1
"4574","DPP10",86,172,258,0.666666666666667,0.333333333333333,1
"4575","DPP3",32,39,71,0.549295774647887,0.450704225352113,1
"4576","DPP4",35,70,105,0.666666666666667,0.333333333333333,1
"4577","DPP6",62,119,181,0.657458563535912,0.342541436464088,1
"4578","DPP7",10,11,21,0.523809523809524,0.476190476190476,1
"4579","DPP8",30,46,76,0.605263157894737,0.394736842105263,1
"4580","DPP9",30,29,59,0.491525423728814,0.508474576271186,1
"4581","DPPA2",32,67,99,0.676767676767677,0.323232323232323,1
"4582","DPPA3",10,29,39,0.743589743589744,0.256410256410256,1
"4583","DPPA4",25,66,91,0.725274725274725,0.274725274725275,1
"4584","DPPA5",10,15,25,0.6,0.4,1
"4585","DPRX",14,34,48,0.708333333333333,0.291666666666667,1
"4586","DPT",7,16,23,0.695652173913043,0.304347826086957,1
"4587","DPY19L1",21,38,59,0.644067796610169,0.355932203389831,1
"4588","DPY19L2",41,69,110,0.627272727272727,0.372727272727273,1
"4589","DPY19L3",16,45,61,0.737704918032787,0.262295081967213,1
"4590","DPY19L4",21,37,58,0.637931034482759,0.362068965517241,1
"4591","DPY30",4,5,9,0.555555555555556,0.444444444444444,1
"4592","DPYD",85,180,265,0.679245283018868,0.320754716981132,1
"4593","DPYS",41,84,125,0.672,0.328,1
"4594","DPYSL2",13,34,47,0.723404255319149,0.276595744680851,1
"4595","DPYSL3",31,40,71,0.563380281690141,0.436619718309859,1
"4596","DPYSL4",27,45,72,0.625,0.375,1
"4597","DPYSL5",38,64,102,0.627450980392157,0.372549019607843,1
"4598","DQX1",24,44,68,0.647058823529412,0.352941176470588,1
"4599","DR1",4,7,11,0.636363636363636,0.363636363636364,1
"4600","DRAM1",11,9,20,0.45,0.55,1
"4601","DRAM2",10,11,21,0.523809523809524,0.476190476190476,1
"4602","DRAP1",5,10,15,0.666666666666667,0.333333333333333,1
"4603","DRAXIN",20,18,38,0.473684210526316,0.526315789473684,1
"4604","DRC1",34,54,88,0.613636363636364,0.386363636363636,1
"4605","DRC3",10,18,28,0.642857142857143,0.357142857142857,1
"4606","DRC7",47,60,107,0.560747663551402,0.439252336448598,1
"4607","DRD1",33,23,56,0.410714285714286,0.589285714285714,1
"4608","DRD2",34,55,89,0.617977528089888,0.382022471910112,1
"4609","DRD3",34,44,78,0.564102564102564,0.435897435897436,1
"4610","DRD4",8,4,12,0.333333333333333,0.666666666666667,1
"4611","DRD5",42,77,119,0.647058823529412,0.352941176470588,1
"4612","DRG1",3,13,16,0.8125,0.1875,1
"4613","DRG2",14,17,31,0.548387096774194,0.451612903225806,1
"4614","DRGX",19,26,45,0.577777777777778,0.422222222222222,1
"4615","DRICH1",6,22,28,0.785714285714286,0.214285714285714,1
"4616","DROSHA",49,91,140,0.65,0.35,1
"4617","DRP2",73,42,115,0.365217391304348,0.634782608695652,1
"4618","DSC1",64,112,176,0.636363636363636,0.363636363636364,1
"4619","DSC2",42,104,146,0.712328767123288,0.287671232876712,1
"4620","DSC3",55,120,175,0.685714285714286,0.314285714285714,1
"4621","DSCAM",204,357,561,0.636363636363636,0.363636363636364,1
"4622","DSCAML1",112,214,326,0.656441717791411,0.343558282208589,1
"4623","DSCC1",12,10,22,0.454545454545455,0.545454545454545,1
"4624","DSCR4",7,18,25,0.72,0.28,1
"4625","DSE",32,69,101,0.683168316831683,0.316831683168317,1
"4626","DSEL",82,146,228,0.640350877192982,0.359649122807018,1
"4627","DSG1",68,135,203,0.665024630541872,0.334975369458128,1
"4628","DSG2",45,92,137,0.671532846715328,0.328467153284672,1
"4629","DSG3",74,140,214,0.654205607476635,0.345794392523364,1
"4630","DSG4",85,142,227,0.625550660792952,0.374449339207048,1
"4631","DSN1",8,20,28,0.714285714285714,0.285714285714286,1
"4632","DSP",113,256,369,0.693766937669377,0.306233062330623,1
"4633","DSPP",37,84,121,0.694214876033058,0.305785123966942,1
"4634","DST",286,444,730,0.608219178082192,0.391780821917808,1
"4635","DSTN",19,12,31,0.387096774193548,0.612903225806452,1
"4636","DSTYK",30,52,82,0.634146341463415,0.365853658536585,1
"4637","DTD1",11,13,24,0.541666666666667,0.458333333333333,1
"4638","DTD2",12,6,18,0.333333333333333,0.666666666666667,1
"4639","DTHD1",1,1,2,0.5,0.5,1
"4640","DTL",18,33,51,0.647058823529412,0.352941176470588,1
"4641","DTNA",49,68,117,0.581196581196581,0.418803418803419,1
"4642","DTNB",13,25,38,0.657894736842105,0.342105263157895,1
"4643","DTNBP1",15,24,39,0.615384615384615,0.384615384615385,1
"4644","DTWD1",8,25,33,0.757575757575758,0.242424242424242,1
"4645","DTWD2",13,12,25,0.48,0.52,1
"4646","DTX1",27,33,60,0.55,0.45,1
"4647","DTX2",13,31,44,0.704545454545455,0.295454545454545,1
"4648","DTX3",18,28,46,0.608695652173913,0.391304347826087,1
"4649","DTX3L",21,30,51,0.588235294117647,0.411764705882353,1
"4650","DTX4",26,37,63,0.587301587301587,0.412698412698413,1
"4651","DTYMK",4,3,7,0.428571428571429,0.571428571428571,1
"4652","DUOX1",52,73,125,0.584,0.416,1
"4653","DUOX2",69,105,174,0.603448275862069,0.396551724137931,1
"4654","DUOXA1",6,17,23,0.739130434782609,0.260869565217391,1
"4655","DUOXA2",12,17,29,0.586206896551724,0.413793103448276,1
"4656","DUS1L",11,22,33,0.666666666666667,0.333333333333333,1
"4657","DUS2",12,20,32,0.625,0.375,1
"4658","DUS3L",22,29,51,0.568627450980392,0.431372549019608,1
"4659","DUS4L",4,4,8,0.5,0.5,1
"4660","DUS4L-BCAP29",36,33,69,0.478260869565217,0.521739130434783,1
"4661","DUSP1",8,14,22,0.636363636363636,0.363636363636364,1
"4662","DUSP10",19,26,45,0.577777777777778,0.422222222222222,1
"4663","DUSP11",9,23,32,0.71875,0.28125,1
"4664","DUSP12",16,19,35,0.542857142857143,0.457142857142857,1
"4665","DUSP13",5,12,17,0.705882352941177,0.294117647058824,1
"4666","DUSP14",9,10,19,0.526315789473684,0.473684210526316,1
"4667","DUSP15",8,15,23,0.652173913043478,0.347826086956522,1
"4668","DUSP16",25,34,59,0.576271186440678,0.423728813559322,1
"4669","DUSP18",4,6,10,0.6,0.4,1
"4670","DUSP19",6,14,20,0.7,0.3,1
"4671","DUSP2",7,14,21,0.666666666666667,0.333333333333333,1
"4672","DUSP21",13,12,25,0.48,0.52,1
"4673","DUSP22",23,49,72,0.680555555555556,0.319444444444444,1
"4674","DUSP23",1,2,3,0.666666666666667,0.333333333333333,1
"4675","DUSP26",21,20,41,0.48780487804878,0.51219512195122,1
"4676","DUSP28",1,3,4,0.75,0.25,1
"4677","DUSP29",13,17,30,0.566666666666667,0.433333333333333,1
"4678","DUSP3",10,5,15,0.333333333333333,0.666666666666667,1
"4679","DUSP4",10,16,26,0.615384615384615,0.384615384615385,1
"4680","DUSP5",16,24,40,0.6,0.4,1
"4681","DUSP6",23,24,47,0.51063829787234,0.48936170212766,1
"4682","DUSP7",15,19,34,0.558823529411765,0.441176470588235,1
"4683","DUSP8",12,12,24,0.5,0.5,1
"4684","DUSP9",22,9,31,0.290322580645161,0.709677419354839,1
"4685","DUT",4,8,12,0.666666666666667,0.333333333333333,1
"4686","DUXA",14,33,47,0.702127659574468,0.297872340425532,1
"4687","DVL1",21,31,52,0.596153846153846,0.403846153846154,1
"4688","DVL2",25,36,61,0.590163934426229,0.409836065573771,1
"4689","DVL3",32,40,72,0.555555555555556,0.444444444444444,1
"4690","DXO",9,26,35,0.742857142857143,0.257142857142857,1
"4691","DYDC1",10,14,24,0.583333333333333,0.416666666666667,1
"4692","DYDC2",7,19,26,0.730769230769231,0.269230769230769,1
"4693","DYM",26,37,63,0.587301587301587,0.412698412698413,1
"4694","DYNAP",8,33,41,0.804878048780488,0.195121951219512,1
"4695","DYNC1H1",136,218,354,0.615819209039548,0.384180790960452,1
"4696","DYNC1I1",36,80,116,0.689655172413793,0.310344827586207,1
"4697","DYNC1I2",17,35,52,0.673076923076923,0.326923076923077,1
"4698","DYNC1LI1",16,22,38,0.578947368421053,0.421052631578947,1
"4699","DYNC1LI2",8,20,28,0.714285714285714,0.285714285714286,1
"4700","DYNC2H1",139,218,357,0.610644257703081,0.389355742296919,1
"4701","DYNC2I1",44,52,96,0.541666666666667,0.458333333333333,1
"4702","DYNC2I2",11,17,28,0.607142857142857,0.392857142857143,1
"4703","DYNC2LI1",21,20,41,0.48780487804878,0.51219512195122,1
"4704","DYNLL1",4,4,8,0.5,0.5,1
"4705","DYNLL2",5,5,10,0.5,0.5,1
"4706","DYNLRB1",0,14,14,1,0,1
"4707","DYNLRB2",4,17,21,0.80952380952381,0.19047619047619,1
"4708","DYNLT1",3,3,6,0.5,0.5,1
"4709","DYNLT3",2,3,5,0.6,0.4,1
"4710","DYRK1A",27,62,89,0.696629213483146,0.303370786516854,1
"4711","DYRK1B",18,43,61,0.704918032786885,0.295081967213115,1
"4712","DYRK2",14,30,44,0.681818181818182,0.318181818181818,1
"4713","DYRK3",31,45,76,0.592105263157895,0.407894736842105,1
"4714","DYRK4",41,59,100,0.59,0.41,1
"4715","DYSF",136,254,390,0.651282051282051,0.348717948717949,1
"4716","DYTN",40,56,96,0.583333333333333,0.416666666666667,1
"4717","DZANK1",29,35,64,0.546875,0.453125,0.44
"4718","DZIP1",42,89,131,0.679389312977099,0.320610687022901,1
"4719","DZIP1L",27,56,83,0.674698795180723,0.325301204819277,1
"4720","DZIP3",57,98,155,0.632258064516129,0.367741935483871,1
"4721","E2F1",6,14,20,0.7,0.3,1
"4722","E2F2",14,22,36,0.611111111111111,0.388888888888889,1
"4723","E2F3",14,27,41,0.658536585365854,0.341463414634146,1
"4724","E2F4",13,14,27,0.518518518518518,0.481481481481481,1
"4725","E2F5",15,16,31,0.516129032258065,0.483870967741935,1
"4726","E2F6",4,9,13,0.692307692307692,0.307692307692308,1
"4727","E2F7",39,70,109,0.642201834862385,0.357798165137615,1
"4728","E2F8",48,64,112,0.571428571428571,0.428571428571429,1
"4729","E4F1",23,37,60,0.616666666666667,0.383333333333333,1
"4730","EAF1",5,10,15,0.666666666666667,0.333333333333333,1
"4731","EAF2",13,29,42,0.69047619047619,0.30952380952381,1
"4732","EAPP",10,15,25,0.6,0.4,1
"4733","EARS2",8,23,31,0.741935483870968,0.258064516129032,0.77
"4734","EBAG9",13,15,28,0.535714285714286,0.464285714285714,1
"4735","EBF1",45,67,112,0.598214285714286,0.401785714285714,1
"4736","EBF2",39,87,126,0.69047619047619,0.30952380952381,1
"4737","EBF3",46,79,125,0.632,0.368,1
"4738","EBF4",0,1,1,1,0,1
"4739","EBI3",8,15,23,0.652173913043478,0.347826086956522,1
"4740","EBLN2",4,12,16,0.75,0.25,1
"4741","EBNA1BP2",16,17,33,0.515151515151515,0.484848484848485,1
"4742","EBP",2,2,4,0.5,0.5,1
"4743","EBPL",16,18,34,0.529411764705882,0.470588235294118,1
"4744","ECD",13,27,40,0.675,0.325,1
"4745","ECE1",29,44,73,0.602739726027397,0.397260273972603,1
"4746","ECE2",7,6,13,0.461538461538462,0.538461538461538,1
"4747","ECEL1",38,42,80,0.525,0.475,1
"4748","ECH1",8,18,26,0.692307692307692,0.307692307692308,1
"4749","ECHDC1",13,15,28,0.535714285714286,0.464285714285714,1
"4750","ECHDC2",16,12,28,0.428571428571429,0.571428571428571,1
"4751","ECHDC3",2,16,18,0.888888888888889,0.111111111111111,1
"4752","ECHS1",14,17,31,0.548387096774194,0.451612903225806,1
"4753","ECI1",5,13,18,0.722222222222222,0.277777777777778,1
"4754","ECI2",20,28,48,0.583333333333333,0.416666666666667,1
"4755","ECM1",20,36,56,0.642857142857143,0.357142857142857,1
"4756","ECM2",38,42,80,0.525,0.475,1
"4757","ECPAS",62,67,129,0.51937984496124,0.48062015503876,1
"4758","ECRG4",14,15,29,0.517241379310345,0.482758620689655,1
"4759","ECSCR",2,3,5,0.6,0.4,1
"4760","ECSIT",17,30,47,0.638297872340426,0.361702127659574,1
"4761","ECT2",29,53,82,0.646341463414634,0.353658536585366,1
"4762","ECT2L",35,50,85,0.588235294117647,0.411764705882353,1
"4763","EDA",15,15,30,0.5,0.5,1
"4764","EDA2R",17,17,34,0.5,0.5,1
"4765","EDAR",19,46,65,0.707692307692308,0.292307692307692,0.77
"4766","EDARADD",16,20,36,0.555555555555556,0.444444444444444,0.77
"4767","EDC3",8,27,35,0.771428571428571,0.228571428571429,1
"4768","EDC4",36,62,98,0.63265306122449,0.36734693877551,1
"4769","EDDM3A",11,7,18,0.388888888888889,0.611111111111111,1
"4770","EDDM3B",8,8,16,0.5,0.5,1
"4771","EDEM1",20,24,44,0.545454545454545,0.454545454545455,1
"4772","EDEM2",18,31,49,0.63265306122449,0.36734693877551,1
"4773","EDEM3",29,43,72,0.597222222222222,0.402777777777778,1
"4774","EDF1",4,7,11,0.636363636363636,0.363636363636364,1
"4775","EDIL3",42,68,110,0.618181818181818,0.381818181818182,1
"4776","EDN1",10,16,26,0.615384615384615,0.384615384615385,1
"4777","EDN2",7,8,15,0.533333333333333,0.466666666666667,1
"4778","EDN3",23,31,54,0.574074074074074,0.425925925925926,1
"4779","EDNRA",17,31,48,0.645833333333333,0.354166666666667,1
"4780","EDNRB",60,81,141,0.574468085106383,0.425531914893617,1
"4781","EDRF1",40,65,105,0.619047619047619,0.380952380952381,1
"4782","EEA1",55,59,114,0.517543859649123,0.482456140350877,1
"4783","EED",23,25,48,0.520833333333333,0.479166666666667,1
"4784","EEF1A1",35,55,90,0.611111111111111,0.388888888888889,1
"4785","EEF1A1P22",0,4,4,1,0,1
"4786","EEF1A2",28,32,60,0.533333333333333,0.466666666666667,1
"4787","EEF1AKMT1",5,15,20,0.75,0.25,1
"4788","EEF1AKMT2",3,5,8,0.625,0.375,1
"4789","EEF1AKMT3",6,11,17,0.647058823529412,0.352941176470588,1
"4790","EEF1AKMT4",5,7,12,0.583333333333333,0.416666666666667,1
"4791","EEF1AKMT4-ECE2",45,66,111,0.594594594594595,0.405405405405405,1
"4792","EEF1AKNMT",34,42,76,0.552631578947368,0.447368421052632,1
"4793","EEF1B2",2,18,20,0.9,0.1,1
"4794","EEF1D",11,16,27,0.592592592592593,0.407407407407407,1
"4795","EEF1E1",8,11,19,0.578947368421053,0.421052631578947,1
"4796","EEF1G",14,20,34,0.588235294117647,0.411764705882353,1
"4797","EEF2",35,49,84,0.583333333333333,0.416666666666667,1
"4798","EEF2K",30,46,76,0.605263157894737,0.394736842105263,1
"4799","EEF2KMT",6,11,17,0.647058823529412,0.352941176470588,1
"4800","EEFSEC",24,30,54,0.555555555555556,0.444444444444444,1
"4801","EEPD1",31,29,60,0.483333333333333,0.516666666666667,1
"4802","EFCAB1",10,19,29,0.655172413793103,0.344827586206897,1
"4803","EFCAB11",7,7,14,0.5,0.5,1
"4804","EFCAB12",19,37,56,0.660714285714286,0.339285714285714,1
"4805","EFCAB13",42,62,104,0.596153846153846,0.403846153846154,1
"4806","EFCAB14",11,22,33,0.666666666666667,0.333333333333333,1
"4807","EFCAB2",2,9,11,0.818181818181818,0.181818181818182,1
"4808","EFCAB3",17,47,64,0.734375,0.265625,1
"4809","EFCAB5",61,94,155,0.606451612903226,0.393548387096774,1
"4810","EFCAB6",63,114,177,0.644067796610169,0.355932203389831,1
"4811","EFCAB7",20,33,53,0.622641509433962,0.377358490566038,1
"4812","EFCAB8",1,9,10,0.9,0.1,1
"4813","EFCC1",4,10,14,0.714285714285714,0.285714285714286,1
"4814","EFEMP1",26,47,73,0.643835616438356,0.356164383561644,1
"4815","EFEMP2",15,26,41,0.634146341463415,0.365853658536585,1
"4816","EFHB",51,68,119,0.571428571428571,0.428571428571429,1
"4817","EFHC1",20,43,63,0.682539682539683,0.317460317460317,1
"4818","EFHC2",32,26,58,0.448275862068966,0.551724137931034,1
"4819","EFHD1",13,19,32,0.59375,0.40625,1
"4820","EFHD2",4,8,12,0.666666666666667,0.333333333333333,1
"4821","EFL1",35,48,83,0.578313253012048,0.421686746987952,1
"4822","EFNA1",7,9,16,0.5625,0.4375,1
"4823","EFNA2",5,4,9,0.444444444444444,0.555555555555556,1
"4824","EFNA3",11,4,15,0.266666666666667,0.733333333333333,1
"4825","EFNA4",13,11,24,0.458333333333333,0.541666666666667,1
"4826","EFNA5",7,24,31,0.774193548387097,0.225806451612903,1
"4827","EFNB1",23,8,31,0.258064516129032,0.741935483870968,1
"4828","EFNB2",10,23,33,0.696969696969697,0.303030303030303,1
"4829","EFNB3",19,30,49,0.612244897959184,0.387755102040816,1
"4830","EFR3A",34,55,89,0.617977528089888,0.382022471910112,1
"4831","EFR3B",0,2,2,1,0,1
"4832","EFS",9,41,50,0.82,0.18,1
"4833","EFTUD2",33,55,88,0.625,0.375,1
"4834","EGF",42,96,138,0.695652173913043,0.304347826086957,1
"4835","EGFL6",31,28,59,0.474576271186441,0.525423728813559,1
"4836","EGFL7",7,8,15,0.533333333333333,0.466666666666667,1
"4837","EGFL8",18,12,30,0.4,0.6,1
"4838","EGFLAM",73,151,224,0.674107142857143,0.325892857142857,1
"4839","EGFR",173,226,399,0.566416040100251,0.433583959899749,1
"4840","EGLN1",10,15,25,0.6,0.4,1
"4841","EGLN2",13,21,34,0.617647058823529,0.382352941176471,1
"4842","EGLN3",13,9,22,0.409090909090909,0.590909090909091,1
"4843","EGR1",39,43,82,0.524390243902439,0.475609756097561,1
"4844","EGR2",27,44,71,0.619718309859155,0.380281690140845,1
"4845","EGR3",23,20,43,0.465116279069767,0.534883720930233,1
"4846","EGR4",13,28,41,0.682926829268293,0.317073170731707,1
"4847","EHBP1",45,76,121,0.628099173553719,0.371900826446281,1
"4848","EHBP1L1",32,59,91,0.648351648351648,0.351648351648352,1
"4849","EHD1",13,32,45,0.711111111111111,0.288888888888889,1
"4850","EHD2",32,38,70,0.542857142857143,0.457142857142857,1
"4851","EHD3",26,64,90,0.711111111111111,0.288888888888889,1
"4852","EHD4",14,17,31,0.548387096774194,0.451612903225806,1
"4853","EHF",17,26,43,0.604651162790698,0.395348837209302,1
"4854","EHHADH",31,38,69,0.550724637681159,0.449275362318841,1
"4855","EHMT1",38,74,112,0.660714285714286,0.339285714285714,1
"4856","EHMT2",41,66,107,0.616822429906542,0.383177570093458,1
"4857","EI24",4,10,14,0.714285714285714,0.285714285714286,1
"4858","EI24P4",19,22,41,0.536585365853659,0.463414634146341,1
"4859","EID1",1,15,16,0.9375,0.0625,1
"4860","EID2",4,6,10,0.6,0.4,1
"4861","EID2B",2,7,9,0.777777777777778,0.222222222222222,1
"4862","EID3",11,19,30,0.633333333333333,0.366666666666667,1
"4863","EIF1",4,11,15,0.733333333333333,0.266666666666667,1
"4864","EIF1AD",6,4,10,0.4,0.6,1
"4865","EIF1AX",17,20,37,0.540540540540541,0.459459459459459,1
"4866","EIF1AY",0,3,3,1,0,1
"4867","EIF1B",4,7,11,0.636363636363636,0.363636363636364,1
"4868","EIF2A",15,20,35,0.571428571428571,0.428571428571429,1
"4869","EIF2AK1",37,37,74,0.5,0.5,1
"4870","EIF2AK2",22,19,41,0.463414634146341,0.536585365853659,1
"4871","EIF2AK3",50,68,118,0.576271186440678,0.423728813559322,0.54
"4872","EIF2AK4",43,76,119,0.638655462184874,0.361344537815126,1
"4873","EIF2B1",11,14,25,0.56,0.44,1
"4874","EIF2B2",10,17,27,0.62962962962963,0.37037037037037,1
"4875","EIF2B3",20,28,48,0.583333333333333,0.416666666666667,1
"4876","EIF2B4",12,26,38,0.684210526315789,0.315789473684211,1
"4877","EIF2B5",15,39,54,0.722222222222222,0.277777777777778,1
"4878","EIF2D",17,27,44,0.613636363636364,0.386363636363636,1
"4879","EIF2S1",3,12,15,0.8,0.2,1
"4880","EIF2S2",7,16,23,0.695652173913043,0.304347826086957,1
"4881","EIF2S3",14,16,30,0.533333333333333,0.466666666666667,1
"4882","EIF3A",51,83,134,0.619402985074627,0.380597014925373,1
"4883","EIF3B",22,44,66,0.666666666666667,0.333333333333333,1
"4884","EIF3C",6,3,9,0.333333333333333,0.666666666666667,1
"4885","EIF3CL",2,0,2,0,1,1
"4886","EIF3D",16,28,44,0.636363636363636,0.363636363636364,1
"4887","EIF3E",18,36,54,0.666666666666667,0.333333333333333,1
"4888","EIF3F",8,16,24,0.666666666666667,0.333333333333333,1
"4889","EIF3G",13,11,24,0.458333333333333,0.541666666666667,1
"4890","EIF3H",12,15,27,0.555555555555556,0.444444444444444,1
"4891","EIF3I",10,15,25,0.6,0.4,1
"4892","EIF3J",20,17,37,0.459459459459459,0.540540540540541,1
"4893","EIF3K",11,13,24,0.541666666666667,0.458333333333333,1
"4894","EIF3L",19,24,43,0.558139534883721,0.441860465116279,1
"4895","EIF3M",13,23,36,0.638888888888889,0.361111111111111,1
"4896","EIF4A1",12,18,30,0.6,0.4,1
"4897","EIF4A2",17,42,59,0.711864406779661,0.288135593220339,1
"4898","EIF4A3",7,22,29,0.758620689655172,0.241379310344828,1
"4899","EIF4B",20,45,65,0.692307692307692,0.307692307692308,1
"4900","EIF4E",13,7,20,0.35,0.65,1
"4901","EIF4E1B",10,15,25,0.6,0.4,1
"4902","EIF4E2",10,11,21,0.523809523809524,0.476190476190476,1
"4903","EIF4E3",8,8,16,0.5,0.5,1
"4904","EIF4EBP1",2,2,4,0.5,0.5,1
"4905","EIF4EBP2",4,9,13,0.692307692307692,0.307692307692308,1
"4906","EIF4ENIF1",41,43,84,0.511904761904762,0.488095238095238,1
"4907","EIF4G1",61,121,182,0.664835164835165,0.335164835164835,1
"4908","EIF4G2",41,46,87,0.528735632183908,0.471264367816092,1
"4909","EIF4G3",68,102,170,0.6,0.4,1
"4910","EIF4H",8,16,24,0.666666666666667,0.333333333333333,1
"4911","EIF5",12,30,42,0.714285714285714,0.285714285714286,1
"4912","EIF5A",7,17,24,0.708333333333333,0.291666666666667,1
"4913","EIF5A2",6,14,20,0.7,0.3,1
"4914","EIF5AL1",6,7,13,0.538461538461538,0.461538461538462,1
"4915","EIF5B",43,70,113,0.619469026548673,0.380530973451327,1
"4916","EIF6",3,16,19,0.842105263157895,0.157894736842105,1
"4917","EIPR1",11,27,38,0.710526315789474,0.289473684210526,1
"4918","ELAC1",10,23,33,0.696969696969697,0.303030303030303,1
"4919","ELAC2",30,27,57,0.473684210526316,0.526315789473684,1
"4920","ELANE",8,20,28,0.714285714285714,0.285714285714286,1
"4921","ELAPOR1",33,48,81,0.592592592592593,0.407407407407407,1
"4922","ELAPOR2",51,88,139,0.633093525179856,0.366906474820144,1
"4923","ELAVL1",20,31,51,0.607843137254902,0.392156862745098,1
"4924","ELAVL2",38,63,101,0.623762376237624,0.376237623762376,1
"4925","ELAVL3",22,32,54,0.592592592592593,0.407407407407407,1
"4926","ELAVL4",37,67,104,0.644230769230769,0.355769230769231,1
"4927","ELF1",21,43,64,0.671875,0.328125,1
"4928","ELF2",18,29,47,0.617021276595745,0.382978723404255,1
"4929","ELF3",49,77,126,0.611111111111111,0.388888888888889,1
"4930","ELF4",40,26,66,0.393939393939394,0.606060606060606,1
"4931","ELF5",11,25,36,0.694444444444444,0.305555555555556,1
"4932","ELFN1",3,1,4,0.25,0.75,1
"4933","ELFN2",40,61,101,0.603960396039604,0.396039603960396,1
"4934","ELK1",16,13,29,0.448275862068966,0.551724137931034,1
"4935","ELK3",16,17,33,0.515151515151515,0.484848484848485,1
"4936","ELK4",14,23,37,0.621621621621622,0.378378378378378,1
"4937","ELL",21,14,35,0.4,0.6,1
"4938","ELL2",38,42,80,0.525,0.475,1
"4939","ELL3",16,17,33,0.515151515151515,0.484848484848485,1
"4940","ELMO1",76,106,182,0.582417582417582,0.417582417582418,1
"4941","ELMO2",26,36,62,0.580645161290323,0.419354838709677,1
"4942","ELMO3",14,33,47,0.702127659574468,0.297872340425532,1
"4943","ELMOD1",15,28,43,0.651162790697674,0.348837209302326,1
"4944","ELMOD2",8,15,23,0.652173913043478,0.347826086956522,1
"4945","ELMOD3",7,20,27,0.740740740740741,0.259259259259259,1
"4946","ELN",33,55,88,0.625,0.375,1
"4947","ELOA",28,46,74,0.621621621621622,0.378378378378378,1
"4948","ELOA2",63,115,178,0.646067415730337,0.353932584269663,1
"4949","ELOA3",2,6,8,0.75,0.25,1
"4950","ELOA3B",2,3,5,0.6,0.4,1
"4951","ELOA3C",1,4,5,0.8,0.2,1
"4952","ELOB",4,2,6,0.333333333333333,0.666666666666667,1
"4953","ELOC",8,5,13,0.384615384615385,0.615384615384615,1
"4954","ELOF1",5,3,8,0.375,0.625,1
"4955","ELOVL1",7,15,22,0.681818181818182,0.318181818181818,1
"4956","ELOVL2",13,26,39,0.666666666666667,0.333333333333333,1
"4957","ELOVL3",16,16,32,0.5,0.5,1
"4958","ELOVL4",21,31,52,0.596153846153846,0.403846153846154,1
"4959","ELOVL5",6,12,18,0.666666666666667,0.333333333333333,1
"4960","ELOVL6",8,13,21,0.619047619047619,0.380952380952381,1
"4961","ELOVL7",10,19,29,0.655172413793103,0.344827586206897,1
"4962","ELP1",42,60,102,0.588235294117647,0.411764705882353,1
"4963","ELP2",19,30,49,0.612244897959184,0.387755102040816,1
"4964","ELP3",11,24,35,0.685714285714286,0.314285714285714,1
"4965","ELP4",16,35,51,0.686274509803922,0.313725490196078,1
"4966","ELP5",10,18,28,0.642857142857143,0.357142857142857,1
"4967","ELP6",6,12,18,0.666666666666667,0.333333333333333,1
"4968","ELSPBP1",26,21,47,0.446808510638298,0.553191489361702,1
"4969","EMB",15,48,63,0.761904761904762,0.238095238095238,1
"4970","EMC1",37,30,67,0.447761194029851,0.552238805970149,1
"4971","EMC10",2,9,11,0.818181818181818,0.181818181818182,1
"4972","EMC2",11,23,34,0.676470588235294,0.323529411764706,1
"4973","EMC3",9,9,18,0.5,0.5,1
"4974","EMC4",6,10,16,0.625,0.375,1
"4975","EMC6",0,3,3,1,0,1
"4976","EMC7",10,19,29,0.655172413793103,0.344827586206897,1
"4977","EMC8",7,5,12,0.416666666666667,0.583333333333333,1
"4978","EMC9",5,8,13,0.615384615384615,0.384615384615385,1
"4979","EMCN",10,23,33,0.696969696969697,0.303030303030303,1
"4980","EMD",22,7,29,0.241379310344828,0.758620689655172,1
"4981","EME1",13,24,37,0.648648648648649,0.351351351351351,1
"4982","EME2",4,12,16,0.75,0.25,1
"4983","EMG1",10,10,20,0.5,0.5,1
"4984","EMID1",17,22,39,0.564102564102564,0.435897435897436,1
"4985","EMILIN1",29,43,72,0.597222222222222,0.402777777777778,1
"4986","EMILIN2",48,73,121,0.603305785123967,0.396694214876033,1
"4987","EMILIN3",31,51,82,0.621951219512195,0.378048780487805,1
"4988","EML1",40,94,134,0.701492537313433,0.298507462686567,1
"4989","EML2",40,31,71,0.436619718309859,0.563380281690141,1
"4990","EML3",27,35,62,0.564516129032258,0.435483870967742,1
"4991","EML4",32,37,69,0.536231884057971,0.463768115942029,1
"4992","EML5",67,113,180,0.627777777777778,0.372222222222222,1
"4993","EML6",1,12,13,0.923076923076923,0.0769230769230769,1
"4994","EMP1",3,9,12,0.75,0.25,1
"4995","EMP2",3,9,12,0.75,0.25,1
"4996","EMP3",8,9,17,0.529411764705882,0.470588235294118,1
"4997","EMSY",38,78,116,0.672413793103448,0.327586206896552,1
"4998","EMX1",5,8,13,0.615384615384615,0.384615384615385,1
"4999","EMX2",10,15,25,0.6,0.4,1
"5000","EN1",11,21,32,0.65625,0.34375,1
"5001","EN2",5,8,13,0.615384615384615,0.384615384615385,1
"5002","ENAH",12,29,41,0.707317073170732,0.292682926829268,1
"5003","ENAM",69,140,209,0.669856459330144,0.330143540669856,1
"5004","ENC1",28,41,69,0.594202898550725,0.405797101449275,1
"5005","ENDOD1",17,25,42,0.595238095238095,0.404761904761905,1
"5006","ENDOG",5,4,9,0.444444444444444,0.555555555555556,1
"5007","ENDOU",7,21,28,0.75,0.25,1
"5008","ENDOV",6,10,16,0.625,0.375,1
"5009","ENG",20,17,37,0.459459459459459,0.540540540540541,1
"5010","ENGASE",33,36,69,0.521739130434783,0.478260869565217,1
"5011","ENHO",2,8,10,0.8,0.2,1
"5012","ENKD1",5,18,23,0.782608695652174,0.217391304347826,1
"5013","ENKUR",14,23,37,0.621621621621622,0.378378378378378,1
"5014","ENO1",15,17,32,0.53125,0.46875,1
"5015","ENO2",7,17,24,0.708333333333333,0.291666666666667,1
"5016","ENO3",16,21,37,0.567567567567568,0.432432432432432,1
"5017","ENO4",0,4,4,1,0,1
"5018","ENOPH1",10,15,25,0.6,0.4,1
"5019","ENOSF1",14,32,46,0.695652173913043,0.304347826086957,1
"5020","ENOX1",39,61,100,0.61,0.39,1
"5021","ENOX2",52,28,80,0.35,0.65,1
"5022","ENPEP",57,134,191,0.701570680628272,0.298429319371728,1
"5023","ENPP1",37,80,117,0.683760683760684,0.316239316239316,1
"5024","ENPP2",56,74,130,0.569230769230769,0.430769230769231,1
"5025","ENPP3",39,69,108,0.638888888888889,0.361111111111111,1
"5026","ENPP4",20,35,55,0.636363636363636,0.363636363636364,1
"5027","ENPP5",16,42,58,0.724137931034483,0.275862068965517,1
"5028","ENPP6",23,38,61,0.622950819672131,0.377049180327869,1
"5029","ENPP7",23,38,61,0.622950819672131,0.377049180327869,1
"5030","ENSA",3,7,10,0.7,0.3,1
"5031","ENTHD1",46,52,98,0.530612244897959,0.469387755102041,1
"5032","ENTPD1",22,26,48,0.541666666666667,0.458333333333333,1
"5033","ENTPD2",12,20,32,0.625,0.375,1
"5034","ENTPD3",15,29,44,0.659090909090909,0.340909090909091,1
"5035","ENTPD4",24,30,54,0.555555555555556,0.444444444444444,1
"5036","ENTPD5",7,14,21,0.666666666666667,0.333333333333333,1
"5037","ENTPD6",16,24,40,0.6,0.4,1
"5038","ENTPD7",16,41,57,0.719298245614035,0.280701754385965,1
"5039","ENTPD8",10,25,35,0.714285714285714,0.285714285714286,1
"5040","ENTR1",17,18,35,0.514285714285714,0.485714285714286,1
"5041","ENY2",6,8,14,0.571428571428571,0.428571428571429,1
"5042","EOGT",10,14,24,0.583333333333333,0.416666666666667,1
"5043","EOLA1",10,6,16,0.375,0.625,1
"5044","EOLA2",11,4,15,0.266666666666667,0.733333333333333,1
"5045","EOMES",33,41,74,0.554054054054054,0.445945945945946,1
"5046","EP300",110,185,295,0.627118644067797,0.372881355932203,1
"5047","EP400",127,145,272,0.533088235294118,0.466911764705882,1
"5048","EP400P1",1,1,2,0.5,0.5,1
"5049","EPAS1",40,47,87,0.540229885057471,0.459770114942529,1
"5050","EPB41",31,39,70,0.557142857142857,0.442857142857143,1
"5051","EPB41L1",39,68,107,0.635514018691589,0.364485981308411,1
"5052","EPB41L2",45,75,120,0.625,0.375,1
"5053","EPB41L3",94,152,246,0.617886178861789,0.382113821138211,1
"5054","EPB41L4A",35,53,88,0.602272727272727,0.397727272727273,1
"5055","EPB41L4B",37,65,102,0.637254901960784,0.362745098039216,1
"5056","EPB41L5",29,58,87,0.666666666666667,0.333333333333333,1
"5057","EPB42",29,40,69,0.579710144927536,0.420289855072464,1
"5058","EPC1",33,41,74,0.554054054054054,0.445945945945946,1
"5059","EPC2",36,36,72,0.5,0.5,1
"5060","EPCAM",12,14,26,0.538461538461538,0.461538461538462,1
"5061","EPDR1",12,23,35,0.657142857142857,0.342857142857143,1
"5062","EPG5",86,156,242,0.644628099173554,0.355371900826446,1
"5063","EPGN",5,7,12,0.583333333333333,0.416666666666667,1
"5064","EPHA1",37,58,95,0.610526315789474,0.389473684210526,1
"5065","EPHA10",51,76,127,0.598425196850394,0.401574803149606,1
"5066","EPHA2",81,99,180,0.55,0.45,1
"5067","EPHA3",115,185,300,0.616666666666667,0.383333333333333,1
"5068","EPHA4",53,97,150,0.646666666666667,0.353333333333333,1
"5069","EPHA5",110,204,314,0.64968152866242,0.35031847133758,1
"5070","EPHA6",117,199,316,0.629746835443038,0.370253164556962,1
"5071","EPHA7",72,178,250,0.712,0.288,1
"5072","EPHA8",44,91,135,0.674074074074074,0.325925925925926,1
"5073","EPHB1",94,129,223,0.57847533632287,0.42152466367713,1
"5074","EPHB2",45,84,129,0.651162790697674,0.348837209302326,1
"5075","EPHB3",31,83,114,0.728070175438597,0.271929824561404,1
"5076","EPHB4",31,68,99,0.686868686868687,0.313131313131313,1
"5077","EPHB6",68,111,179,0.620111731843575,0.379888268156425,1
"5078","EPHX1",30,33,63,0.523809523809524,0.476190476190476,1
"5079","EPHX2",19,34,53,0.641509433962264,0.358490566037736,1
"5080","EPHX3",9,15,24,0.625,0.375,1
"5081","EPHX4",14,23,37,0.621621621621622,0.378378378378378,1
"5082","EPM2A",9,9,18,0.5,0.5,1
"5083","EPM2AIP1",15,31,46,0.673913043478261,0.326086956521739,1
"5084","EPN1",31,32,63,0.507936507936508,0.492063492063492,1
"5085","EPN2",29,35,64,0.546875,0.453125,1
"5086","EPN3",16,25,41,0.609756097560976,0.390243902439024,1
"5087","EPO",10,18,28,0.642857142857143,0.357142857142857,1
"5088","EPOR",11,12,23,0.521739130434783,0.478260869565217,1
"5089","EPPIN",7,17,24,0.708333333333333,0.291666666666667,1
"5090","EPPIN-WFDC6",5,2,7,0.285714285714286,0.714285714285714,1
"5091","EPPK1",81,134,215,0.623255813953488,0.376744186046512,1
"5092","EPRS1",71,92,163,0.56441717791411,0.43558282208589,1
"5093","EPS15",30,47,77,0.61038961038961,0.38961038961039,1
"5094","EPS15L1",25,55,80,0.6875,0.3125,1
"5095","EPS8",22,56,78,0.717948717948718,0.282051282051282,1
"5096","EPS8L1",17,46,63,0.73015873015873,0.26984126984127,1
"5097","EPS8L2",32,25,57,0.43859649122807,0.56140350877193,1
"5098","EPS8L3",31,53,84,0.630952380952381,0.369047619047619,1
"5099","EPSTI1",20,23,43,0.534883720930233,0.465116279069767,1
"5100","EPX",42,61,103,0.592233009708738,0.407766990291262,1
"5101","EPYC",16,43,59,0.728813559322034,0.271186440677966,1
"5102","EQTN",10,23,33,0.696969696969697,0.303030303030303,1
"5103","ERAL1",7,16,23,0.695652173913043,0.304347826086957,1
"5104","ERAP1",20,36,56,0.642857142857143,0.357142857142857,1
"5105","ERAP2",38,34,72,0.472222222222222,0.527777777777778,1
"5106","ERAS",16,4,20,0.2,0.8,1
"5107","ERBB2",68,101,169,0.597633136094675,0.402366863905325,1
"5108","ERBB3",73,112,185,0.605405405405405,0.394594594594595,1
"5109","ERBB4",156,249,405,0.614814814814815,0.385185185185185,1
"5110","ERBIN",39,65,104,0.625,0.375,1
"5111","ERC1",30,70,100,0.7,0.3,1
"5112","ERC2",61,139,200,0.695,0.305,1
"5113","ERCC1",12,16,28,0.571428571428571,0.428571428571429,1
"5114","ERCC2",32,58,90,0.644444444444444,0.355555555555556,1
"5115","ERCC3",33,35,68,0.514705882352941,0.485294117647059,1
"5116","ERCC4",30,47,77,0.61038961038961,0.38961038961039,1
"5117","ERCC5",3,4,7,0.571428571428571,0.428571428571429,1
"5118","ERCC6",50,86,136,0.632352941176471,0.367647058823529,1
"5119","ERCC6L",55,32,87,0.367816091954023,0.632183908045977,1
"5120","ERCC6L2",39,57,96,0.59375,0.40625,1
"5121","ERCC8",6,11,17,0.647058823529412,0.352941176470588,1
"5122","EREG",7,17,24,0.708333333333333,0.291666666666667,1
"5123","ERF",35,32,67,0.477611940298507,0.522388059701492,1
"5124","ERG",25,64,89,0.719101123595506,0.280898876404494,1
"5125","ERG28",1,9,10,0.9,0.1,1
"5126","ERGIC1",6,11,17,0.647058823529412,0.352941176470588,1
"5127","ERGIC2",9,18,27,0.666666666666667,0.333333333333333,1
"5128","ERGIC3",16,17,33,0.515151515151515,0.484848484848485,1
"5129","ERH",2,5,7,0.714285714285714,0.285714285714286,1
"5130","ERI1",6,14,20,0.7,0.3,1
"5131","ERI2",7,5,12,0.416666666666667,0.583333333333333,1
"5132","ERI3",13,27,40,0.675,0.325,1
"5133","ERICH1",21,42,63,0.666666666666667,0.333333333333333,1
"5134","ERICH2",0,1,1,1,0,1
"5135","ERICH3",183,374,557,0.671454219030521,0.328545780969479,1
"5136","ERICH5",18,22,40,0.55,0.45,1
"5137","ERICH6",31,62,93,0.666666666666667,0.333333333333333,1
"5138","ERICH6B",0,2,2,1,0,1
"5139","ERLEC1",16,23,39,0.58974358974359,0.41025641025641,1
"5140","ERLIN1",6,10,16,0.625,0.375,1
"5141","ERLIN2",12,16,28,0.571428571428571,0.428571428571429,1
"5142","ERMAP",9,19,28,0.678571428571429,0.321428571428571,1
"5143","ERMARD",21,33,54,0.611111111111111,0.388888888888889,0.77
"5144","ERMN",14,25,39,0.641025641025641,0.358974358974359,1
"5145","ERMP1",21,34,55,0.618181818181818,0.381818181818182,1
"5146","ERN1",37,31,68,0.455882352941176,0.544117647058823,1
"5147","ERN2",54,88,142,0.619718309859155,0.380281690140845,1
"5148","ERO1A",13,18,31,0.580645161290323,0.419354838709677,1
"5149","ERO1B",18,24,42,0.571428571428571,0.428571428571429,1
"5150","ERP27",9,22,31,0.709677419354839,0.290322580645161,1
"5151","ERP29",4,13,17,0.764705882352941,0.235294117647059,1
"5152","ERP44",13,22,35,0.628571428571429,0.371428571428571,1
"5153","ERRFI1",20,28,48,0.583333333333333,0.416666666666667,1
"5154","ERV3-1",16,30,46,0.652173913043478,0.347826086956522,1
"5155","ERVFRD-1",9,19,28,0.678571428571429,0.321428571428571,1
"5156","ERVW-1",15,36,51,0.705882352941177,0.294117647058824,1
"5157","ESAM",11,26,37,0.702702702702703,0.297297297297297,1
"5158","ESCO1",26,43,69,0.623188405797101,0.376811594202899,1
"5159","ESCO2",27,34,61,0.557377049180328,0.442622950819672,1
"5160","ESD",5,17,22,0.772727272727273,0.227272727272727,1
"5161","ESF1",49,61,110,0.554545454545455,0.445454545454545,1
"5162","ESM1",14,22,36,0.611111111111111,0.388888888888889,1
"5163","ESPL1",60,106,166,0.63855421686747,0.36144578313253,1
"5164","ESPN",9,21,30,0.7,0.3,1
"5165","ESPNL",38,42,80,0.525,0.475,1
"5166","ESR1",32,54,86,0.627906976744186,0.372093023255814,1
"5167","ESR2",23,47,70,0.671428571428571,0.328571428571429,1
"5168","ESRP1",55,70,125,0.56,0.44,1
"5169","ESRP2",19,37,56,0.660714285714286,0.339285714285714,1
"5170","ESRRA",10,17,27,0.62962962962963,0.37037037037037,1
"5171","ESRRB",25,36,61,0.590163934426229,0.409836065573771,1
"5172","ESRRG",43,81,124,0.653225806451613,0.346774193548387,1
"5173","ESS2",18,29,47,0.617021276595745,0.382978723404255,1
"5174","ESX1",42,29,71,0.408450704225352,0.591549295774648,1
"5175","ESYT1",26,51,77,0.662337662337662,0.337662337662338,1
"5176","ESYT2",25,44,69,0.63768115942029,0.36231884057971,1
"5177","ESYT3",36,50,86,0.581395348837209,0.418604651162791,1
"5178","ETAA1",33,47,80,0.5875,0.4125,1
"5179","ETF1",15,19,34,0.558823529411765,0.441176470588235,1
"5180","ETFA",10,13,23,0.565217391304348,0.434782608695652,1
"5181","ETFB",13,13,26,0.5,0.5,1
"5182","ETFBKMT",9,10,19,0.526315789473684,0.473684210526316,1
"5183","ETFDH",12,19,31,0.612903225806452,0.387096774193548,1
"5184","ETFRF1",6,3,9,0.333333333333333,0.666666666666667,1
"5185","ETHE1",9,7,16,0.4375,0.5625,1
"5186","ETNK1",12,20,32,0.625,0.375,1
"5187","ETNK2",10,8,18,0.444444444444444,0.555555555555556,1
"5188","ETNPPL",32,62,94,0.659574468085106,0.340425531914894,1
"5189","ETS1",18,39,57,0.684210526315789,0.315789473684211,1
"5190","ETS2",15,34,49,0.693877551020408,0.306122448979592,1
"5191","ETV1",25,45,70,0.642857142857143,0.357142857142857,1
"5192","ETV2",3,6,9,0.666666666666667,0.333333333333333,1
"5193","ETV3",5,17,22,0.772727272727273,0.227272727272727,1
"5194","ETV3L",23,17,40,0.425,0.575,1
"5195","ETV4",17,16,33,0.484848484848485,0.515151515151515,1
"5196","ETV5",19,53,72,0.736111111111111,0.263888888888889,1
"5197","ETV6",29,57,86,0.662790697674419,0.337209302325581,1
"5198","ETV7",8,14,22,0.636363636363636,0.363636363636364,1
"5199","EVA1A",10,11,21,0.523809523809524,0.476190476190476,1
"5200","EVA1B",2,8,10,0.8,0.2,1
"5201","EVA1C",10,18,28,0.642857142857143,0.357142857142857,1
"5202","EVC",49,58,107,0.542056074766355,0.457943925233645,1
"5203","EVC2",67,106,173,0.61271676300578,0.38728323699422,1
"5204","EVI2A",7,16,23,0.695652173913043,0.304347826086957,1
"5205","EVI2B",22,29,51,0.568627450980392,0.431372549019608,1
"5206","EVI5",32,63,95,0.663157894736842,0.336842105263158,1
"5207","EVI5L",15,29,44,0.659090909090909,0.340909090909091,1
"5208","EVL",19,20,39,0.512820512820513,0.487179487179487,1
"5209","EVPL",62,140,202,0.693069306930693,0.306930693069307,1
"5210","EVX1",9,17,26,0.653846153846154,0.346153846153846,1
"5211","EVX2",20,43,63,0.682539682539683,0.317460317460317,1
"5212","EWSR1",21,32,53,0.60377358490566,0.39622641509434,1
"5213","EXD1",26,39,65,0.6,0.4,1
"5214","EXD2",13,29,42,0.69047619047619,0.30952380952381,1
"5215","EXD3",21,35,56,0.625,0.375,1
"5216","EXO1",38,43,81,0.530864197530864,0.469135802469136,1
"5217","EXO5",13,20,33,0.606060606060606,0.393939393939394,1
"5218","EXOC1",43,63,106,0.594339622641509,0.405660377358491,1
"5219","EXOC2",25,57,82,0.695121951219512,0.304878048780488,1
"5220","EXOC3",22,27,49,0.551020408163265,0.448979591836735,1
"5221","EXOC3L1",25,24,49,0.489795918367347,0.510204081632653,1
"5222","EXOC3L2",13,34,47,0.723404255319149,0.276595744680851,1
"5223","EXOC3L4",23,16,39,0.41025641025641,0.58974358974359,1
"5224","EXOC4",50,73,123,0.59349593495935,0.40650406504065,1
"5225","EXOC5",12,33,45,0.733333333333333,0.266666666666667,1
"5226","EXOC6",21,45,66,0.681818181818182,0.318181818181818,1
"5227","EXOC6B",19,48,67,0.716417910447761,0.283582089552239,1
"5228","EXOC7",24,37,61,0.60655737704918,0.39344262295082,1
"5229","EXOC8",23,37,60,0.616666666666667,0.383333333333333,1
"5230","EXOG",12,19,31,0.612903225806452,0.387096774193548,1
"5231","EXOSC1",2,7,9,0.777777777777778,0.222222222222222,1
"5232","EXOSC10",32,53,85,0.623529411764706,0.376470588235294,1
"5233","EXOSC2",4,10,14,0.714285714285714,0.285714285714286,1
"5234","EXOSC3",7,2,9,0.222222222222222,0.777777777777778,1
"5235","EXOSC4",10,10,20,0.5,0.5,1
"5236","EXOSC5",11,15,26,0.576923076923077,0.423076923076923,1
"5237","EXOSC6",1,0,1,0,1,1
"5238","EXOSC7",15,13,28,0.464285714285714,0.535714285714286,1
"5239","EXOSC8",15,9,24,0.375,0.625,1
"5240","EXOSC9",12,27,39,0.692307692307692,0.307692307692308,1
"5241","EXPH5",81,142,223,0.63677130044843,0.36322869955157,1
"5242","EXT1",33,51,84,0.607142857142857,0.392857142857143,1
"5243","EXT2",18,47,65,0.723076923076923,0.276923076923077,1
"5244","EXTL1",20,28,48,0.583333333333333,0.416666666666667,1
"5245","EXTL2",10,22,32,0.6875,0.3125,1
"5246","EXTL3",46,50,96,0.520833333333333,0.479166666666667,1
"5247","EYA1",49,81,130,0.623076923076923,0.376923076923077,1
"5248","EYA2",22,65,87,0.747126436781609,0.252873563218391,1
"5249","EYA3",21,27,48,0.5625,0.4375,1
"5250","EYA4",77,88,165,0.533333333333333,0.466666666666667,1
"5251","EYS",88,151,239,0.631799163179916,0.368200836820084,1
"5252","EZH1",27,39,66,0.590909090909091,0.409090909090909,1
"5253","EZH2",39,47,86,0.546511627906977,0.453488372093023,1
"5254","EZHIP",52,30,82,0.365853658536585,0.634146341463415,1
"5255","EZR",18,30,48,0.625,0.375,1
"5256","F10",24,37,61,0.60655737704918,0.39344262295082,1
"5257","F11",26,55,81,0.679012345679012,0.320987654320988,1
"5258","F11R",11,29,40,0.725,0.275,1
"5259","F12",16,26,42,0.619047619047619,0.380952380952381,1
"5260","F13A1",65,121,186,0.650537634408602,0.349462365591398,1
"5261","F13B",60,116,176,0.659090909090909,0.340909090909091,1
"5262","F2",31,44,75,0.586666666666667,0.413333333333333,1
"5263","F2R",22,37,59,0.627118644067797,0.372881355932203,1
"5264","F2RL1",9,30,39,0.769230769230769,0.230769230769231,1
"5265","F2RL2",17,23,40,0.575,0.425,1
"5266","F2RL3",6,21,27,0.777777777777778,0.222222222222222,1
"5267","F3",5,22,27,0.814814814814815,0.185185185185185,1
"5268","F5",124,195,319,0.61128526645768,0.38871473354232,1
"5269","F7",24,36,60,0.6,0.4,1
"5270","F8",199,132,331,0.398791540785498,0.601208459214502,1
"5271","F8A1",5,2,7,0.285714285714286,0.714285714285714,1
"5272","F9",44,48,92,0.521739130434783,0.478260869565217,1
"5273","FA2H",8,12,20,0.6,0.4,1
"5274","FAAH",19,25,44,0.568181818181818,0.431818181818182,1
"5275","FAAH2",27,41,68,0.602941176470588,0.397058823529412,1
"5276","FAAP100",25,36,61,0.590163934426229,0.409836065573771,1
"5277","FAAP20",6,6,12,0.5,0.5,1
"5278","FAAP24",9,18,27,0.666666666666667,0.333333333333333,1
"5279","FABP1",4,17,21,0.80952380952381,0.19047619047619,1
"5280","FABP12",9,10,19,0.526315789473684,0.473684210526316,1
"5281","FABP2",6,16,22,0.727272727272727,0.272727272727273,1
"5282","FABP3",3,5,8,0.625,0.375,1
"5283","FABP4",5,8,13,0.615384615384615,0.384615384615385,1
"5284","FABP5",4,4,8,0.5,0.5,1
"5285","FABP6",6,14,20,0.7,0.3,1
"5286","FABP7",6,6,12,0.5,0.5,1
"5287","FABP9",7,13,20,0.65,0.35,1
"5288","FADD",7,13,20,0.65,0.35,1
"5289","FADS1",6,13,19,0.684210526315789,0.315789473684211,1
"5290","FADS2",18,22,40,0.55,0.45,1
"5291","FADS3",15,22,37,0.594594594594595,0.405405405405405,1
"5292","FADS6",12,10,22,0.454545454545455,0.545454545454545,1
"5293","FAF1",21,41,62,0.661290322580645,0.338709677419355,1
"5294","FAF2",17,23,40,0.575,0.425,1
"5295","FAH",12,20,32,0.625,0.375,1
"5296","FAHD1",4,1,5,0.2,0.8,1
"5297","FAHD2A",21,12,33,0.363636363636364,0.636363636363636,1
"5298","FAHD2B",23,27,50,0.54,0.46,1
"5299","FAIM",4,7,11,0.636363636363636,0.363636363636364,1
"5300","FAIM2",14,15,29,0.517241379310345,0.482758620689655,1
"5301","FAM102A",13,20,33,0.606060606060606,0.393939393939394,1
"5302","FAM102B",3,10,13,0.769230769230769,0.230769230769231,1
"5303","FAM104A",3,18,21,0.857142857142857,0.142857142857143,1
"5304","FAM104B",6,4,10,0.4,0.6,1
"5305","FAM107A",4,8,12,0.666666666666667,0.333333333333333,1
"5306","FAM107B",13,26,39,0.666666666666667,0.333333333333333,1
"5307","FAM110A",5,9,14,0.642857142857143,0.357142857142857,1
"5308","FAM110B",25,30,55,0.545454545454545,0.454545454545455,1
"5309","FAM110C",10,14,24,0.583333333333333,0.416666666666667,1
"5310","FAM110D",2,7,9,0.777777777777778,0.222222222222222,1
"5311","FAM111A",17,28,45,0.622222222222222,0.377777777777778,1
"5312","FAM111B",24,39,63,0.619047619047619,0.380952380952381,1
"5313","FAM114A1",25,31,56,0.553571428571429,0.446428571428571,1
"5314","FAM114A2",16,27,43,0.627906976744186,0.372093023255814,1
"5315","FAM117A",16,24,40,0.6,0.4,1
"5316","FAM117B",13,26,39,0.666666666666667,0.333333333333333,1
"5317","FAM118A",12,19,31,0.612903225806452,0.387096774193548,1
"5318","FAM118B",13,16,29,0.551724137931034,0.448275862068966,1
"5319","FAM120A",27,65,92,0.706521739130435,0.293478260869565,1
"5320","FAM120AOS",3,11,14,0.785714285714286,0.214285714285714,1
"5321","FAM120B",38,42,80,0.525,0.475,1
"5322","FAM120C",51,39,90,0.433333333333333,0.566666666666667,1
"5323","FAM122A",6,9,15,0.6,0.4,1
"5324","FAM122B",10,3,13,0.230769230769231,0.769230769230769,1
"5325","FAM122C",8,6,14,0.428571428571429,0.571428571428571,1
"5326","FAM124A",16,36,52,0.692307692307692,0.307692307692308,1
"5327","FAM124B",13,26,39,0.666666666666667,0.333333333333333,1
"5328","FAM126A",15,32,47,0.680851063829787,0.319148936170213,1
"5329","FAM126B",12,20,32,0.625,0.375,1
"5330","FAM131A",5,18,23,0.782608695652174,0.217391304347826,1
"5331","FAM131B",28,33,61,0.540983606557377,0.459016393442623,1
"5332","FAM131C",6,10,16,0.625,0.375,1
"5333","FAM133A",28,34,62,0.548387096774194,0.451612903225806,1
"5334","FAM133B",7,7,14,0.5,0.5,1
"5335","FAM135A",39,72,111,0.648648648648649,0.351351351351351,1
"5336","FAM135B",187,445,632,0.704113924050633,0.295886075949367,1
"5337","FAM136A",2,10,12,0.833333333333333,0.166666666666667,1
"5338","FAM136BP",0,1,1,1,0,1
"5339","FAM13A",32,62,94,0.659574468085106,0.340425531914894,1
"5340","FAM13B",32,33,65,0.507692307692308,0.492307692307692,1
"5341","FAM13C",38,74,112,0.660714285714286,0.339285714285714,1
"5342","FAM149A",23,25,48,0.520833333333333,0.479166666666667,1
"5343","FAM149B1",0,2,2,1,0,1
"5344","FAM151A",19,46,65,0.707692307692308,0.292307692307692,1
"5345","FAM151B",8,16,24,0.666666666666667,0.333333333333333,1
"5346","FAM153A",8,24,32,0.75,0.25,1
"5347","FAM153B",21,36,57,0.631578947368421,0.368421052631579,1
"5348","FAM153CP",3,8,11,0.727272727272727,0.272727272727273,1
"5349","FAM155A",40,60,100,0.6,0.4,1
"5350","FAM155B",17,20,37,0.540540540540541,0.459459459459459,1
"5351","FAM160A1",1,1,2,0.5,0.5,1
"5352","FAM160A2",32,59,91,0.648351648351648,0.351648351648352,1
"5353","FAM160B1",23,47,70,0.671428571428571,0.328571428571429,1
"5354","FAM160B2",18,26,44,0.590909090909091,0.409090909090909,1
"5355","FAM161A",19,46,65,0.707692307692308,0.292307692307692,1
"5356","FAM161B",21,35,56,0.625,0.375,1
"5357","FAM162A",7,5,12,0.416666666666667,0.583333333333333,1
"5358","FAM162B",7,8,15,0.533333333333333,0.466666666666667,1
"5359","FAM163A",8,11,19,0.578947368421053,0.421052631578947,1
"5360","FAM163B",11,15,26,0.576923076923077,0.423076923076923,1
"5361","FAM166A",18,22,40,0.55,0.45,1
"5362","FAM166B",4,6,10,0.6,0.4,1
"5363","FAM166C",7,7,14,0.5,0.5,1
"5364","FAM167A",9,17,26,0.653846153846154,0.346153846153846,1
"5365","FAM167B",5,14,19,0.736842105263158,0.263157894736842,1
"5366","FAM168A",5,8,13,0.615384615384615,0.384615384615385,1
"5367","FAM168B",6,15,21,0.714285714285714,0.285714285714286,1
"5368","FAM169A",23,42,65,0.646153846153846,0.353846153846154,1
"5369","FAM169B",16,24,40,0.6,0.4,1
"5370","FAM170A",33,45,78,0.576923076923077,0.423076923076923,1
"5371","FAM170B",0,2,2,1,0,1
"5372","FAM171A1",44,95,139,0.683453237410072,0.316546762589928,1
"5373","FAM171B",38,87,125,0.696,0.304,1
"5374","FAM172A",15,18,33,0.545454545454545,0.454545454545455,1
"5375","FAM174A",4,19,23,0.826086956521739,0.173913043478261,1
"5376","FAM174B",2,4,6,0.666666666666667,0.333333333333333,1
"5377","FAM174C",0,1,1,1,0,1
"5378","FAM177A1",4,3,7,0.428571428571429,0.571428571428571,1
"5379","FAM177B",5,11,16,0.6875,0.3125,1
"5380","FAM178B",7,1,8,0.125,0.875,1
"5381","FAM180A",13,13,26,0.5,0.5,1
"5382","FAM181A",16,32,48,0.666666666666667,0.333333333333333,1
"5383","FAM181B",7,6,13,0.461538461538462,0.538461538461538,1
"5384","FAM182A",0,3,3,1,0,1
"5385","FAM182B",0,2,2,1,0,1
"5386","FAM183A",2,5,7,0.714285714285714,0.285714285714286,1
"5387","FAM183BP",20,38,58,0.655172413793103,0.344827586206897,1
"5388","FAM184A",58,109,167,0.652694610778443,0.347305389221557,1
"5389","FAM184B",3,5,8,0.625,0.375,1
"5390","FAM185A",0,1,1,1,0,1
"5391","FAM186A",3,15,18,0.833333333333333,0.166666666666667,1
"5392","FAM186B",36,24,60,0.4,0.6,1
"5393","FAM187A",0,1,1,1,0,1
"5394","FAM187B",21,16,37,0.432432432432432,0.567567567567568,1
"5395","FAM189A2",12,31,43,0.720930232558139,0.27906976744186,1
"5396","FAM189B",24,23,47,0.48936170212766,0.51063829787234,1
"5397","FAM193A",49,75,124,0.604838709677419,0.395161290322581,1
"5398","FAM193B",7,14,21,0.666666666666667,0.333333333333333,1
"5399","FAM199X",23,13,36,0.361111111111111,0.638888888888889,1
"5400","FAM200A",4,12,16,0.75,0.25,1
"5401","FAM200B",0,5,5,1,0,1
"5402","FAM204A",8,10,18,0.555555555555556,0.444444444444444,1
"5403","FAM205A",1,7,8,0.875,0.125,1
"5404","FAM205BP",0,1,1,1,0,1
"5405","FAM207A",6,5,11,0.454545454545455,0.545454545454545,1
"5406","FAM209A",12,13,25,0.52,0.48,1
"5407","FAM209B",16,26,42,0.619047619047619,0.380952380952381,1
"5408","FAM20A",17,30,47,0.638297872340426,0.361702127659574,1
"5409","FAM20B",12,23,35,0.657142857142857,0.342857142857143,1
"5410","FAM20C",4,3,7,0.428571428571429,0.571428571428571,1
"5411","FAM210A",4,18,22,0.818181818181818,0.181818181818182,1
"5412","FAM210B",5,3,8,0.375,0.625,1
"5413","FAM214A",43,62,105,0.59047619047619,0.40952380952381,1
"5414","FAM214B",33,31,64,0.484375,0.515625,1
"5415","FAM216A",9,8,17,0.470588235294118,0.529411764705882,1
"5416","FAM216B",5,13,18,0.722222222222222,0.277777777777778,1
"5417","FAM217A",19,42,61,0.688524590163934,0.311475409836066,1
"5418","FAM217B",16,29,45,0.644444444444444,0.355555555555556,1
"5419","FAM219A",5,17,22,0.772727272727273,0.227272727272727,1
"5420","FAM219B",1,2,3,0.666666666666667,0.333333333333333,1
"5421","FAM21FP",9,16,25,0.64,0.36,1
"5422","FAM220A",9,17,26,0.653846153846154,0.346153846153846,1
"5423","FAM220BP",0,7,7,1,0,1
"5424","FAM221A",15,14,29,0.482758620689655,0.517241379310345,1
"5425","FAM221B",6,24,30,0.8,0.2,1
"5426","FAM222A",6,13,19,0.684210526315789,0.315789473684211,1
"5427","FAM222B",16,23,39,0.58974358974359,0.41025641025641,1
"5428","FAM227A",0,2,2,1,0,1
"5429","FAM227B",30,52,82,0.634146341463415,0.365853658536585,1
"5430","FAM228A",4,10,14,0.714285714285714,0.285714285714286,1
"5431","FAM228B",0,3,3,1,0,1
"5432","FAM229B",2,6,8,0.75,0.25,1
"5433","FAM234A",17,28,45,0.622222222222222,0.377777777777778,1
"5434","FAM234B",22,44,66,0.666666666666667,0.333333333333333,1
"5435","FAM237A",10,24,34,0.705882352941177,0.294117647058824,1
"5436","FAM241A",5,4,9,0.444444444444444,0.555555555555556,1
"5437","FAM241B",6,10,16,0.625,0.375,1
"5438","FAM24A",10,9,19,0.473684210526316,0.526315789473684,1
"5439","FAM24B",8,3,11,0.272727272727273,0.727272727272727,1
"5440","FAM27E5",15,22,37,0.594594594594595,0.405405405405405,1
"5441","FAM32A",5,8,13,0.615384615384615,0.384615384615385,1
"5442","FAM3A",10,8,18,0.444444444444444,0.555555555555556,1
"5443","FAM3B",9,15,24,0.625,0.375,1
"5444","FAM3C",8,13,21,0.619047619047619,0.380952380952381,1
"5445","FAM3D",19,12,31,0.387096774193548,0.612903225806452,1
"5446","FAM43A",13,6,19,0.315789473684211,0.684210526315789,1
"5447","FAM43B",2,8,10,0.8,0.2,1
"5448","FAM47A",168,135,303,0.445544554455446,0.554455445544555,1
"5449","FAM47B",99,95,194,0.489690721649485,0.510309278350515,1
"5450","FAM47C",175,169,344,0.491279069767442,0.508720930232558,1
"5451","FAM47E",0,1,1,1,0,1
"5452","FAM47E-STBD1",0,1,1,1,0,1
"5453","FAM50A",10,11,21,0.523809523809524,0.476190476190476,1
"5454","FAM50B",16,36,52,0.692307692307692,0.307692307692308,1
"5455","FAM53A",13,14,27,0.518518518518518,0.481481481481481,1
"5456","FAM53B",9,19,28,0.678571428571429,0.321428571428571,1
"5457","FAM53C",22,28,50,0.56,0.44,1
"5458","FAM71A",32,74,106,0.69811320754717,0.30188679245283,1
"5459","FAM71B",74,98,172,0.569767441860465,0.430232558139535,1
"5460","FAM71C",23,25,48,0.520833333333333,0.479166666666667,1
"5461","FAM71D",10,18,28,0.642857142857143,0.357142857142857,1
"5462","FAM71E1",8,10,18,0.555555555555556,0.444444444444444,1
"5463","FAM71E2",0,2,2,1,0,1
"5464","FAM71F1",20,13,33,0.393939393939394,0.606060606060606,1
"5465","FAM71F2",7,17,24,0.708333333333333,0.291666666666667,1
"5466","FAM72A",1,11,12,0.916666666666667,0.0833333333333333,1
"5467","FAM72C",0,4,4,1,0,1
"5468","FAM74A3",13,28,41,0.682926829268293,0.317073170731707,1
"5469","FAM76A",9,14,23,0.608695652173913,0.391304347826087,1
"5470","FAM76B",8,18,26,0.692307692307692,0.307692307692308,1
"5471","FAM78A",15,16,31,0.516129032258065,0.483870967741935,1
"5472","FAM78B",24,23,47,0.48936170212766,0.51063829787234,1
"5473","FAM81A",16,17,33,0.515151515151515,0.484848484848485,1
"5474","FAM81B",19,38,57,0.666666666666667,0.333333333333333,1
"5475","FAM83A",17,33,50,0.66,0.34,1
"5476","FAM83B",90,171,261,0.655172413793103,0.344827586206897,1
"5477","FAM83C",44,67,111,0.603603603603604,0.396396396396396,1
"5478","FAM83D",26,39,65,0.6,0.4,1
"5479","FAM83E",19,43,62,0.693548387096774,0.306451612903226,1
"5480","FAM83F",22,30,52,0.576923076923077,0.423076923076923,1
"5481","FAM83G",25,54,79,0.683544303797468,0.316455696202532,1
"5482","FAM83H",42,77,119,0.647058823529412,0.352941176470588,1
"5483","FAM86B1",6,3,9,0.333333333333333,0.666666666666667,1
"5484","FAM86B2",1,0,1,0,1,1
"5485","FAM86C1P",8,5,13,0.384615384615385,0.615384615384615,1
"5486","FAM89A",3,5,8,0.625,0.375,1
"5487","FAM89B",7,6,13,0.461538461538462,0.538461538461538,1
"5488","FAM8A1",10,15,25,0.6,0.4,1
"5489","FAM90A1",30,60,90,0.666666666666667,0.333333333333333,1
"5490","FAM91A1",31,54,85,0.635294117647059,0.364705882352941,1
"5491","FAM98A",23,26,49,0.530612244897959,0.469387755102041,1
"5492","FAM98B",7,12,19,0.631578947368421,0.368421052631579,1
"5493","FAM98C",7,20,27,0.740740740740741,0.259259259259259,1
"5494","FAM9A",37,15,52,0.288461538461538,0.711538461538462,1
"5495","FAM9B",13,17,30,0.566666666666667,0.433333333333333,1
"5496","FAM9C",11,6,17,0.352941176470588,0.647058823529412,1
"5497","FAN1",35,50,85,0.588235294117647,0.411764705882353,1
"5498","FANCA",28,72,100,0.72,0.28,1
"5499","FANCB",41,27,68,0.397058823529412,0.602941176470588,1
"5500","FANCC",17,25,42,0.595238095238095,0.404761904761905,1
"5501","FANCD2",45,74,119,0.621848739495798,0.378151260504202,1
"5502","FANCD2OS",10,10,20,0.5,0.5,1
"5503","FANCE",16,23,39,0.58974358974359,0.41025641025641,1
"5504","FANCF",10,14,24,0.583333333333333,0.416666666666667,1
"5505","FANCG",15,27,42,0.642857142857143,0.357142857142857,1
"5506","FANCI",34,65,99,0.656565656565657,0.343434343434343,1
"5507","FANCL",13,20,33,0.606060606060606,0.393939393939394,1
"5508","FANCM",101,126,227,0.555066079295154,0.444933920704846,1
"5509","FANK1",18,29,47,0.617021276595745,0.382978723404255,0.44
"5510","FAP",39,86,125,0.688,0.312,1
"5511","FAR1",16,31,47,0.659574468085106,0.340425531914894,0.77
"5512","FAR2",17,37,54,0.685185185185185,0.314814814814815,0.77
"5513","FARP1",54,53,107,0.495327102803738,0.504672897196262,0.77
"5514","FARP2",21,50,71,0.704225352112676,0.295774647887324,0.77
"5515","FARS2",18,28,46,0.608695652173913,0.391304347826087,0.77
"5516","FARSA",17,35,52,0.673076923076923,0.326923076923077,0.77
"5517","FARSB",17,34,51,0.666666666666667,0.333333333333333,0.77
"5518","FAS",12,21,33,0.636363636363636,0.363636363636364,1
"5519","FASLG",25,29,54,0.537037037037037,0.462962962962963,1
"5520","FASN",71,104,175,0.594285714285714,0.405714285714286,1
"5521","FASTK",19,19,38,0.5,0.5,1
"5522","FASTKD1",31,52,83,0.626506024096386,0.373493975903614,1
"5523","FASTKD2",16,36,52,0.692307692307692,0.307692307692308,1
"5524","FASTKD3",45,58,103,0.563106796116505,0.436893203883495,1
"5525","FASTKD5",20,41,61,0.672131147540984,0.327868852459016,1
"5526","FAT1",261,364,625,0.5824,0.4176,1
"5527","FAT2",198,289,487,0.593429158110883,0.406570841889117,1
"5528","FAT3",299,623,922,0.675704989154013,0.324295010845987,1
"5529","FAT4",414,682,1096,0.622262773722628,0.377737226277372,1
"5530","FATE1",18,18,36,0.5,0.5,1
"5531","FAU",8,10,18,0.555555555555556,0.444444444444444,1
"5532","FAXC",16,18,34,0.529411764705882,0.470588235294118,1
"5533","FAXDC2",8,9,17,0.529411764705882,0.470588235294118,1
"5534","FBF1",25,45,70,0.642857142857143,0.357142857142857,1
"5535","FBH1",33,67,100,0.67,0.33,1
"5536","FBL",22,15,37,0.405405405405405,0.594594594594595,1
"5537","FBLIM1",15,32,47,0.680851063829787,0.319148936170213,1
"5538","FBLL1",4,9,13,0.692307692307692,0.307692307692308,1
"5539","FBLN1",33,55,88,0.625,0.375,1
"5540","FBLN2",32,71,103,0.689320388349515,0.310679611650485,1
"5541","FBLN5",16,41,57,0.719298245614035,0.280701754385965,1
"5542","FBLN7",22,36,58,0.620689655172414,0.379310344827586,1
"5543","FBN1",134,231,365,0.632876712328767,0.367123287671233,1
"5544","FBN2",190,291,481,0.604989604989605,0.395010395010395,1
"5545","FBN3",132,209,341,0.612903225806452,0.387096774193548,1
"5546","FBP1",14,9,23,0.391304347826087,0.608695652173913,1
"5547","FBP2",25,14,39,0.358974358974359,0.641025641025641,1
"5548","FBRS",5,13,18,0.722222222222222,0.277777777777778,1
"5549","FBRSL1",1,2,3,0.666666666666667,0.333333333333333,1
"5550","FBXL12",9,13,22,0.590909090909091,0.409090909090909,1
"5551","FBXL13",37,44,81,0.54320987654321,0.45679012345679,1
"5552","FBXL14",14,10,24,0.416666666666667,0.583333333333333,1
"5553","FBXL15",2,3,5,0.6,0.4,1
"5554","FBXL16",8,23,31,0.741935483870968,0.258064516129032,1
"5555","FBXL17",17,17,34,0.5,0.5,1
"5556","FBXL18",21,33,54,0.611111111111111,0.388888888888889,1
"5557","FBXL19",15,23,38,0.605263157894737,0.394736842105263,1
"5558","FBXL2",14,23,37,0.621621621621622,0.378378378378378,1
"5559","FBXL20",26,25,51,0.490196078431373,0.509803921568627,1
"5560","FBXL21P",16,25,41,0.609756097560976,0.390243902439024,1
"5561","FBXL22",5,6,11,0.545454545454545,0.454545454545455,1
"5562","FBXL3",16,23,39,0.58974358974359,0.41025641025641,1
"5563","FBXL4",16,40,56,0.714285714285714,0.285714285714286,1
"5564","FBXL5",15,31,46,0.673913043478261,0.326086956521739,1
"5565","FBXL6",9,22,31,0.709677419354839,0.290322580645161,1
"5566","FBXL7",58,113,171,0.660818713450292,0.339181286549708,1
"5567","FBXL8",0,6,6,1,0,1
"5568","FBXO10",31,40,71,0.563380281690141,0.436619718309859,1
"5569","FBXO11",40,38,78,0.487179487179487,0.512820512820513,1
"5570","FBXO15",27,43,70,0.614285714285714,0.385714285714286,1
"5571","FBXO16",14,17,31,0.548387096774194,0.451612903225806,1
"5572","FBXO17",8,7,15,0.466666666666667,0.533333333333333,1
"5573","FBXO2",3,9,12,0.75,0.25,1
"5574","FBXO21",35,34,69,0.492753623188406,0.507246376811594,1
"5575","FBXO22",21,28,49,0.571428571428571,0.428571428571429,1
"5576","FBXO24",48,43,91,0.472527472527473,0.527472527472527,1
"5577","FBXO25",5,19,24,0.791666666666667,0.208333333333333,1
"5578","FBXO27",8,21,29,0.724137931034483,0.275862068965517,1
"5579","FBXO28",20,22,42,0.523809523809524,0.476190476190476,1
"5580","FBXO3",13,24,37,0.648648648648649,0.351351351351351,1
"5581","FBXO30",23,47,70,0.671428571428571,0.328571428571429,1
"5582","FBXO31",24,36,60,0.6,0.4,1
"5583","FBXO32",17,18,35,0.514285714285714,0.485714285714286,1
"5584","FBXO33",6,18,24,0.75,0.25,1
"5585","FBXO34",38,49,87,0.563218390804598,0.436781609195402,1
"5586","FBXO36",11,8,19,0.421052631578947,0.578947368421053,1
"5587","FBXO38",41,56,97,0.577319587628866,0.422680412371134,1
"5588","FBXO39",10,26,36,0.722222222222222,0.277777777777778,1
"5589","FBXO4",19,22,41,0.536585365853659,0.463414634146341,1
"5590","FBXO40",54,77,131,0.587786259541985,0.412213740458015,1
"5591","FBXO41",17,23,40,0.575,0.425,1
"5592","FBXO42",25,54,79,0.683544303797468,0.316455696202532,1
"5593","FBXO43",35,54,89,0.606741573033708,0.393258426966292,1
"5594","FBXO44",10,14,24,0.583333333333333,0.416666666666667,1
"5595","FBXO45",11,8,19,0.421052631578947,0.578947368421053,1
"5596","FBXO46",15,26,41,0.634146341463415,0.365853658536585,1
"5597","FBXO47",31,35,66,0.53030303030303,0.46969696969697,1
"5598","FBXO48",8,15,23,0.652173913043478,0.347826086956522,1
"5599","FBXO5",12,25,37,0.675675675675676,0.324324324324324,1
"5600","FBXO6",8,11,19,0.578947368421053,0.421052631578947,1
"5601","FBXO7",17,28,45,0.622222222222222,0.377777777777778,1
"5602","FBXO8",13,21,34,0.617647058823529,0.382352941176471,1
"5603","FBXO9",18,14,32,0.4375,0.5625,1
"5604","FBXW10",34,61,95,0.642105263157895,0.357894736842105,1
"5605","FBXW11",18,36,54,0.666666666666667,0.333333333333333,1
"5606","FBXW12",16,32,48,0.666666666666667,0.333333333333333,1
"5607","FBXW2",13,14,27,0.518518518518518,0.481481481481481,1
"5608","FBXW4",15,14,29,0.482758620689655,0.517241379310345,1
"5609","FBXW5",17,16,33,0.484848484848485,0.515151515151515,1
"5610","FBXW7",136,169,305,0.554098360655738,0.445901639344262,1
"5611","FBXW8",10,22,32,0.6875,0.3125,1
"5612","FBXW9",18,12,30,0.4,0.6,1
"5613","FCAMR",15,18,33,0.545454545454545,0.454545454545455,1
"5614","FCAR",18,50,68,0.735294117647059,0.264705882352941,0.77
"5615","FCER1A",20,43,63,0.682539682539683,0.317460317460317,1
"5616","FCER1G",3,7,10,0.7,0.3,1
"5617","FCER2",12,18,30,0.6,0.4,1
"5618","FCF1",4,9,13,0.692307692307692,0.307692307692308,1
"5619","FCGBP",155,330,485,0.680412371134021,0.319587628865979,1
"5620","FCGR1A",15,34,49,0.693877551020408,0.306122448979592,1
"5621","FCGR2A",19,21,40,0.525,0.475,1
"5622","FCGR2B",14,19,33,0.575757575757576,0.424242424242424,1
"5623","FCGR2C",14,16,30,0.533333333333333,0.466666666666667,1
"5624","FCGR3A",9,34,43,0.790697674418605,0.209302325581395,1
"5625","FCGR3B",13,32,45,0.711111111111111,0.288888888888889,1
"5626","FCGRT",12,26,38,0.684210526315789,0.315789473684211,1
"5627","FCHO1",34,63,97,0.649484536082474,0.350515463917526,1
"5628","FCHO2",32,37,69,0.536231884057971,0.463768115942029,1
"5629","FCHSD1",23,22,45,0.488888888888889,0.511111111111111,1
"5630","FCHSD2",16,24,40,0.6,0.4,1
"5631","FCMR",18,19,37,0.513513513513513,0.486486486486487,1
"5632","FCN1",39,35,74,0.472972972972973,0.527027027027027,1
"5633","FCN2",28,33,61,0.540983606557377,0.459016393442623,1
"5634","FCN3",6,23,29,0.793103448275862,0.206896551724138,1
"5635","FCRL1",42,83,125,0.664,0.336,1
"5636","FCRL2",48,54,102,0.529411764705882,0.470588235294118,1
"5637","FCRL3",54,118,172,0.686046511627907,0.313953488372093,1
"5638","FCRL4",31,75,106,0.707547169811321,0.292452830188679,1
"5639","FCRL5",88,148,236,0.627118644067797,0.372881355932203,1
"5640","FCRL6",13,47,60,0.783333333333333,0.216666666666667,1
"5641","FCRLA",21,52,73,0.712328767123288,0.287671232876712,1
"5642","FCRLB",12,22,34,0.647058823529412,0.352941176470588,1
"5643","FCSK",27,32,59,0.542372881355932,0.457627118644068,1
"5644","FDCSP",4,15,19,0.789473684210526,0.210526315789474,1
"5645","FDFT1",10,12,22,0.545454545454545,0.454545454545455,1
"5646","FDPS",18,31,49,0.63265306122449,0.36734693877551,1
"5647","FDX1",4,7,11,0.636363636363636,0.363636363636364,1
"5648","FDX2",10,9,19,0.473684210526316,0.526315789473684,1
"5649","FDXACB1",10,13,23,0.565217391304348,0.434782608695652,1
"5650","FDXR",14,31,45,0.688888888888889,0.311111111111111,1
"5651","FECH",7,32,39,0.82051282051282,0.179487179487179,1
"5652","FEM1A",23,18,41,0.439024390243902,0.560975609756098,1
"5653","FEM1B",17,23,40,0.575,0.425,1
"5654","FEM1C",16,18,34,0.529411764705882,0.470588235294118,1
"5655","FEN1",13,15,28,0.535714285714286,0.464285714285714,1
"5656","FER",43,62,105,0.59047619047619,0.40952380952381,1
"5657","FER1L5",26,54,80,0.675,0.325,1
"5658","FER1L6",133,232,365,0.635616438356164,0.364383561643836,1
"5659","FERD3L",31,44,75,0.586666666666667,0.413333333333333,1
"5660","FERMT1",32,45,77,0.584415584415584,0.415584415584416,1
"5661","FERMT2",22,33,55,0.6,0.4,1
"5662","FERMT3",25,39,64,0.609375,0.390625,1
"5663","FES",21,45,66,0.681818181818182,0.318181818181818,1
"5664","FETUB",23,56,79,0.708860759493671,0.291139240506329,1
"5665","FEV",9,2,11,0.181818181818182,0.818181818181818,1
"5666","FEZ1",20,25,45,0.555555555555556,0.444444444444444,1
"5667","FEZ2",5,17,22,0.772727272727273,0.227272727272727,1
"5668","FEZF1",19,47,66,0.712121212121212,0.287878787878788,1
"5669","FEZF2",20,33,53,0.622641509433962,0.377358490566038,1
"5670","FFAR1",17,19,36,0.527777777777778,0.472222222222222,0.77
"5671","FFAR2",10,21,31,0.67741935483871,0.32258064516129,0.77
"5672","FFAR3",12,39,51,0.764705882352941,0.235294117647059,0.77
"5673","FFAR4",16,23,39,0.58974358974359,0.41025641025641,0.77
"5674","FGA",50,137,187,0.732620320855615,0.267379679144385,1
"5675","FGB",22,51,73,0.698630136986301,0.301369863013699,1
"5676","FGD1",63,32,95,0.336842105263158,0.663157894736842,1
"5677","FGD2",25,55,80,0.6875,0.3125,1
"5678","FGD3",43,33,76,0.434210526315789,0.565789473684211,1
"5679","FGD4",32,36,68,0.529411764705882,0.470588235294118,1
"5680","FGD5",66,93,159,0.584905660377358,0.415094339622642,1
"5681","FGD6",62,96,158,0.607594936708861,0.392405063291139,1
"5682","FGF1",3,14,17,0.823529411764706,0.176470588235294,1
"5683","FGF10",20,28,48,0.583333333333333,0.416666666666667,1
"5684","FGF11",4,7,11,0.636363636363636,0.363636363636364,1
"5685","FGF12",27,40,67,0.597014925373134,0.402985074626866,1
"5686","FGF13",44,32,76,0.421052631578947,0.578947368421053,1
"5687","FGF14",22,42,64,0.65625,0.34375,1
"5688","FGF16",9,14,23,0.608695652173913,0.391304347826087,1
"5689","FGF17",8,10,18,0.555555555555556,0.444444444444444,1
"5690","FGF18",11,14,25,0.56,0.44,1
"5691","FGF19",3,17,20,0.85,0.15,1
"5692","FGF2",10,11,21,0.523809523809524,0.476190476190476,1
"5693","FGF20",10,13,23,0.565217391304348,0.434782608695652,1
"5694","FGF21",4,12,16,0.75,0.25,1
"5695","FGF22",2,4,6,0.666666666666667,0.333333333333333,1
"5696","FGF23",30,36,66,0.545454545454545,0.454545454545455,1
"5697","FGF3",16,15,31,0.483870967741935,0.516129032258065,1
"5698","FGF4",6,6,12,0.5,0.5,1
"5699","FGF5",23,39,62,0.629032258064516,0.370967741935484,1
"5700","FGF6",19,32,51,0.627450980392157,0.372549019607843,1
"5701","FGF7",10,21,31,0.67741935483871,0.32258064516129,1
"5702","FGF8",7,14,21,0.666666666666667,0.333333333333333,1
"5703","FGF9",14,21,35,0.6,0.4,1
"5704","FGFBP1",20,18,38,0.473684210526316,0.526315789473684,1
"5705","FGFBP2",4,13,17,0.764705882352941,0.235294117647059,1
"5706","FGFBP3",2,3,5,0.6,0.4,1
"5707","FGFR1",32,47,79,0.594936708860759,0.40506329113924,1
"5708","FGFR1OP2",3,6,9,0.666666666666667,0.333333333333333,1
"5709","FGFR2",51,94,145,0.648275862068965,0.351724137931034,1
"5710","FGFR3",20,58,78,0.743589743589744,0.256410256410256,1
"5711","FGFR4",37,53,90,0.588888888888889,0.411111111111111,1
"5712","FGFRL1",21,31,52,0.596153846153846,0.403846153846154,1
"5713","FGG",21,41,62,0.661290322580645,0.338709677419355,1
"5714","FGGY",20,38,58,0.655172413793103,0.344827586206897,1
"5715","FGL1",17,19,36,0.527777777777778,0.472222222222222,1
"5716","FGL2",12,38,50,0.76,0.24,1
"5717","FGR",14,32,46,0.695652173913043,0.304347826086957,1
"5718","FH",19,33,52,0.634615384615385,0.365384615384615,1
"5719","FHAD1",2,3,5,0.6,0.4,1
"5720","FHDC1",53,87,140,0.621428571428571,0.378571428571429,1
"5721","FHIT",6,15,21,0.714285714285714,0.285714285714286,1
"5722","FHL1",19,12,31,0.387096774193548,0.612903225806452,1
"5723","FHL2",10,6,16,0.375,0.625,1
"5724","FHL3",6,14,20,0.7,0.3,1
"5725","FHL5",29,57,86,0.662790697674419,0.337209302325581,1
"5726","FHOD1",36,57,93,0.612903225806452,0.387096774193548,1
"5727","FHOD3",96,114,210,0.542857142857143,0.457142857142857,1
"5728","FIBCD1",25,20,45,0.444444444444444,0.555555555555556,1
"5729","FIBIN",7,21,28,0.75,0.25,1
"5730","FIBP",12,10,22,0.454545454545455,0.545454545454545,1
"5731","FICD",12,8,20,0.4,0.6,1
"5732","FIG4",33,43,76,0.565789473684211,0.434210526315789,1
"5733","FIGLA",6,7,13,0.538461538461538,0.461538461538462,1
"5734","FIGN",68,74,142,0.52112676056338,0.47887323943662,1
"5735","FIGNL1",24,51,75,0.68,0.32,1
"5736","FIGNL2",7,9,16,0.5625,0.4375,1
"5737","FILIP1",68,141,209,0.674641148325359,0.325358851674641,1
"5738","FILIP1L",52,63,115,0.547826086956522,0.452173913043478,1
"5739","FIP1L1",27,45,72,0.625,0.375,1
"5740","FIS1",2,8,10,0.8,0.2,1
"5741","FITM1",4,18,22,0.818181818181818,0.181818181818182,1
"5742","FITM2",11,6,17,0.352941176470588,0.647058823529412,1
"5743","FIZ1",16,25,41,0.609756097560976,0.390243902439024,1
"5744","FJX1",10,7,17,0.411764705882353,0.588235294117647,1
"5745","FKBP10",24,25,49,0.510204081632653,0.489795918367347,1
"5746","FKBP11",6,18,24,0.75,0.25,1
"5747","FKBP14",7,12,19,0.631578947368421,0.368421052631579,1
"5748","FKBP15",32,54,86,0.627906976744186,0.372093023255814,1
"5749","FKBP1A",5,4,9,0.444444444444444,0.555555555555556,1
"5750","FKBP1B",0,4,4,1,0,1
"5751","FKBP1C",1,0,1,0,1,1
"5752","FKBP2",3,5,8,0.625,0.375,1
"5753","FKBP3",4,13,17,0.764705882352941,0.235294117647059,1
"5754","FKBP4",14,23,37,0.621621621621622,0.378378378378378,1
"5755","FKBP5",13,37,50,0.74,0.26,1
"5756","FKBP6",29,32,61,0.524590163934426,0.475409836065574,1
"5757","FKBP7",5,10,15,0.666666666666667,0.333333333333333,1
"5758","FKBP8",13,28,41,0.682926829268293,0.317073170731707,1
"5759","FKBP9",28,39,67,0.582089552238806,0.417910447761194,1
"5760","FKBPL",23,21,44,0.477272727272727,0.522727272727273,1
"5761","FKRP",11,9,20,0.45,0.55,1
"5762","FKTN",13,26,39,0.666666666666667,0.333333333333333,1
"5763","FLACC1",16,21,37,0.567567567567568,0.432432432432432,1
"5764","FLAD1",15,37,52,0.711538461538462,0.288461538461538,1
"5765","FLCN",42,37,79,0.468354430379747,0.531645569620253,1
"5766","FLG",399,699,1098,0.636612021857924,0.363387978142077,1
"5767","FLG2",158,310,468,0.662393162393162,0.337606837606838,1
"5768","FLI1",28,50,78,0.641025641025641,0.358974358974359,1
"5769","FLII",32,35,67,0.522388059701492,0.477611940298507,1
"5770","FLNA",174,88,262,0.33587786259542,0.66412213740458,1
"5771","FLNB",95,148,243,0.609053497942387,0.390946502057613,1
"5772","FLNC",158,250,408,0.612745098039216,0.387254901960784,1
"5773","FLOT1",20,24,44,0.545454545454545,0.454545454545455,1
"5774","FLOT2",13,22,35,0.628571428571429,0.371428571428571,1
"5775","FLRT1",21,35,56,0.625,0.375,1
"5776","FLRT2",77,129,206,0.62621359223301,0.37378640776699,1
"5777","FLRT3",31,51,82,0.621951219512195,0.378048780487805,1
"5778","FLT1",69,130,199,0.653266331658292,0.346733668341709,1
"5779","FLT3",72,95,167,0.568862275449102,0.431137724550898,1
"5780","FLT3LG",5,9,14,0.642857142857143,0.357142857142857,1
"5781","FLT4",75,136,211,0.644549763033175,0.355450236966825,1
"5782","FLVCR1",7,22,29,0.758620689655172,0.241379310344828,1
"5783","FLVCR2",23,22,45,0.488888888888889,0.511111111111111,1
"5784","FLYWCH1",8,31,39,0.794871794871795,0.205128205128205,1
"5785","FLYWCH2",3,4,7,0.571428571428571,0.428571428571429,1
"5786","FMC1",1,1,2,0.5,0.5,1
"5787","FMC1-LUC7L2",6,4,10,0.4,0.6,1
"5788","FMN1",35,34,69,0.492753623188406,0.507246376811594,1
"5789","FMN2",151,306,457,0.669584245076586,0.330415754923414,1
"5790","FMNL1",21,56,77,0.727272727272727,0.272727272727273,1
"5791","FMNL2",34,62,96,0.645833333333333,0.354166666666667,1
"5792","FMNL3",41,60,101,0.594059405940594,0.405940594059406,1
"5793","FMO1",41,69,110,0.627272727272727,0.372727272727273,1
"5794","FMO2",18,69,87,0.793103448275862,0.206896551724138,1
"5795","FMO3",47,73,120,0.608333333333333,0.391666666666667,1
"5796","FMO4",26,53,79,0.670886075949367,0.329113924050633,1
"5797","FMO5",21,38,59,0.644067796610169,0.355932203389831,1
"5798","FMO6P",0,3,3,1,0,1
"5799","FMOD",27,35,62,0.564516129032258,0.435483870967742,1
"5800","FMR1",54,27,81,0.333333333333333,0.666666666666667,1
"5801","FMR1NB",27,27,54,0.5,0.5,1
"5802","FN1",106,169,275,0.614545454545455,0.385454545454545,1
"5803","FN3K",11,10,21,0.476190476190476,0.523809523809524,1
"5804","FN3KRP",11,12,23,0.521739130434783,0.478260869565217,1
"5805","FNBP1",15,36,51,0.705882352941177,0.294117647058824,1
"5806","FNBP1L",17,15,32,0.46875,0.53125,1
"5807","FNBP4",32,75,107,0.700934579439252,0.299065420560748,1
"5808","FNDC1",80,200,280,0.714285714285714,0.285714285714286,1
"5809","FNDC11",10,24,34,0.705882352941177,0.294117647058824,1
"5810","FNDC3A",33,60,93,0.645161290322581,0.354838709677419,1
"5811","FNDC3B",48,62,110,0.563636363636364,0.436363636363636,1
"5812","FNDC4",15,8,23,0.347826086956522,0.652173913043478,1
"5813","FNDC5",7,7,14,0.5,0.5,1
"5814","FNDC7",21,52,73,0.712328767123288,0.287671232876712,1
"5815","FNDC8",11,16,27,0.592592592592593,0.407407407407407,1
"5816","FNIP1",43,68,111,0.612612612612613,0.387387387387387,1
"5817","FNIP2",33,52,85,0.611764705882353,0.388235294117647,1
"5818","FNTA",11,19,30,0.633333333333333,0.366666666666667,1
"5819","FNTB",9,19,28,0.678571428571429,0.321428571428571,1
"5820","FO393400.1",6,3,9,0.333333333333333,0.666666666666667,1
"5821","FOCAD",52,82,134,0.611940298507463,0.388059701492537,1
"5822","FOLH1",64,119,183,0.650273224043716,0.349726775956284,1
"5823","FOLH1B",58,87,145,0.6,0.4,1
"5824","FOLR1",16,18,34,0.529411764705882,0.470588235294118,1
"5825","FOLR2",5,12,17,0.705882352941177,0.294117647058824,1
"5826","FOLR3",24,27,51,0.529411764705882,0.470588235294118,1
"5827","FOS",12,23,35,0.657142857142857,0.342857142857143,1
"5828","FOSB",19,18,37,0.486486486486487,0.513513513513513,1
"5829","FOSL1",14,6,20,0.3,0.7,1
"5830","FOSL2",16,29,45,0.644444444444444,0.355555555555556,1
"5831","FOXA1",18,25,43,0.581395348837209,0.418604651162791,1
"5832","FOXA2",15,25,40,0.625,0.375,1
"5833","FOXA3",9,34,43,0.790697674418605,0.209302325581395,1
"5834","FOXB1",8,15,23,0.652173913043478,0.347826086956522,1
"5835","FOXB2",19,20,39,0.512820512820513,0.487179487179487,1
"5836","FOXC1",12,10,22,0.454545454545455,0.545454545454545,1
"5837","FOXC2",15,31,46,0.673913043478261,0.326086956521739,1
"5838","FOXD1",5,3,8,0.375,0.625,1
"5839","FOXD2",5,12,17,0.705882352941177,0.294117647058824,1
"5840","FOXD3",9,9,18,0.5,0.5,1
"5841","FOXD4",20,15,35,0.428571428571429,0.571428571428571,1
"5842","FOXD4L1",20,25,45,0.555555555555556,0.444444444444444,1
"5843","FOXD4L3",6,18,24,0.75,0.25,1
"5844","FOXD4L4",24,48,72,0.666666666666667,0.333333333333333,1
"5845","FOXD4L5",22,44,66,0.666666666666667,0.333333333333333,1
"5846","FOXD4L6",12,11,23,0.478260869565217,0.521739130434783,1
"5847","FOXE1",11,20,31,0.645161290322581,0.354838709677419,1
"5848","FOXE3",5,7,12,0.583333333333333,0.416666666666667,1
"5849","FOXF1",15,23,38,0.605263157894737,0.394736842105263,1
"5850","FOXF2",15,19,34,0.558823529411765,0.441176470588235,1
"5851","FOXG1",42,67,109,0.614678899082569,0.385321100917431,1
"5852","FOXH1",11,22,33,0.666666666666667,0.333333333333333,1
"5853","FOXI1",34,51,85,0.6,0.4,1
"5854","FOXI2",7,10,17,0.588235294117647,0.411764705882353,1
"5855","FOXI3",0,3,3,1,0,1
"5856","FOXJ1",5,18,23,0.782608695652174,0.217391304347826,1
"5857","FOXJ2",24,32,56,0.571428571428571,0.428571428571429,1
"5858","FOXJ3",21,32,53,0.60377358490566,0.39622641509434,1
"5859","FOXK1",38,38,76,0.5,0.5,1
"5860","FOXK2",20,29,49,0.591836734693878,0.408163265306122,1
"5861","FOXL1",19,18,37,0.486486486486487,0.513513513513513,1
"5862","FOXL2",13,19,32,0.59375,0.40625,1
"5863","FOXL2NB",12,11,23,0.478260869565217,0.521739130434783,1
"5864","FOXM1",27,47,74,0.635135135135135,0.364864864864865,1
"5865","FOXN1",35,33,68,0.485294117647059,0.514705882352941,1
"5866","FOXN2",19,35,54,0.648148148148148,0.351851851851852,1
"5867","FOXN3",24,33,57,0.578947368421053,0.421052631578947,1
"5868","FOXN4",17,14,31,0.451612903225806,0.548387096774194,1
"5869","FOXO1",16,36,52,0.692307692307692,0.307692307692308,1
"5870","FOXO3",18,29,47,0.617021276595745,0.382978723404255,1
"5871","FOXO4",37,15,52,0.288461538461538,0.711538461538462,1
"5872","FOXP1",36,59,95,0.621052631578947,0.378947368421053,1
"5873","FOXP2",47,79,126,0.626984126984127,0.373015873015873,1
"5874","FOXP3",23,9,32,0.28125,0.71875,1
"5875","FOXP4",21,36,57,0.631578947368421,0.368421052631579,1
"5876","FOXQ1",13,15,28,0.535714285714286,0.464285714285714,1
"5877","FOXR1",10,26,36,0.722222222222222,0.277777777777778,1
"5878","FOXR2",22,34,56,0.607142857142857,0.392857142857143,1
"5879","FOXRED1",18,28,46,0.608695652173913,0.391304347826087,1
"5880","FOXRED2",17,45,62,0.725806451612903,0.274193548387097,1
"5881","FOXS1",21,30,51,0.588235294117647,0.411764705882353,1
"5882","FPGS",14,24,38,0.631578947368421,0.368421052631579,1
"5883","FPGT",23,35,58,0.603448275862069,0.396551724137931,1
"5884","FPGT-TNNI3K",42,84,126,0.666666666666667,0.333333333333333,1
"5885","FPR1",27,57,84,0.678571428571429,0.321428571428571,1
"5886","FPR2",25,57,82,0.695121951219512,0.304878048780488,1
"5887","FPR3",21,42,63,0.666666666666667,0.333333333333333,1
"5888","FRA10AC1",5,24,29,0.827586206896552,0.172413793103448,1
"5889","FRAS1",160,278,438,0.634703196347032,0.365296803652968,1
"5890","FRAT1",2,2,4,0.5,0.5,1
"5891","FREM1",120,208,328,0.634146341463415,0.365853658536585,1
"5892","FREM2",149,258,407,0.633906633906634,0.366093366093366,1
"5893","FRG1",12,11,23,0.478260869565217,0.521739130434783,1
"5894","FRG1BP",1,2,3,0.666666666666667,0.333333333333333,1
"5895","FRG2",11,36,47,0.765957446808511,0.234042553191489,1
"5896","FRG2B",16,35,51,0.686274509803922,0.313725490196078,1
"5897","FRG2C",47,79,126,0.626984126984127,0.373015873015873,1
"5898","FRK",24,35,59,0.593220338983051,0.406779661016949,1
"5899","FRMD1",18,37,55,0.672727272727273,0.327272727272727,1
"5900","FRMD3",21,54,75,0.72,0.28,1
"5901","FRMD4A",42,76,118,0.644067796610169,0.355932203389831,1
"5902","FRMD4B",24,39,63,0.619047619047619,0.380952380952381,1
"5903","FRMD5",22,17,39,0.435897435897436,0.564102564102564,1
"5904","FRMD6",34,45,79,0.569620253164557,0.430379746835443,1
"5905","FRMD7",62,43,105,0.40952380952381,0.59047619047619,1
"5906","FRMD8",15,27,42,0.642857142857143,0.357142857142857,1
"5907","FRMPD1",85,113,198,0.570707070707071,0.429292929292929,1
"5908","FRMPD2",68,141,209,0.674641148325359,0.325358851674641,1
"5909","FRMPD2B",33,61,94,0.648936170212766,0.351063829787234,1
"5910","FRMPD3",91,66,157,0.420382165605096,0.579617834394904,1
"5911","FRMPD4",115,109,224,0.486607142857143,0.513392857142857,1
"5912","FRRS1",21,33,54,0.611111111111111,0.388888888888889,1
"5913","FRRS1L",7,19,26,0.730769230769231,0.269230769230769,1
"5914","FRS2",19,31,50,0.62,0.38,1
"5915","FRS3",22,39,61,0.639344262295082,0.360655737704918,1
"5916","FRY",133,242,375,0.645333333333333,0.354666666666667,1
"5917","FRYL",96,184,280,0.657142857142857,0.342857142857143,1
"5918","FRZB",17,30,47,0.638297872340426,0.361702127659574,1
"5919","FSCB",66,130,196,0.663265306122449,0.336734693877551,1
"5920","FSCN1",16,25,41,0.609756097560976,0.390243902439024,1
"5921","FSCN2",6,17,23,0.739130434782609,0.260869565217391,1
"5922","FSCN3",26,50,76,0.657894736842105,0.342105263157895,1
"5923","FSD1",17,35,52,0.673076923076923,0.326923076923077,1
"5924","FSD1L",0,3,3,1,0,1
"5925","FSD2",30,45,75,0.6,0.4,1
"5926","FSHB",9,25,34,0.735294117647059,0.264705882352941,1
"5927","FSHR",75,127,202,0.628712871287129,0.371287128712871,1
"5928","FSIP1",18,54,72,0.75,0.25,1
"5929","FSIP2",93,198,291,0.680412371134021,0.319587628865979,1
"5930","FST",11,26,37,0.702702702702703,0.297297297297297,1
"5931","FSTL1",15,22,37,0.594594594594595,0.405405405405405,1
"5932","FSTL3",4,6,10,0.6,0.4,1
"5933","FSTL4",44,58,102,0.568627450980392,0.431372549019608,1
"5934","FSTL5",107,163,270,0.603703703703704,0.396296296296296,1
"5935","FTCD",24,24,48,0.5,0.5,1
"5936","FTH1",6,15,21,0.714285714285714,0.285714285714286,1
"5937","FTHL17",26,16,42,0.380952380952381,0.619047619047619,1
"5938","FTL",4,11,15,0.733333333333333,0.266666666666667,1
"5939","FTMT",31,41,72,0.569444444444444,0.430555555555556,1
"5940","FTO",21,31,52,0.596153846153846,0.403846153846154,1
"5941","FTSJ1",16,10,26,0.384615384615385,0.615384615384615,1
"5942","FTSJ3",30,49,79,0.620253164556962,0.379746835443038,1
"5943","FUBP1",49,75,124,0.604838709677419,0.395161290322581,1
"5944","FUBP3",20,38,58,0.655172413793103,0.344827586206897,1
"5945","FUCA1",12,13,25,0.52,0.48,1
"5946","FUCA2",9,19,28,0.678571428571429,0.321428571428571,1
"5947","FUNDC1",2,5,7,0.714285714285714,0.285714285714286,1
"5948","FUNDC2",18,3,21,0.142857142857143,0.857142857142857,1
"5949","FUOM",3,3,6,0.5,0.5,1
"5950","FURIN",31,33,64,0.515625,0.484375,1
"5951","FUS",11,30,41,0.731707317073171,0.268292682926829,1
"5952","FUT1",26,25,51,0.490196078431373,0.509803921568627,1
"5953","FUT10",15,30,45,0.666666666666667,0.333333333333333,1
"5954","FUT11",14,10,24,0.416666666666667,0.583333333333333,1
"5955","FUT2",11,20,31,0.645161290322581,0.354838709677419,1
"5956","FUT3",17,32,49,0.653061224489796,0.346938775510204,1
"5957","FUT4",4,14,18,0.777777777777778,0.222222222222222,1
"5958","FUT5",15,44,59,0.745762711864407,0.254237288135593,1
"5959","FUT6",15,31,46,0.673913043478261,0.326086956521739,1
"5960","FUT7",8,11,19,0.578947368421053,0.421052631578947,1
"5961","FUT8",12,47,59,0.796610169491525,0.203389830508475,1
"5962","FUT9",35,89,124,0.717741935483871,0.282258064516129,1
"5963","FUZ",9,16,25,0.64,0.36,1
"5964","FXN",6,7,13,0.538461538461538,0.461538461538462,1
"5965","FXR1",39,47,86,0.546511627906977,0.453488372093023,1
"5966","FXR2",27,28,55,0.509090909090909,0.490909090909091,1
"5967","FXYD1",5,4,9,0.444444444444444,0.555555555555556,1
"5968","FXYD2",2,0,2,0,1,1
"5969","FXYD4",4,3,7,0.428571428571429,0.571428571428571,1
"5970","FXYD5",7,15,22,0.681818181818182,0.318181818181818,1
"5971","FXYD6",3,7,10,0.7,0.3,1
"5972","FXYD6P3",8,13,21,0.619047619047619,0.380952380952381,1
"5973","FXYD7",1,4,5,0.8,0.2,1
"5974","FYB1",61,78,139,0.561151079136691,0.438848920863309,1
"5975","FYB2",42,111,153,0.725490196078431,0.274509803921569,1
"5976","FYCO1",43,66,109,0.605504587155963,0.394495412844037,1
"5977","FYN",24,44,68,0.647058823529412,0.352941176470588,1
"5978","FYTTD1",11,22,33,0.666666666666667,0.333333333333333,1
"5979","FZD1",30,31,61,0.508196721311475,0.491803278688525,1
"5980","FZD10",46,67,113,0.592920353982301,0.407079646017699,1
"5981","FZD2",22,38,60,0.633333333333333,0.366666666666667,1
"5982","FZD3",33,29,62,0.467741935483871,0.532258064516129,1
"5983","FZD4",10,21,31,0.67741935483871,0.32258064516129,1
"5984","FZD5",6,22,28,0.785714285714286,0.214285714285714,1
"5985","FZD6",28,36,64,0.5625,0.4375,1
"5986","FZD7",23,31,54,0.574074074074074,0.425925925925926,1
"5987","FZD8",24,30,54,0.555555555555556,0.444444444444444,1
"5988","FZD9",15,28,43,0.651162790697674,0.348837209302326,1
"5989","FZR1",24,31,55,0.563636363636364,0.436363636363636,1
"5990","G0S2",2,3,5,0.6,0.4,1
"5991","G2E3",28,51,79,0.645569620253165,0.354430379746835,1
"5992","G3BP1",24,41,65,0.630769230769231,0.369230769230769,1
"5993","G3BP2",21,23,44,0.522727272727273,0.477272727272727,1
"5994","G6PC",20,29,49,0.591836734693878,0.408163265306122,1
"5995","G6PC2",13,30,43,0.697674418604651,0.302325581395349,1
"5996","G6PC3",12,13,25,0.52,0.48,1
"5997","G6PD",35,19,54,0.351851851851852,0.648148148148148,1
"5998","GAA",32,46,78,0.58974358974359,0.41025641025641,1
"5999","GAB1",18,40,58,0.689655172413793,0.310344827586207,1
"6000","GAB2",20,26,46,0.565217391304348,0.434782608695652,1
"6001","GAB3",40,18,58,0.310344827586207,0.689655172413793,1
"6002","GAB4",50,64,114,0.56140350877193,0.43859649122807,1
"6003","GABARAP",0,5,5,1,0,0.77
"6004","GABARAPL1",6,10,16,0.625,0.375,0.77
"6005","GABARAPL2",1,8,9,0.888888888888889,0.111111111111111,0.77
"6006","GABBR1",47,62,109,0.568807339449541,0.431192660550459,1
"6007","GABBR2",43,82,125,0.656,0.344,1
"6008","GABPA",20,31,51,0.607843137254902,0.392156862745098,1
"6009","GABPB1",17,29,46,0.630434782608696,0.369565217391304,1
"6010","GABPB2",11,26,37,0.702702702702703,0.297297297297297,1
"6011","GABRA1",57,109,166,0.656626506024096,0.343373493975904,0.66
"6012","GABRA2",55,125,180,0.694444444444444,0.305555555555556,0.66
"6013","GABRA3",59,50,109,0.458715596330275,0.541284403669725,0.66
"6014","GABRA4",69,80,149,0.536912751677852,0.463087248322148,0.66
"6015","GABRA5",41,81,122,0.663934426229508,0.336065573770492,0.66
"6016","GABRA6",66,100,166,0.602409638554217,0.397590361445783,0.66
"6017","GABRB1",45,73,118,0.61864406779661,0.38135593220339,0.53
"6018","GABRB2",48,86,134,0.641791044776119,0.358208955223881,0.53
"6019","GABRB3",45,124,169,0.733727810650888,0.266272189349112,0.53
"6020","GABRD",31,29,60,0.483333333333333,0.516666666666667,0.53
"6021","GABRE",45,49,94,0.521276595744681,0.478723404255319,0.53
"6022","GABRG1",65,147,212,0.693396226415094,0.306603773584906,0.53
"6023","GABRG2",72,92,164,0.560975609756098,0.439024390243902,0.53
"6024","GABRG3",46,66,112,0.589285714285714,0.410714285714286,0.53
"6025","GABRP",20,45,65,0.692307692307692,0.307692307692308,0.53
"6026","GABRQ",64,64,128,0.5,0.5,0.53
"6027","GABRR1",32,41,73,0.561643835616438,0.438356164383562,0.53
"6028","GABRR2",22,28,50,0.56,0.44,0.53
"6029","GABRR3",24,28,52,0.538461538461538,0.461538461538462,0.53
"6030","GAD1",37,63,100,0.63,0.37,1
"6031","GAD2",42,80,122,0.655737704918033,0.344262295081967,1
"6032","GADD45A",4,3,7,0.428571428571429,0.571428571428571,1
"6033","GADD45B",2,7,9,0.777777777777778,0.222222222222222,1
"6034","GADD45G",2,8,10,0.8,0.2,1
"6035","GADD45GIP1",4,11,15,0.733333333333333,0.266666666666667,1
"6036","GADL1",21,42,63,0.666666666666667,0.333333333333333,1
"6037","GAGE1",3,8,11,0.727272727272727,0.272727272727273,1
"6038","GAGE10",9,8,17,0.470588235294118,0.529411764705882,1
"6039","GAGE12H",0,1,1,1,0,1
"6040","GAGE12J",1,1,2,0.5,0.5,1
"6041","GAGE2A",1,3,4,0.75,0.25,1
"6042","GAGE2E",7,8,15,0.533333333333333,0.466666666666667,1
"6043","GAK",54,68,122,0.557377049180328,0.442622950819672,1
"6044","GAL",2,7,9,0.777777777777778,0.222222222222222,1
"6045","GAL3ST1",18,44,62,0.709677419354839,0.290322580645161,1
"6046","GAL3ST2",14,15,29,0.517241379310345,0.482758620689655,1
"6047","GAL3ST3",18,33,51,0.647058823529412,0.352941176470588,1
"6048","GAL3ST4",19,42,61,0.688524590163934,0.311475409836066,1
"6049","GALC",25,40,65,0.615384615384615,0.384615384615385,1
"6050","GALE",8,11,19,0.578947368421053,0.421052631578947,1
"6051","GALK1",4,13,17,0.764705882352941,0.235294117647059,0.29
"6052","GALK2",14,24,38,0.631578947368421,0.368421052631579,0.29
"6053","GALM",10,17,27,0.62962962962963,0.37037037037037,1
"6054","GALNS",16,15,31,0.483870967741935,0.516129032258065,1
"6055","GALNT1",29,25,54,0.462962962962963,0.537037037037037,1
"6056","GALNT10",31,32,63,0.507936507936508,0.492063492063492,1
"6057","GALNT11",15,28,43,0.651162790697674,0.348837209302326,1
"6058","GALNT12",10,36,46,0.782608695652174,0.217391304347826,1
"6059","GALNT13",59,123,182,0.675824175824176,0.324175824175824,1
"6060","GALNT14",49,77,126,0.611111111111111,0.388888888888889,1
"6061","GALNT15",31,57,88,0.647727272727273,0.352272727272727,1
"6062","GALNT16",20,37,57,0.649122807017544,0.350877192982456,1
"6063","GALNT17",90,163,253,0.644268774703557,0.355731225296443,1
"6064","GALNT18",22,46,68,0.676470588235294,0.323529411764706,1
"6065","GALNT2",32,43,75,0.573333333333333,0.426666666666667,1
"6066","GALNT3",19,38,57,0.666666666666667,0.333333333333333,1
"6067","GALNT4",1,2,3,0.666666666666667,0.333333333333333,1
"6068","GALNT5",42,76,118,0.644067796610169,0.355932203389831,1
"6069","GALNT6",33,55,88,0.625,0.375,1
"6070","GALNT7",24,32,56,0.571428571428571,0.428571428571429,1
"6071","GALNT8",28,41,69,0.594202898550725,0.405797101449275,1
"6072","GALNT9",14,23,37,0.621621621621622,0.378378378378378,1
"6073","GALNTL5",31,59,90,0.655555555555556,0.344444444444444,1
"6074","GALNTL6",45,98,143,0.685314685314685,0.314685314685315,1
"6075","GALP",7,20,27,0.740740740740741,0.259259259259259,1
"6076","GALR1",36,29,65,0.446153846153846,0.553846153846154,1
"6077","GALR2",14,17,31,0.548387096774194,0.451612903225806,1
"6078","GALR3",4,7,11,0.636363636363636,0.363636363636364,1
"6079","GALT",15,17,32,0.53125,0.46875,1
"6080","GAMT",7,8,15,0.533333333333333,0.466666666666667,1
"6081","GAN",25,28,53,0.528301886792453,0.471698113207547,1
"6082","GANAB",33,60,93,0.645161290322581,0.354838709677419,1
"6083","GANC",23,35,58,0.603448275862069,0.396551724137931,1
"6084","GAP43",18,44,62,0.709677419354839,0.290322580645161,1
"6085","GAPDH",6,21,27,0.777777777777778,0.222222222222222,1
"6086","GAPDHS",17,28,45,0.622222222222222,0.377777777777778,1
"6087","GAPT",9,13,22,0.590909090909091,0.409090909090909,1
"6088","GAPVD1",44,77,121,0.636363636363636,0.363636363636364,1
"6089","GAR1",14,10,24,0.416666666666667,0.583333333333333,0.77
"6090","GAREM1",33,55,88,0.625,0.375,0.77
"6091","GAREM2",0,3,3,1,0,0.77
"6092","GARNL3",32,62,94,0.659574468085106,0.340425531914894,0.77
"6093","GARRE1",20,51,71,0.71830985915493,0.28169014084507,0.77
"6094","GARS1",17,19,36,0.527777777777778,0.472222222222222,0.77
"6095","GART",31,40,71,0.563380281690141,0.436619718309859,0.77
"6096","GAS1",6,1,7,0.142857142857143,0.857142857142857,1
"6097","GAS2",22,44,66,0.666666666666667,0.333333333333333,1
"6098","GAS2L1",30,33,63,0.523809523809524,0.476190476190476,1
"6099","GAS2L2",51,65,116,0.560344827586207,0.439655172413793,1
"6100","GAS2L3",36,36,72,0.5,0.5,1
"6101","GAS6",21,31,52,0.596153846153846,0.403846153846154,1
"6102","GAS7",28,40,68,0.588235294117647,0.411764705882353,1
"6103","GAS8",10,14,24,0.583333333333333,0.416666666666667,1
"6104","GASK1A",0,1,1,1,0,1
"6105","GASK1B",32,41,73,0.561643835616438,0.438356164383562,1
"6106","GAST",7,7,14,0.5,0.5,1
"6107","GATA1",27,16,43,0.372093023255814,0.627906976744186,1
"6108","GATA2",21,33,54,0.611111111111111,0.388888888888889,1
"6109","GATA3",42,58,100,0.58,0.42,1
"6110","GATA4",16,19,35,0.542857142857143,0.457142857142857,1
"6111","GATA5",10,17,27,0.62962962962963,0.37037037037037,1
"6112","GATA6",17,20,37,0.540540540540541,0.459459459459459,1
"6113","GATAD1",6,3,9,0.333333333333333,0.666666666666667,1
"6114","GATAD2A",22,36,58,0.620689655172414,0.379310344827586,1
"6115","GATAD2B",22,28,50,0.56,0.44,1
"6116","GATB",17,36,53,0.679245283018868,0.320754716981132,1
"6117","GATC",4,3,7,0.428571428571429,0.571428571428571,1
"6118","GATD1",8,6,14,0.428571428571429,0.571428571428571,1
"6119","GATM",13,30,43,0.697674418604651,0.302325581395349,1
"6120","GBA",18,37,55,0.672727272727273,0.327272727272727,1
"6121","GBA2",18,42,60,0.7,0.3,1
"6122","GBA3",37,63,100,0.63,0.37,1
"6123","GBE1",28,40,68,0.588235294117647,0.411764705882353,1
"6124","GBF1",60,83,143,0.58041958041958,0.41958041958042,1
"6125","GBGT1",9,12,21,0.571428571428571,0.428571428571429,1
"6126","GBP1",23,47,70,0.671428571428571,0.328571428571429,1
"6127","GBP2",22,30,52,0.576923076923077,0.423076923076923,1
"6128","GBP3",14,31,45,0.688888888888889,0.311111111111111,1
"6129","GBP4",21,51,72,0.708333333333333,0.291666666666667,1
"6130","GBP5",38,53,91,0.582417582417582,0.417582417582418,1
"6131","GBP6",36,51,87,0.586206896551724,0.413793103448276,1
"6132","GBP7",29,45,74,0.608108108108108,0.391891891891892,1
"6133","GBX1",10,25,35,0.714285714285714,0.285714285714286,1
"6134","GBX2",14,14,28,0.5,0.5,1
"6135","GC",23,48,71,0.676056338028169,0.323943661971831,1
"6136","GCA",12,10,22,0.454545454545455,0.545454545454545,1
"6137","GCAT",18,21,39,0.538461538461538,0.461538461538462,1
"6138","GCC1",34,50,84,0.595238095238095,0.404761904761905,1
"6139","GCC2",53,89,142,0.626760563380282,0.373239436619718,1
"6140","GCDH",23,30,53,0.566037735849057,0.433962264150943,1
"6141","GCFC2",17,38,55,0.690909090909091,0.309090909090909,1
"6142","GCG",10,24,34,0.705882352941177,0.294117647058824,1
"6143","GCH1",7,9,16,0.5625,0.4375,1
"6144","GCHFR",5,2,7,0.285714285714286,0.714285714285714,1
"6145","GCK",24,44,68,0.647058823529412,0.352941176470588,1
"6146","GCKR",15,45,60,0.75,0.25,1
"6147","GCLC",26,30,56,0.535714285714286,0.464285714285714,1
"6148","GCLM",9,15,24,0.625,0.375,1
"6149","GCM1",30,34,64,0.53125,0.46875,1
"6150","GCM2",23,42,65,0.646153846153846,0.353846153846154,1
"6151","GCN1",90,150,240,0.625,0.375,1
"6152","GCNA",52,25,77,0.324675324675325,0.675324675324675,1
"6153","GCNT1",21,33,54,0.611111111111111,0.388888888888889,1
"6154","GCNT2",18,27,45,0.6,0.4,1
"6155","GCNT3",12,30,42,0.714285714285714,0.285714285714286,1
"6156","GCNT4",20,45,65,0.692307692307692,0.307692307692308,1
"6157","GCNT7",0,1,1,1,0,1
"6158","GCOM1",22,38,60,0.633333333333333,0.366666666666667,1
"6159","GCSAM",3,23,26,0.884615384615385,0.115384615384615,1
"6160","GCSAML",24,37,61,0.60655737704918,0.39344262295082,1
"6161","GCSH",0,1,1,1,0,1
"6162","GDA",19,51,70,0.728571428571429,0.271428571428571,1
"6163","GDAP1",20,17,37,0.459459459459459,0.540540540540541,1
"6164","GDAP1L1",13,27,40,0.675,0.325,1
"6165","GDAP2",31,31,62,0.5,0.5,1
"6166","GDE1",7,11,18,0.611111111111111,0.388888888888889,1
"6167","GDF1",4,4,8,0.5,0.5,1
"6168","GDF10",37,45,82,0.548780487804878,0.451219512195122,1
"6169","GDF11",14,9,23,0.391304347826087,0.608695652173913,1
"6170","GDF15",12,15,27,0.555555555555556,0.444444444444444,1
"6171","GDF2",38,60,98,0.612244897959184,0.387755102040816,1
"6172","GDF3",28,42,70,0.6,0.4,1
"6173","GDF5",44,72,116,0.620689655172414,0.379310344827586,1
"6174","GDF6",28,32,60,0.533333333333333,0.466666666666667,1
"6175","GDF7",10,10,20,0.5,0.5,1
"6176","GDF9",18,27,45,0.6,0.4,1
"6177","GDI1",24,15,39,0.384615384615385,0.615384615384615,1
"6178","GDI2",11,23,34,0.676470588235294,0.323529411764706,1
"6179","GDNF",9,31,40,0.775,0.225,1
"6180","GDPD1",13,22,35,0.628571428571429,0.371428571428571,1
"6181","GDPD2",45,13,58,0.224137931034483,0.775862068965517,1
"6182","GDPD3",13,17,30,0.566666666666667,0.433333333333333,1
"6183","GDPD4",27,33,60,0.55,0.45,1
"6184","GDPD5",16,23,39,0.58974358974359,0.41025641025641,1
"6185","GDPGP1",11,17,28,0.607142857142857,0.392857142857143,1
"6186","GEM",25,26,51,0.509803921568627,0.490196078431373,1
"6187","GEMIN2",3,18,21,0.857142857142857,0.142857142857143,1
"6188","GEMIN4",25,22,47,0.468085106382979,0.531914893617021,1
"6189","GEMIN5",38,69,107,0.644859813084112,0.355140186915888,1
"6190","GEMIN6",4,7,11,0.636363636363636,0.363636363636364,1
"6191","GEMIN7",7,9,16,0.5625,0.4375,1
"6192","GEMIN8",14,16,30,0.533333333333333,0.466666666666667,1
"6193","GEN1",31,46,77,0.597402597402597,0.402597402597403,1
"6194","GET1",9,9,18,0.5,0.5,1
"6195","GET1-SH3BGR",4,11,15,0.733333333333333,0.266666666666667,1
"6196","GET3",6,19,25,0.76,0.24,1
"6197","GET4",17,21,38,0.552631578947368,0.447368421052632,1
"6198","GFAP",19,26,45,0.577777777777778,0.422222222222222,1
"6199","GFER",1,4,5,0.8,0.2,1
"6200","GFI1",12,27,39,0.692307692307692,0.307692307692308,1
"6201","GFI1B",11,21,32,0.65625,0.34375,1
"6202","GFM1",31,24,55,0.436363636363636,0.563636363636364,1
"6203","GFM2",25,31,56,0.553571428571429,0.446428571428571,1
"6204","GFOD1",21,21,42,0.5,0.5,1
"6205","GFOD2",13,24,37,0.648648648648649,0.351351351351351,1
"6206","GFPT1",23,37,60,0.616666666666667,0.383333333333333,1
"6207","GFPT2",28,50,78,0.641025641025641,0.358974358974359,1
"6208","GFRA1",35,54,89,0.606741573033708,0.393258426966292,1
"6209","GFRA2",22,34,56,0.607142857142857,0.392857142857143,1
"6210","GFRA3",13,20,33,0.606060606060606,0.393939393939394,1
"6211","GFRA4",2,7,9,0.777777777777778,0.222222222222222,1
"6212","GFRAL",60,103,163,0.631901840490798,0.368098159509202,1
"6213","GFUS",7,14,21,0.666666666666667,0.333333333333333,1
"6214","GGA1",19,25,44,0.568181818181818,0.431818181818182,1
"6215","GGA2",22,33,55,0.6,0.4,1
"6216","GGA3",27,25,52,0.480769230769231,0.519230769230769,1
"6217","GGCT",8,7,15,0.466666666666667,0.533333333333333,1
"6218","GGCX",14,43,57,0.754385964912281,0.245614035087719,1
"6219","GGH",14,23,37,0.621621621621622,0.378378378378378,1
"6220","GGN",30,36,66,0.545454545454545,0.454545454545455,1
"6221","GGNBP2",34,52,86,0.604651162790698,0.395348837209302,1
"6222","GGPS1",9,16,25,0.64,0.36,1
"6223","GGT1",16,31,47,0.659574468085106,0.340425531914894,1
"6224","GGT5",36,33,69,0.478260869565217,0.521739130434783,1
"6225","GGT6",8,18,26,0.692307692307692,0.307692307692308,1
"6226","GGT7",20,29,49,0.591836734693878,0.408163265306122,1
"6227","GGTLC1",13,31,44,0.704545454545455,0.295454545454545,1
"6228","GGTLC2",6,12,18,0.666666666666667,0.333333333333333,1
"6229","GH2",16,27,43,0.627906976744186,0.372093023255814,1
"6230","GHDC",21,18,39,0.461538461538462,0.538461538461538,1
"6231","GHITM",7,23,30,0.766666666666667,0.233333333333333,1
"6232","GHR",47,97,144,0.673611111111111,0.326388888888889,1
"6233","GHRH",7,4,11,0.363636363636364,0.636363636363636,1
"6234","GHRHR",18,23,41,0.560975609756098,0.439024390243902,1
"6235","GHRL",0,7,7,1,0,1
"6236","GHSR",23,37,60,0.616666666666667,0.383333333333333,1
"6237","GID4",5,7,12,0.583333333333333,0.416666666666667,1
"6238","GID8",4,13,17,0.764705882352941,0.235294117647059,1
"6239","GIGYF1",42,62,104,0.596153846153846,0.403846153846154,1
"6240","GIGYF2",50,85,135,0.62962962962963,0.37037037037037,1
"6241","GIMAP1",29,58,87,0.666666666666667,0.333333333333333,1
"6242","GIMAP1-GIMAP5",0,1,1,1,0,1
"6243","GIMAP2",16,42,58,0.724137931034483,0.275862068965517,1
"6244","GIMAP4",17,54,71,0.76056338028169,0.23943661971831,1
"6245","GIMAP5",27,40,67,0.597014925373134,0.402985074626866,1
"6246","GIMAP6",40,72,112,0.642857142857143,0.357142857142857,1
"6247","GIMAP7",22,58,80,0.725,0.275,1
"6248","GIMAP8",46,108,154,0.701298701298701,0.298701298701299,1
"6249","GIN1",18,34,52,0.653846153846154,0.346153846153846,1
"6250","GINM1",16,14,30,0.466666666666667,0.533333333333333,1
"6251","GINS1",15,17,32,0.53125,0.46875,1
"6252","GINS2",3,9,12,0.75,0.25,1
"6253","GINS3",11,8,19,0.421052631578947,0.578947368421053,1
"6254","GINS4",4,17,21,0.80952380952381,0.19047619047619,1
"6255","GIP",6,15,21,0.714285714285714,0.285714285714286,1
"6256","GIPC1",13,25,38,0.657894736842105,0.342105263157895,1
"6257","GIPC2",15,19,34,0.558823529411765,0.441176470588235,1
"6258","GIPC3",19,22,41,0.536585365853659,0.463414634146341,1
"6259","GIPR",12,21,33,0.636363636363636,0.363636363636364,1
"6260","GIT1",14,28,42,0.666666666666667,0.333333333333333,1
"6261","GIT2",19,37,56,0.660714285714286,0.339285714285714,1
"6262","GJA1",36,42,78,0.538461538461538,0.461538461538462,1
"6263","GJA10",34,74,108,0.685185185185185,0.314814814814815,1
"6264","GJA3",9,11,20,0.55,0.45,1
"6265","GJA4",18,20,38,0.526315789473684,0.473684210526316,1
"6266","GJA5",20,50,70,0.714285714285714,0.285714285714286,1
"6267","GJA8",48,80,128,0.625,0.375,1
"6268","GJA9",20,28,48,0.583333333333333,0.416666666666667,1
"6269","GJB1",17,14,31,0.451612903225806,0.548387096774194,1
"6270","GJB2",6,9,15,0.6,0.4,1
"6271","GJB3",12,23,35,0.657142857142857,0.342857142857143,1
"6272","GJB4",12,28,40,0.7,0.3,1
"6273","GJB5",11,14,25,0.56,0.44,1
"6274","GJB6",10,22,32,0.6875,0.3125,1
"6275","GJB7",8,11,19,0.578947368421053,0.421052631578947,1
"6276","GJC1",16,39,55,0.709090909090909,0.290909090909091,1
"6277","GJC2",7,10,17,0.588235294117647,0.411764705882353,1
"6278","GJC3",10,12,22,0.545454545454545,0.454545454545455,1
"6279","GJD2",29,49,78,0.628205128205128,0.371794871794872,1
"6280","GJD3",1,4,5,0.8,0.2,1
"6281","GJD4",17,13,30,0.433333333333333,0.566666666666667,1
"6282","GK",27,16,43,0.372093023255814,0.627906976744186,1
"6283","GK2",44,92,136,0.676470588235294,0.323529411764706,1
"6284","GK5",11,18,29,0.620689655172414,0.379310344827586,1
"6285","GKAP1",6,22,28,0.785714285714286,0.214285714285714,1
"6286","GKN1",12,20,32,0.625,0.375,1
"6287","GKN2",5,14,19,0.736842105263158,0.263157894736842,1
"6288","GLA",36,12,48,0.25,0.75,1
"6289","GLB1",23,32,55,0.581818181818182,0.418181818181818,1
"6290","GLB1L",15,30,45,0.666666666666667,0.333333333333333,1
"6291","GLB1L2",37,52,89,0.584269662921348,0.415730337078652,1
"6292","GLB1L3",23,53,76,0.697368421052632,0.302631578947368,1
"6293","GLCCI1",14,36,50,0.72,0.28,1
"6294","GLCE",28,30,58,0.517241379310345,0.482758620689655,1
"6295","GLDC",40,80,120,0.666666666666667,0.333333333333333,1
"6296","GLDN",21,39,60,0.65,0.35,1
"6297","GLE1",19,23,42,0.547619047619048,0.452380952380952,1
"6298","GLG1",41,65,106,0.613207547169811,0.386792452830189,1
"6299","GLI1",57,97,154,0.62987012987013,0.37012987012987,1
"6300","GLI2",84,134,218,0.614678899082569,0.385321100917431,1
"6301","GLI3",128,162,290,0.558620689655172,0.441379310344828,1
"6302","GLI4",7,19,26,0.730769230769231,0.269230769230769,1
"6303","GLIPR1",24,21,45,0.466666666666667,0.533333333333333,1
"6304","GLIPR1L1",4,15,19,0.789473684210526,0.210526315789474,1
"6305","GLIPR1L2",6,28,34,0.823529411764706,0.176470588235294,1
"6306","GLIPR2",4,5,9,0.555555555555556,0.444444444444444,1
"6307","GLIS1",22,55,77,0.714285714285714,0.285714285714286,1
"6308","GLIS2",13,17,30,0.566666666666667,0.433333333333333,1
"6309","GLIS3",43,84,127,0.661417322834646,0.338582677165354,1
"6310","GLMN",20,23,43,0.534883720930233,0.465116279069767,1
"6311","GLMP",14,16,30,0.533333333333333,0.466666666666667,1
"6312","GLO1",12,8,20,0.4,0.6,1
"6313","GLOD4",5,14,19,0.736842105263158,0.263157894736842,1
"6314","GLOD5",6,8,14,0.571428571428571,0.428571428571429,1
"6315","GLP1R",25,40,65,0.615384615384615,0.384615384615385,1
"6316","GLP2R",25,67,92,0.728260869565217,0.271739130434783,1
"6317","GLRA1",22,41,63,0.650793650793651,0.349206349206349,1
"6318","GLRA2",36,42,78,0.538461538461538,0.461538461538462,1
"6319","GLRA3",36,60,96,0.625,0.375,1
"6320","GLRA4",22,25,47,0.531914893617021,0.468085106382979,1
"6321","GLRB",40,74,114,0.649122807017544,0.350877192982456,1
"6322","GLRX",2,7,9,0.777777777777778,0.222222222222222,1
"6323","GLRX2",7,6,13,0.461538461538462,0.538461538461538,1
"6324","GLRX3",10,31,41,0.75609756097561,0.24390243902439,1
"6325","GLRX5",3,3,6,0.5,0.5,1
"6326","GLRXP3",18,21,39,0.538461538461538,0.461538461538462,1
"6327","GLS",25,24,49,0.489795918367347,0.510204081632653,1
"6328","GLS2",14,23,37,0.621621621621622,0.378378378378378,1
"6329","GLT1D1",16,29,45,0.644444444444444,0.355555555555556,1
"6330","GLT6D1",21,21,42,0.5,0.5,1
"6331","GLT8D1",16,25,41,0.609756097560976,0.390243902439024,1
"6332","GLT8D2",15,28,43,0.651162790697674,0.348837209302326,1
"6333","GLTP",7,13,20,0.65,0.35,1
"6334","GLTPD2",6,7,13,0.538461538461538,0.461538461538462,1
"6335","GLUD1",9,31,40,0.775,0.225,1
"6336","GLUD1P3",0,1,1,1,0,1
"6337","GLUD2",64,40,104,0.384615384615385,0.615384615384615,1
"6338","GLUL",18,27,45,0.6,0.4,1
"6339","GLYAT",15,44,59,0.745762711864407,0.254237288135593,1
"6340","GLYATL1",30,56,86,0.651162790697674,0.348837209302326,1
"6341","GLYATL2",21,52,73,0.712328767123288,0.287671232876712,1
"6342","GLYATL3",0,2,2,1,0,1
"6343","GLYCTK",9,16,25,0.64,0.36,1
"6344","GLYR1",42,47,89,0.528089887640449,0.471910112359551,1
"6345","GM2A",6,8,14,0.571428571428571,0.428571428571429,1
"6346","GMCL1",7,16,23,0.695652173913043,0.304347826086957,1
"6347","GMDS",17,26,43,0.604651162790698,0.395348837209302,1
"6348","GMEB1",12,29,41,0.707317073170732,0.292682926829268,1
"6349","GMEB2",18,34,52,0.653846153846154,0.346153846153846,1
"6350","GMFB",5,7,12,0.583333333333333,0.416666666666667,1
"6351","GMFG",10,7,17,0.411764705882353,0.588235294117647,1
"6352","GMIP",39,54,93,0.580645161290323,0.419354838709677,1
"6353","GML",17,25,42,0.595238095238095,0.404761904761905,1
"6354","GMNN",6,10,16,0.625,0.375,1
"6355","GMPPA",21,28,49,0.571428571428571,0.428571428571429,1
"6356","GMPPB",9,16,25,0.64,0.36,1
"6357","GMPR",16,18,34,0.529411764705882,0.470588235294118,1
"6358","GMPR2",11,13,24,0.541666666666667,0.458333333333333,1
"6359","GMPS",28,37,65,0.569230769230769,0.430769230769231,1
"6360","GNA11",38,35,73,0.479452054794521,0.520547945205479,1
"6361","GNA12",10,17,27,0.62962962962963,0.37037037037037,1
"6362","GNA13",9,33,42,0.785714285714286,0.214285714285714,1
"6363","GNA14",15,24,39,0.615384615384615,0.384615384615385,1
"6364","GNA15",9,25,34,0.735294117647059,0.264705882352941,1
"6365","GNAI1",14,29,43,0.674418604651163,0.325581395348837,1
"6366","GNAI2",16,18,34,0.529411764705882,0.470588235294118,1
"6367","GNAI3",11,18,29,0.620689655172414,0.379310344827586,1
"6368","GNAL",13,33,46,0.717391304347826,0.282608695652174,1
"6369","GNAO1",10,22,32,0.6875,0.3125,1
"6370","GNAQ",36,53,89,0.595505617977528,0.404494382022472,1
"6371","GNAS",55,71,126,0.563492063492063,0.436507936507937,1
"6372","GNAT1",14,21,35,0.6,0.4,1
"6373","GNAT2",8,19,27,0.703703703703704,0.296296296296296,1
"6374","GNAT3",16,22,38,0.578947368421053,0.421052631578947,1
"6375","GNAZ",28,48,76,0.631578947368421,0.368421052631579,1
"6376","GNB1",19,17,36,0.472222222222222,0.527777777777778,1
"6377","GNB1L",18,28,46,0.608695652173913,0.391304347826087,1
"6378","GNB2",4,15,19,0.789473684210526,0.210526315789474,1
"6379","GNB3",15,27,42,0.642857142857143,0.357142857142857,1
"6380","GNB4",21,27,48,0.5625,0.4375,1
"6381","GNB5",12,23,35,0.657142857142857,0.342857142857143,1
"6382","GNE",22,29,51,0.568627450980392,0.431372549019608,1
"6383","GNG10",0,1,1,1,0,1
"6384","GNG11",5,13,18,0.722222222222222,0.277777777777778,1
"6385","GNG12",18,16,34,0.470588235294118,0.529411764705882,1
"6386","GNG13",6,6,12,0.5,0.5,1
"6387","GNG2",5,11,16,0.6875,0.3125,1
"6388","GNG3",6,2,8,0.25,0.75,1
"6389","GNG4",3,11,14,0.785714285714286,0.214285714285714,1
"6390","GNG5",5,3,8,0.375,0.625,1
"6391","GNG5P2",0,1,1,1,0,1
"6392","GNG7",4,7,11,0.636363636363636,0.363636363636364,1
"6393","GNG8",0,2,2,1,0,1
"6394","GNGT1",5,5,10,0.5,0.5,1
"6395","GNGT2",3,10,13,0.769230769230769,0.230769230769231,1
"6396","GNL1",22,20,42,0.476190476190476,0.523809523809524,1
"6397","GNL2",31,34,65,0.523076923076923,0.476923076923077,1
"6398","GNL3",12,23,35,0.657142857142857,0.342857142857143,1
"6399","GNL3L",44,14,58,0.241379310344828,0.758620689655172,1
"6400","GNLY",6,9,15,0.6,0.4,1
"6401","GNMT",4,12,16,0.75,0.25,1
"6402","GNPAT",22,26,48,0.541666666666667,0.458333333333333,1
"6403","GNPDA1",10,9,19,0.473684210526316,0.526315789473684,1
"6404","GNPDA2",11,16,27,0.592592592592593,0.407407407407407,1
"6405","GNPNAT1",7,13,20,0.65,0.35,1
"6406","GNPTAB",46,58,104,0.557692307692308,0.442307692307692,1
"6407","GNPTG",10,8,18,0.444444444444444,0.555555555555556,1
"6408","GNRH1",4,7,11,0.636363636363636,0.363636363636364,1
"6409","GNRH2",4,5,9,0.555555555555556,0.444444444444444,1
"6410","GNRHR",13,22,35,0.628571428571429,0.371428571428571,1
"6411","GNS",9,23,32,0.71875,0.28125,1
"6412","GOLGA1",25,40,65,0.615384615384615,0.384615384615385,1
"6413","GOLGA2",28,62,90,0.688888888888889,0.311111111111111,1
"6414","GOLGA3",66,92,158,0.582278481012658,0.417721518987342,1
"6415","GOLGA4",57,133,190,0.7,0.3,1
"6416","GOLGA5",16,47,63,0.746031746031746,0.253968253968254,1
"6417","GOLGA6A",19,19,38,0.5,0.5,1
"6418","GOLGA6B",12,22,34,0.647058823529412,0.352941176470588,1
"6419","GOLGA6L22",8,8,16,0.5,0.5,1
"6420","GOLGA6L9",2,8,10,0.8,0.2,1
"6421","GOLGA7",5,1,6,0.166666666666667,0.833333333333333,1
"6422","GOLGA7B",2,10,12,0.833333333333333,0.166666666666667,1
"6423","GOLGA8A",3,5,8,0.625,0.375,1
"6424","GOLGA8G",5,5,10,0.5,0.5,1
"6425","GOLGB1",106,204,310,0.658064516129032,0.341935483870968,1
"6426","GOLIM4",33,49,82,0.597560975609756,0.402439024390244,1
"6427","GOLM1",14,19,33,0.575757575757576,0.424242424242424,1
"6428","GOLM2",11,22,33,0.666666666666667,0.333333333333333,1
"6429","GOLPH3",13,14,27,0.518518518518518,0.481481481481481,1
"6430","GOLPH3L",6,10,16,0.625,0.375,1
"6431","GOLT1A",8,8,16,0.5,0.5,1
"6432","GOLT1B",15,10,25,0.4,0.6,1
"6433","GON4L",82,119,201,0.592039800995025,0.407960199004975,1
"6434","GON7",1,5,6,0.833333333333333,0.166666666666667,1
"6435","GOPC",7,25,32,0.78125,0.21875,1
"6436","GORAB",14,35,49,0.714285714285714,0.285714285714286,1
"6437","GORASP1",13,9,22,0.409090909090909,0.590909090909091,1
"6438","GORASP2",16,37,53,0.69811320754717,0.30188679245283,1
"6439","GOSR1",6,11,17,0.647058823529412,0.352941176470588,1
"6440","GOSR2",7,14,21,0.666666666666667,0.333333333333333,1
"6441","GOT1",23,21,44,0.477272727272727,0.522727272727273,1
"6442","GOT1L1",31,28,59,0.474576271186441,0.525423728813559,1
"6443","GOT2",23,16,39,0.41025641025641,0.58974358974359,1
"6444","GP1BA",21,25,46,0.543478260869565,0.456521739130435,1
"6445","GP1BB",0,1,1,1,0,1
"6446","GP2",34,84,118,0.711864406779661,0.288135593220339,1
"6447","GP5",36,28,64,0.4375,0.5625,1
"6448","GP6",19,23,42,0.547619047619048,0.452380952380952,1
"6449","GP9",8,15,23,0.652173913043478,0.347826086956522,1
"6450","GPA33",16,29,45,0.644444444444444,0.355555555555556,1
"6451","GPAA1",16,30,46,0.652173913043478,0.347826086956522,1
"6452","GPALPP1",7,23,30,0.766666666666667,0.233333333333333,0.74
"6453","GPAM",28,48,76,0.631578947368421,0.368421052631579,1
"6454","GPANK1",10,22,32,0.6875,0.3125,0.44
"6455","GPAT2",22,26,48,0.541666666666667,0.458333333333333,1
"6456","GPAT3",30,28,58,0.482758620689655,0.517241379310345,1
"6457","GPAT4",10,18,28,0.642857142857143,0.357142857142857,1
"6458","GPATCH1",34,46,80,0.575,0.425,1
"6459","GPATCH11",4,4,8,0.5,0.5,1
"6460","GPATCH2",22,38,60,0.633333333333333,0.366666666666667,1
"6461","GPATCH2L",13,23,36,0.638888888888889,0.361111111111111,1
"6462","GPATCH3",13,23,36,0.638888888888889,0.361111111111111,1
"6463","GPATCH4",6,25,31,0.806451612903226,0.193548387096774,1
"6464","GPATCH8",62,115,177,0.649717514124294,0.350282485875706,1
"6465","GPBAR1",7,9,16,0.5625,0.4375,0.77
"6466","GPBP1",22,26,48,0.541666666666667,0.458333333333333,1
"6467","GPBP1L1",19,29,48,0.604166666666667,0.395833333333333,1
"6468","GPC1",15,16,31,0.516129032258065,0.483870967741935,1
"6469","GPC2",13,35,48,0.729166666666667,0.270833333333333,1
"6470","GPC3",30,37,67,0.552238805970149,0.447761194029851,1
"6471","GPC4",48,24,72,0.333333333333333,0.666666666666667,1
"6472","GPC5",54,138,192,0.71875,0.28125,1
"6473","GPC6",36,72,108,0.666666666666667,0.333333333333333,1
"6474","GPCPD1",27,27,54,0.5,0.5,1
"6475","GPD1",19,19,38,0.5,0.5,1
"6476","GPD1L",11,16,27,0.592592592592593,0.407407407407407,1
"6477","GPD2",24,42,66,0.636363636363636,0.363636363636364,1
"6478","GPER1",18,23,41,0.560975609756098,0.439024390243902,1
"6479","GPHA2",2,7,9,0.777777777777778,0.222222222222222,1
"6480","GPHB5",8,10,18,0.555555555555556,0.444444444444444,1
"6481","GPHN",35,58,93,0.623655913978495,0.376344086021505,1
"6482","GPI",26,24,50,0.48,0.52,1
"6483","GPIHBP1",5,15,20,0.75,0.25,1
"6484","GPKOW",27,9,36,0.25,0.75,1
"6485","GPLD1",34,68,102,0.666666666666667,0.333333333333333,1
"6486","GPM6A",37,37,74,0.5,0.5,1
"6487","GPM6B",6,8,14,0.571428571428571,0.428571428571429,1
"6488","GPN1",10,17,27,0.62962962962963,0.37037037037037,1
"6489","GPN2",12,13,25,0.52,0.48,1
"6490","GPN3",9,19,28,0.678571428571429,0.321428571428571,1
"6491","GPNMB",19,52,71,0.732394366197183,0.267605633802817,1
"6492","GPR1",6,22,28,0.785714285714286,0.214285714285714,1
"6493","GPR101",44,48,92,0.521739130434783,0.478260869565217,1
"6494","GPR107",10,22,32,0.6875,0.3125,1
"6495","GPR108",15,22,37,0.594594594594595,0.405405405405405,1
"6496","GPR119",20,23,43,0.534883720930233,0.465116279069767,1
"6497","GPR12",25,33,58,0.568965517241379,0.431034482758621,1
"6498","GPR132",19,22,41,0.536585365853659,0.463414634146341,1
"6499","GPR135",9,19,28,0.678571428571429,0.321428571428571,1
"6500","GPR137",20,32,52,0.615384615384615,0.384615384615385,1
"6501","GPR137B",22,24,46,0.521739130434783,0.478260869565217,1
"6502","GPR137C",5,19,24,0.791666666666667,0.208333333333333,1
"6503","GPR139",43,64,107,0.598130841121495,0.401869158878505,1
"6504","GPR141",31,60,91,0.659340659340659,0.340659340659341,1
"6505","GPR142",35,41,76,0.539473684210526,0.460526315789474,1
"6506","GPR143",26,11,37,0.297297297297297,0.702702702702703,1
"6507","GPR146",9,11,20,0.55,0.45,1
"6508","GPR148",25,29,54,0.537037037037037,0.462962962962963,1
"6509","GPR149",53,84,137,0.613138686131387,0.386861313868613,1
"6510","GPR15",19,40,59,0.677966101694915,0.322033898305085,1
"6511","GPR150",5,6,11,0.545454545454545,0.454545454545455,1
"6512","GPR151",19,22,41,0.536585365853659,0.463414634146341,1
"6513","GPR152",7,36,43,0.837209302325581,0.162790697674419,1
"6514","GPR153",9,15,24,0.625,0.375,1
"6515","GPR155",18,49,67,0.73134328358209,0.26865671641791,1
"6516","GPR156",43,63,106,0.594339622641509,0.405660377358491,1
"6517","GPR157",8,13,21,0.619047619047619,0.380952380952381,1
"6518","GPR158",104,212,316,0.670886075949367,0.329113924050633,1
"6519","GPR160",14,17,31,0.548387096774194,0.451612903225806,1
"6520","GPR161",16,37,53,0.69811320754717,0.30188679245283,1
"6521","GPR162",18,47,65,0.723076923076923,0.276923076923077,1
"6522","GPR17",15,22,37,0.594594594594595,0.405405405405405,1
"6523","GPR171",23,28,51,0.549019607843137,0.450980392156863,1
"6524","GPR173",27,11,38,0.289473684210526,0.710526315789474,1
"6525","GPR174",38,46,84,0.547619047619048,0.452380952380952,1
"6526","GPR176",11,31,42,0.738095238095238,0.261904761904762,1
"6527","GPR179",85,169,254,0.665354330708661,0.334645669291339,1
"6528","GPR18",9,22,31,0.709677419354839,0.290322580645161,1
"6529","GPR180",9,26,35,0.742857142857143,0.257142857142857,1
"6530","GPR182",16,19,35,0.542857142857143,0.457142857142857,1
"6531","GPR183",16,18,34,0.529411764705882,0.470588235294118,1
"6532","GPR19",20,26,46,0.565217391304348,0.434782608695652,1
"6533","GPR20",18,24,42,0.571428571428571,0.428571428571429,1
"6534","GPR21",6,16,22,0.727272727272727,0.272727272727273,1
"6535","GPR22",15,34,49,0.693877551020408,0.306122448979592,1
"6536","GPR25",7,13,20,0.65,0.35,1
"6537","GPR26",22,37,59,0.627118644067797,0.372881355932203,1
"6538","GPR27",10,13,23,0.565217391304348,0.434782608695652,1
"6539","GPR3",11,14,25,0.56,0.44,1
"6540","GPR31",16,18,34,0.529411764705882,0.470588235294118,1
"6541","GPR32",25,37,62,0.596774193548387,0.403225806451613,1
"6542","GPR34",14,16,30,0.533333333333333,0.466666666666667,1
"6543","GPR35",18,17,35,0.485714285714286,0.514285714285714,1
"6544","GPR37",36,71,107,0.663551401869159,0.336448598130841,1
"6545","GPR37L1",20,28,48,0.583333333333333,0.416666666666667,1
"6546","GPR39",21,37,58,0.637931034482759,0.362068965517241,1
"6547","GPR4",28,23,51,0.450980392156863,0.549019607843137,1
"6548","GPR42",5,7,12,0.583333333333333,0.416666666666667,1
"6549","GPR45",25,49,74,0.662162162162162,0.337837837837838,1
"6550","GPR50",75,50,125,0.4,0.6,1
"6551","GPR52",18,21,39,0.538461538461538,0.461538461538462,1
"6552","GPR55",13,24,37,0.648648648648649,0.351351351351351,1
"6553","GPR6",30,29,59,0.491525423728814,0.508474576271186,1
"6554","GPR61",20,42,62,0.67741935483871,0.32258064516129,1
"6555","GPR62",5,5,10,0.5,0.5,1
"6556","GPR63",19,61,80,0.7625,0.2375,1
"6557","GPR65",19,36,55,0.654545454545455,0.345454545454545,1
"6558","GPR68",9,19,28,0.678571428571429,0.321428571428571,1
"6559","GPR75",17,32,49,0.653061224489796,0.346938775510204,1
"6560","GPR78",16,39,55,0.709090909090909,0.290909090909091,1
"6561","GPR82",12,13,25,0.52,0.48,1
"6562","GPR83",27,44,71,0.619718309859155,0.380281690140845,1
"6563","GPR84",22,23,45,0.511111111111111,0.488888888888889,1
"6564","GPR85",20,34,54,0.62962962962963,0.37037037037037,1
"6565","GPR87",20,30,50,0.6,0.4,1
"6566","GPR88",4,9,13,0.692307692307692,0.307692307692308,1
"6567","GPR89A",6,17,23,0.739130434782609,0.260869565217391,1
"6568","GPR89B",7,22,29,0.758620689655172,0.241379310344828,1
"6569","GPRASP1",98,57,155,0.367741935483871,0.632258064516129,1
"6570","GPRASP2",61,40,101,0.396039603960396,0.603960396039604,1
"6571","GPRC5A",14,12,26,0.461538461538462,0.538461538461538,1
"6572","GPRC5B",27,26,53,0.490566037735849,0.509433962264151,1
"6573","GPRC5C",21,51,72,0.708333333333333,0.291666666666667,1
"6574","GPRC5D",10,14,24,0.583333333333333,0.416666666666667,1
"6575","GPRC6A",68,115,183,0.628415300546448,0.371584699453552,1
"6576","GPRIN1",44,38,82,0.463414634146341,0.536585365853659,1
"6577","GPRIN2",30,52,82,0.634146341463415,0.365853658536585,1
"6578","GPRIN3",39,63,102,0.617647058823529,0.382352941176471,1
"6579","GPS1",10,29,39,0.743589743589744,0.256410256410256,1
"6580","GPS2",21,19,40,0.475,0.525,1
"6581","GPSM1",12,28,40,0.7,0.3,1
"6582","GPSM2",22,31,53,0.584905660377358,0.415094339622642,1
"6583","GPSM3",16,14,30,0.466666666666667,0.533333333333333,1
"6584","GPT",16,22,38,0.578947368421053,0.421052631578947,1
"6585","GPT2",11,25,36,0.694444444444444,0.305555555555556,1
"6586","GPX1",9,13,22,0.590909090909091,0.409090909090909,1
"6587","GPX2",8,9,17,0.529411764705882,0.470588235294118,1
"6588","GPX3",6,15,21,0.714285714285714,0.285714285714286,1
"6589","GPX4",7,5,12,0.416666666666667,0.583333333333333,1
"6590","GPX5",22,45,67,0.671641791044776,0.328358208955224,1
"6591","GPX6",14,40,54,0.740740740740741,0.259259259259259,1
"6592","GPX7",11,7,18,0.388888888888889,0.611111111111111,1
"6593","GPX8",4,13,17,0.764705882352941,0.235294117647059,1
"6594","GRAMD1A",34,32,66,0.484848484848485,0.515151515151515,0.29
"6595","GRAMD1B",34,49,83,0.590361445783133,0.409638554216867,0.29
"6596","GRAMD1C",23,59,82,0.719512195121951,0.280487804878049,0.29
"6597","GRAMD2A",10,22,32,0.6875,0.3125,1
"6598","GRAMD2B",14,19,33,0.575757575757576,0.424242424242424,1
"6599","GRAMD4",27,31,58,0.53448275862069,0.46551724137931,1
"6600","GRAP",3,6,9,0.666666666666667,0.333333333333333,1
"6601","GRAP2",14,36,50,0.72,0.28,1
"6602","GRB10",19,47,66,0.712121212121212,0.287878787878788,1
"6603","GRB14",16,45,61,0.737704918032787,0.262295081967213,1
"6604","GRB2",8,12,20,0.6,0.4,1
"6605","GRB7",18,35,53,0.660377358490566,0.339622641509434,1
"6606","GREB1",91,137,228,0.600877192982456,0.399122807017544,1
"6607","GREB1L",0,10,10,1,0,1
"6608","GREM1",6,16,22,0.727272727272727,0.272727272727273,1
"6609","GREM2",17,31,48,0.645833333333333,0.354166666666667,1
"6610","GRHL1",21,45,66,0.681818181818182,0.318181818181818,1
"6611","GRHL2",30,40,70,0.571428571428571,0.428571428571429,1
"6612","GRHL3",40,21,61,0.344262295081967,0.655737704918033,1
"6613","GRHPR",7,15,22,0.681818181818182,0.318181818181818,1
"6614","GRIA1",105,151,256,0.58984375,0.41015625,1
"6615","GRIA2",88,139,227,0.612334801762115,0.387665198237885,1
"6616","GRIA3",88,69,157,0.439490445859873,0.560509554140127,1
"6617","GRIA4",62,130,192,0.677083333333333,0.322916666666667,1
"6618","GRID1",86,147,233,0.630901287553648,0.369098712446352,1
"6619","GRID2",105,188,293,0.641638225255973,0.358361774744027,1
"6620","GRID2IP",0,3,3,1,0,1
"6621","GRIFIN",2,2,4,0.5,0.5,1
"6622","GRIK1",60,89,149,0.597315436241611,0.402684563758389,1
"6623","GRIK2",107,173,280,0.617857142857143,0.382142857142857,1
"6624","GRIK3",61,141,202,0.698019801980198,0.301980198019802,1
"6625","GRIK4",55,81,136,0.595588235294118,0.404411764705882,1
"6626","GRIK5",53,73,126,0.579365079365079,0.420634920634921,1
"6627","GRIN1",27,43,70,0.614285714285714,0.385714285714286,1
"6628","GRIN2A",153,310,463,0.669546436285097,0.330453563714903,1
"6629","GRIN2B",124,216,340,0.635294117647059,0.364705882352941,1
"6630","GRIN2C",25,49,74,0.662162162162162,0.337837837837838,1
"6631","GRIN2D",35,66,101,0.653465346534653,0.346534653465347,1
"6632","GRIN3A",84,160,244,0.655737704918033,0.344262295081967,1
"6633","GRIN3B",18,31,49,0.63265306122449,0.36734693877551,1
"6634","GRINA",12,18,30,0.6,0.4,1
"6635","GRIP1",60,107,167,0.640718562874252,0.359281437125749,1
"6636","GRIP2",36,60,96,0.625,0.375,1
"6637","GRIPAP1",45,17,62,0.274193548387097,0.725806451612903,1
"6638","GRK1",16,20,36,0.555555555555556,0.444444444444444,1
"6639","GRK2",24,44,68,0.647058823529412,0.352941176470588,1
"6640","GRK3",24,29,53,0.547169811320755,0.452830188679245,1
"6641","GRK4",23,33,56,0.589285714285714,0.410714285714286,1
"6642","GRK5",26,40,66,0.606060606060606,0.393939393939394,1
"6643","GRK6",11,21,32,0.65625,0.34375,1
"6644","GRK7",32,46,78,0.58974358974359,0.41025641025641,1
"6645","GRM1",120,151,271,0.55719557195572,0.44280442804428,1
"6646","GRM2",42,67,109,0.614678899082569,0.385321100917431,1
"6647","GRM3",87,197,284,0.693661971830986,0.306338028169014,1
"6648","GRM4",56,75,131,0.572519083969466,0.427480916030534,1
"6649","GRM5",99,151,250,0.604,0.396,1
"6650","GRM6",56,105,161,0.652173913043478,0.347826086956522,1
"6651","GRM7",108,164,272,0.602941176470588,0.397058823529412,1
"6652","GRM8",105,218,323,0.674922600619195,0.325077399380805,1
"6653","GRN",19,28,47,0.595744680851064,0.404255319148936,1
"6654","GRP",11,7,18,0.388888888888889,0.611111111111111,1
"6655","GRPEL1",4,8,12,0.666666666666667,0.333333333333333,1
"6656","GRPEL2",2,10,12,0.833333333333333,0.166666666666667,1
"6657","GRPR",23,25,48,0.520833333333333,0.479166666666667,1
"6658","GRSF1",22,17,39,0.435897435897436,0.564102564102564,1
"6659","GRTP1",6,17,23,0.739130434782609,0.260869565217391,1
"6660","GRWD1",7,17,24,0.708333333333333,0.291666666666667,1
"6661","GRXCR1",30,87,117,0.743589743589744,0.256410256410256,1
"6662","GRXCR2",12,29,41,0.707317073170732,0.292682926829268,1
"6663","GSAP",19,39,58,0.672413793103448,0.327586206896552,1
"6664","GSC",3,13,16,0.8125,0.1875,1
"6665","GSC2",2,3,5,0.6,0.4,1
"6666","GSDMA",18,22,40,0.55,0.45,1
"6667","GSDMB",14,17,31,0.548387096774194,0.451612903225806,1
"6668","GSDMC",33,64,97,0.65979381443299,0.34020618556701,1
"6669","GSDMD",14,19,33,0.575757575757576,0.424242424242424,1
"6670","GSDME",23,30,53,0.566037735849057,0.433962264150943,1
"6671","GSE1",46,59,105,0.561904761904762,0.438095238095238,1
"6672","GSG1",13,19,32,0.59375,0.40625,1
"6673","GSG1L",17,22,39,0.564102564102564,0.435897435897436,1
"6674","GSK3A",8,16,24,0.666666666666667,0.333333333333333,1
"6675","GSK3B",26,25,51,0.490196078431373,0.509803921568627,1
"6676","GSKIP",3,6,9,0.666666666666667,0.333333333333333,1
"6677","GSN",15,32,47,0.680851063829787,0.319148936170213,1
"6678","GSN-AS1",0,7,7,1,0,1
"6679","GSPT1",7,12,19,0.631578947368421,0.368421052631579,1
"6680","GSPT2",41,26,67,0.388059701492537,0.611940298507463,1
"6681","GSR",15,20,35,0.571428571428571,0.428571428571429,1
"6682","GSS",12,24,36,0.666666666666667,0.333333333333333,1
"6683","GSTA1",6,26,32,0.8125,0.1875,1
"6684","GSTA2",6,21,27,0.777777777777778,0.222222222222222,1
"6685","GSTA3",7,18,25,0.72,0.28,1
"6686","GSTA4",9,12,21,0.571428571428571,0.428571428571429,1
"6687","GSTA5",11,19,30,0.633333333333333,0.366666666666667,1
"6688","GSTCD",21,25,46,0.543478260869565,0.456521739130435,1
"6689","GSTK1",8,10,18,0.555555555555556,0.444444444444444,1
"6690","GSTM1",3,8,11,0.727272727272727,0.272727272727273,1
"6691","GSTM2",10,15,25,0.6,0.4,1
"6692","GSTM3",8,12,20,0.6,0.4,1
"6693","GSTM4",4,15,19,0.789473684210526,0.210526315789474,1
"6694","GSTM5",6,18,24,0.75,0.25,1
"6695","GSTO1",3,10,13,0.769230769230769,0.230769230769231,1
"6696","GSTO2",7,12,19,0.631578947368421,0.368421052631579,1
"6697","GSTP1",8,8,16,0.5,0.5,1
"6698","GSTT2",1,1,2,0.5,0.5,1
"6699","GSTT2B",6,8,14,0.571428571428571,0.428571428571429,1
"6700","GSTZ1",8,19,27,0.703703703703704,0.296296296296296,1
"6701","GSX1",6,6,12,0.5,0.5,1
"6702","GSX2",11,17,28,0.607142857142857,0.392857142857143,1
"6703","GTDC1",26,53,79,0.670886075949367,0.329113924050633,1
"6704","GTF2A1",8,26,34,0.764705882352941,0.235294117647059,1
"6705","GTF2A1L",0,1,1,1,0,1
"6706","GTF2A2",4,3,7,0.428571428571429,0.571428571428571,1
"6707","GTF2B",8,26,34,0.764705882352941,0.235294117647059,1
"6708","GTF2E1",17,33,50,0.66,0.34,1
"6709","GTF2E2",7,13,20,0.65,0.35,1
"6710","GTF2F1",14,28,42,0.666666666666667,0.333333333333333,1
"6711","GTF2F2",5,6,11,0.545454545454545,0.454545454545455,1
"6712","GTF2H1",14,28,42,0.666666666666667,0.333333333333333,1
"6713","GTF2H2",1,2,3,0.666666666666667,0.333333333333333,1
"6714","GTF2H2B",5,5,10,0.5,0.5,1
"6715","GTF2H2C",1,5,6,0.833333333333333,0.166666666666667,1
"6716","GTF2H3",8,11,19,0.578947368421053,0.421052631578947,1
"6717","GTF2H4",17,22,39,0.564102564102564,0.435897435897436,1
"6718","GTF2H5",0,3,3,1,0,1
"6719","GTF2I",45,73,118,0.61864406779661,0.38135593220339,1
"6720","GTF2IP3",0,2,2,1,0,1
"6721","GTF2IRD1",34,64,98,0.653061224489796,0.346938775510204,1
"6722","GTF2IRD2",25,40,65,0.615384615384615,0.384615384615385,1
"6723","GTF2IRD2B",17,38,55,0.690909090909091,0.309090909090909,1
"6724","GTF3A",7,6,13,0.461538461538462,0.538461538461538,1
"6725","GTF3C1",99,157,256,0.61328125,0.38671875,1
"6726","GTF3C2",37,53,90,0.588888888888889,0.411111111111111,1
"6727","GTF3C3",31,57,88,0.647727272727273,0.352272727272727,1
"6728","GTF3C4",17,35,52,0.673076923076923,0.326923076923077,1
"6729","GTF3C5",17,29,46,0.630434782608696,0.369565217391304,1
"6730","GTF3C6",4,12,16,0.75,0.25,1
"6731","GTPBP1",14,33,47,0.702127659574468,0.297872340425532,1
"6732","GTPBP10",12,21,33,0.636363636363636,0.363636363636364,1
"6733","GTPBP2",14,23,37,0.621621621621622,0.378378378378378,1
"6734","GTPBP3",23,26,49,0.530612244897959,0.469387755102041,1
"6735","GTPBP4",18,35,53,0.660377358490566,0.339622641509434,1
"6736","GTPBP6",8,14,22,0.636363636363636,0.363636363636364,1
"6737","GTPBP8",13,11,24,0.458333333333333,0.541666666666667,1
"6738","GTSE1",16,41,57,0.719298245614035,0.280701754385965,1
"6739","GTSF1",8,13,21,0.619047619047619,0.380952380952381,1
"6740","GTSF1L",8,16,24,0.666666666666667,0.333333333333333,1
"6741","GUCA1A",12,15,27,0.555555555555556,0.444444444444444,1
"6742","GUCA1B",4,14,18,0.777777777777778,0.222222222222222,1
"6743","GUCA1C",16,35,51,0.686274509803922,0.313725490196078,1
"6744","GUCA2A",1,7,8,0.875,0.125,1
"6745","GUCA2B",6,12,18,0.666666666666667,0.333333333333333,1
"6746","GUCD1",9,5,14,0.357142857142857,0.642857142857143,1
"6747","GUCY1A1",64,111,175,0.634285714285714,0.365714285714286,1
"6748","GUCY1A2",60,109,169,0.644970414201183,0.355029585798817,1
"6749","GUCY1B1",29,60,89,0.674157303370786,0.325842696629214,1
"6750","GUCY1B2",1,6,7,0.857142857142857,0.142857142857143,1
"6751","GUCY2C",53,119,172,0.691860465116279,0.308139534883721,1
"6752","GUCY2D",30,61,91,0.67032967032967,0.32967032967033,1
"6753","GUCY2F",74,69,143,0.482517482517482,0.517482517482518,1
"6754","GUF1",27,43,70,0.614285714285714,0.385714285714286,1
"6755","GUK1",6,8,14,0.571428571428571,0.428571428571429,1
"6756","GULP1",13,21,34,0.617647058823529,0.382352941176471,1
"6757","GUSB",23,44,67,0.656716417910448,0.343283582089552,1
"6758","GXYLT1",17,34,51,0.666666666666667,0.333333333333333,1
"6759","GXYLT2",11,28,39,0.717948717948718,0.282051282051282,1
"6760","GYG1",10,13,23,0.565217391304348,0.434782608695652,1
"6761","GYG2",23,12,35,0.342857142857143,0.657142857142857,1
"6762","GYG2P1",0,1,1,1,0,1
"6763","GYPA",11,25,36,0.694444444444444,0.305555555555556,1
"6764","GYPB",6,20,26,0.769230769230769,0.230769230769231,1
"6765","GYPC",13,11,24,0.458333333333333,0.541666666666667,1
"6766","GYPE",7,11,18,0.611111111111111,0.388888888888889,1
"6767","GYS1",20,37,57,0.649122807017544,0.350877192982456,1
"6768","GYS2",34,92,126,0.73015873015873,0.26984126984127,1
"6769","GZF1",33,38,71,0.535211267605634,0.464788732394366,1
"6770","GZMA",21,32,53,0.60377358490566,0.39622641509434,1
"6771","GZMB",11,23,34,0.676470588235294,0.323529411764706,1
"6772","GZMH",14,16,30,0.533333333333333,0.466666666666667,1
"6773","GZMK",22,32,54,0.592592592592593,0.407407407407407,1
"6774","GZMM",4,13,17,0.764705882352941,0.235294117647059,1
"6775","H1-0",7,5,12,0.416666666666667,0.583333333333333,1
"6776","H1-1",7,15,22,0.681818181818182,0.318181818181818,1
"6777","H1-10",3,6,9,0.666666666666667,0.333333333333333,1
"6778","H1-2",26,45,71,0.633802816901408,0.366197183098592,1
"6779","H1-3",16,30,46,0.652173913043478,0.347826086956522,1
"6780","H1-4",24,39,63,0.619047619047619,0.380952380952381,1
"6781","H1-5",26,32,58,0.551724137931034,0.448275862068966,1
"6782","H1-6",14,17,31,0.548387096774194,0.451612903225806,1
"6783","H1-7",14,18,32,0.5625,0.4375,1
"6784","H1-8",13,12,25,0.48,0.52,1
"6785","H2AB1",4,4,8,0.5,0.5,1
"6786","H2AC1",18,27,45,0.6,0.4,1
"6787","H2AC11",13,18,31,0.580645161290323,0.419354838709677,1
"6788","H2AC12",7,15,22,0.681818181818182,0.318181818181818,1
"6789","H2AC13",7,13,20,0.65,0.35,1
"6790","H2AC14",9,9,18,0.5,0.5,1
"6791","H2AC15",6,19,25,0.76,0.24,1
"6792","H2AC16",7,13,20,0.65,0.35,1
"6793","H2AC17",10,14,24,0.583333333333333,0.416666666666667,1
"6794","H2AC20",15,23,38,0.605263157894737,0.394736842105263,1
"6795","H2AC21",7,19,26,0.730769230769231,0.269230769230769,1
"6796","H2AC4",6,11,17,0.647058823529412,0.352941176470588,1
"6797","H2AC6",20,16,36,0.444444444444444,0.555555555555556,1
"6798","H2AC8",14,19,33,0.575757575757576,0.424242424242424,1
"6799","H2AJ",1,6,7,0.857142857142857,0.142857142857143,1
"6800","H2AP",9,5,14,0.357142857142857,0.642857142857143,1
"6801","H2AW",2,13,15,0.866666666666667,0.133333333333333,1
"6802","H2AX",6,13,19,0.684210526315789,0.315789473684211,1
"6803","H2AZ1",6,8,14,0.571428571428571,0.428571428571429,1
"6804","H2AZ2",5,7,12,0.583333333333333,0.416666666666667,1
"6805","H2BC1",12,11,23,0.478260869565217,0.521739130434783,1
"6806","H2BC10",9,15,24,0.625,0.375,1
"6807","H2BC11",14,10,24,0.416666666666667,0.583333333333333,1
"6808","H2BC12",9,16,25,0.64,0.36,1
"6809","H2BC13",8,12,20,0.6,0.4,1
"6810","H2BC14",12,12,24,0.5,0.5,1
"6811","H2BC15",6,9,15,0.6,0.4,1
"6812","H2BC17",5,9,14,0.642857142857143,0.357142857142857,1
"6813","H2BC18",7,14,21,0.666666666666667,0.333333333333333,1
"6814","H2BC21",6,22,28,0.785714285714286,0.214285714285714,1
"6815","H2BC3",6,16,22,0.727272727272727,0.272727272727273,1
"6816","H2BC4",17,24,41,0.585365853658537,0.414634146341463,1
"6817","H2BC5",8,23,31,0.741935483870968,0.258064516129032,1
"6818","H2BC6",4,12,16,0.75,0.25,1
"6819","H2BC7",14,15,29,0.517241379310345,0.482758620689655,1
"6820","H2BC8",12,17,29,0.586206896551724,0.413793103448276,1
"6821","H2BC9",12,17,29,0.586206896551724,0.413793103448276,1
"6822","H2BE1",0,2,2,1,0,1
"6823","H2BU1",6,6,12,0.5,0.5,1
"6824","H2BW1",17,18,35,0.514285714285714,0.485714285714286,1
"6825","H2BW2",0,1,1,1,0,1
"6826","H3-2",0,2,2,1,0,1
"6827","H3-3A",7,15,22,0.681818181818182,0.318181818181818,1
"6828","H3-3B",8,16,24,0.666666666666667,0.333333333333333,1
"6829","H3-4",8,12,20,0.6,0.4,1
"6830","H3-5",18,14,32,0.4375,0.5625,1
"6831","H3C1",3,6,9,0.666666666666667,0.333333333333333,1
"6832","H3C10",6,14,20,0.7,0.3,1
"6833","H3C11",13,21,34,0.617647058823529,0.382352941176471,1
"6834","H3C12",5,9,14,0.642857142857143,0.357142857142857,1
"6835","H3C13",10,17,27,0.62962962962963,0.37037037037037,1
"6836","H3C2",13,46,59,0.779661016949153,0.220338983050847,1
"6837","H3C3",8,25,33,0.757575757575758,0.242424242424242,1
"6838","H3C4",7,19,26,0.730769230769231,0.269230769230769,1
"6839","H3C6",13,12,25,0.48,0.52,1
"6840","H3C7",9,24,33,0.727272727272727,0.272727272727273,1
"6841","H3C8",4,16,20,0.8,0.2,1
"6842","H4-16",11,9,20,0.45,0.55,1
"6843","H4C1",3,8,11,0.727272727272727,0.272727272727273,1
"6844","H4C11",4,17,21,0.80952380952381,0.19047619047619,1
"6845","H4C12",7,21,28,0.75,0.25,1
"6846","H4C13",3,9,12,0.75,0.25,1
"6847","H4C2",9,11,20,0.55,0.45,1
"6848","H4C3",8,18,26,0.692307692307692,0.307692307692308,1
"6849","H4C4",8,21,29,0.724137931034483,0.275862068965517,1
"6850","H4C5",9,21,30,0.7,0.3,1
"6851","H4C6",5,15,20,0.75,0.25,1
"6852","H4C7",10,13,23,0.565217391304348,0.434782608695652,1
"6853","H4C8",5,9,14,0.642857142857143,0.357142857142857,1
"6854","H4C9",10,14,24,0.583333333333333,0.416666666666667,1
"6855","H6PD",32,36,68,0.529411764705882,0.470588235294118,1
"6856","HAAO",7,16,23,0.695652173913043,0.304347826086957,1
"6857","HABP2",18,41,59,0.694915254237288,0.305084745762712,1
"6858","HABP4",10,10,20,0.5,0.5,1
"6859","HACD1",14,13,27,0.481481481481481,0.518518518518518,0.63
"6860","HACD2",4,6,10,0.6,0.4,0.63
"6861","HACD3",4,11,15,0.733333333333333,0.266666666666667,0.63
"6862","HACD4",12,10,22,0.454545454545455,0.545454545454545,0.63
"6863","HACE1",44,55,99,0.555555555555556,0.444444444444444,0.57
"6864","HACL1",7,34,41,0.829268292682927,0.170731707317073,1
"6865","HADH",10,20,30,0.666666666666667,0.333333333333333,1
"6866","HADHA",22,34,56,0.607142857142857,0.392857142857143,1
"6867","HADHB",22,33,55,0.6,0.4,1
"6868","HAGH",9,12,21,0.571428571428571,0.428571428571429,1
"6869","HAGHL",7,12,19,0.631578947368421,0.368421052631579,1
"6870","HAL",29,43,72,0.597222222222222,0.402777777777778,1
"6871","HAMP",3,7,10,0.7,0.3,1
"6872","HAND1",12,13,25,0.52,0.48,1
"6873","HAND2",21,15,36,0.416666666666667,0.583333333333333,1
"6874","HAO1",33,54,87,0.620689655172414,0.379310344827586,1
"6875","HAO2",13,51,64,0.796875,0.203125,1
"6876","HAP1",21,39,60,0.65,0.35,1
"6877","HAPLN1",33,61,94,0.648936170212766,0.351063829787234,1
"6878","HAPLN2",6,9,15,0.6,0.4,1
"6879","HAPLN3",16,25,41,0.609756097560976,0.390243902439024,1
"6880","HAPLN4",16,28,44,0.636363636363636,0.363636363636364,1
"6881","HARBI1",14,17,31,0.548387096774194,0.451612903225806,0.77
"6882","HARS1",10,35,45,0.777777777777778,0.222222222222222,0.77
"6883","HARS2",17,15,32,0.46875,0.53125,0.77
"6884","HAS1",28,38,66,0.575757575757576,0.424242424242424,1
"6885","HAS2",33,50,83,0.602409638554217,0.397590361445783,1
"6886","HAS3",16,20,36,0.555555555555556,0.444444444444444,1
"6887","HASPIN",21,33,54,0.611111111111111,0.388888888888889,1
"6888","HAT1",13,26,39,0.666666666666667,0.333333333333333,1
"6889","HAUS1",10,26,36,0.722222222222222,0.277777777777778,1
"6890","HAUS2",7,5,12,0.416666666666667,0.583333333333333,1
"6891","HAUS3",24,30,54,0.555555555555556,0.444444444444444,1
"6892","HAUS4",8,16,24,0.666666666666667,0.333333333333333,1
"6893","HAUS5",23,22,45,0.488888888888889,0.511111111111111,1
"6894","HAUS6",34,51,85,0.6,0.4,1
"6895","HAUS7",16,8,24,0.333333333333333,0.666666666666667,1
"6896","HAUS8",9,19,28,0.678571428571429,0.321428571428571,1
"6897","HAVCR1",16,49,65,0.753846153846154,0.246153846153846,1
"6898","HAVCR2",25,26,51,0.509803921568627,0.490196078431373,1
"6899","HAX1",15,17,32,0.53125,0.46875,1
"6900","HBA1",1,2,3,0.666666666666667,0.333333333333333,1
"6901","HBA2",1,6,7,0.857142857142857,0.142857142857143,1
"6902","HBB",15,19,34,0.558823529411765,0.441176470588235,1
"6903","HBD",22,32,54,0.592592592592593,0.407407407407407,1
"6904","HBE1",8,29,37,0.783783783783784,0.216216216216216,1
"6905","HBEGF",6,5,11,0.454545454545455,0.545454545454545,1
"6906","HBG1",2,6,8,0.75,0.25,1
"6907","HBG2",19,40,59,0.677966101694915,0.322033898305085,1
"6908","HBM",4,1,5,0.2,0.8,1
"6909","HBP1",13,21,34,0.617647058823529,0.382352941176471,1
"6910","HBQ1",1,2,3,0.666666666666667,0.333333333333333,1
"6911","HBS1L",23,30,53,0.566037735849057,0.433962264150943,1
"6912","HBZ",0,3,3,1,0,1
"6913","HCAR1",17,15,32,0.46875,0.53125,0.77
"6914","HCAR2",19,27,46,0.58695652173913,0.41304347826087,0.77
"6915","HCAR3",13,25,38,0.657894736842105,0.342105263157895,0.77
"6916","HCCS",22,12,34,0.352941176470588,0.647058823529412,1
"6917","HCFC1",82,69,151,0.456953642384106,0.543046357615894,1
"6918","HCFC1R1",11,12,23,0.521739130434783,0.478260869565217,1
"6919","HCFC2",39,44,83,0.530120481927711,0.469879518072289,1
"6920","HCG27",3,4,7,0.571428571428571,0.428571428571429,1
"6921","HCK",34,54,88,0.613636363636364,0.386363636363636,1
"6922","HCLS1",23,58,81,0.716049382716049,0.283950617283951,1
"6923","HCN1",146,248,394,0.629441624365482,0.370558375634518,1
"6924","HCN2",24,26,50,0.52,0.48,1
"6925","HCN3",24,45,69,0.652173913043478,0.347826086956522,1
"6926","HCN4",60,83,143,0.58041958041958,0.41958041958042,1
"6927","HCRT",0,2,2,1,0,1
"6928","HCRTR1",14,17,31,0.548387096774194,0.451612903225806,1
"6929","HCRTR2",43,86,129,0.666666666666667,0.333333333333333,1
"6930","HCST",2,11,13,0.846153846153846,0.153846153846154,1
"6931","HDAC1",15,20,35,0.571428571428571,0.428571428571429,1
"6932","HDAC10",12,17,29,0.586206896551724,0.413793103448276,1
"6933","HDAC11",14,26,40,0.65,0.35,1
"6934","HDAC2",17,28,45,0.622222222222222,0.377777777777778,1
"6935","HDAC3",12,24,36,0.666666666666667,0.333333333333333,1
"6936","HDAC4",60,86,146,0.589041095890411,0.410958904109589,1
"6937","HDAC5",40,41,81,0.506172839506173,0.493827160493827,1
"6938","HDAC6",58,39,97,0.402061855670103,0.597938144329897,1
"6939","HDAC7",24,42,66,0.636363636363636,0.363636363636364,1
"6940","HDAC8",13,13,26,0.5,0.5,1
"6941","HDAC9",92,165,257,0.642023346303502,0.357976653696498,1
"6942","HDC",57,76,133,0.571428571428571,0.428571428571429,1
"6943","HDDC2",6,8,14,0.571428571428571,0.428571428571429,1
"6944","HDDC3",2,4,6,0.666666666666667,0.333333333333333,1
"6945","HDGF",17,22,39,0.564102564102564,0.435897435897436,1
"6946","HDGFL1",13,20,33,0.606060606060606,0.393939393939394,1
"6947","HDGFL2",18,36,54,0.666666666666667,0.333333333333333,1
"6948","HDGFL3",11,9,20,0.45,0.55,1
"6949","HDHD2",6,9,15,0.6,0.4,1
"6950","HDHD3",13,10,23,0.434782608695652,0.565217391304348,1
"6951","HDHD5",10,23,33,0.696969696969697,0.303030303030303,1
"6952","HDLBP",61,91,152,0.598684210526316,0.401315789473684,1
"6953","HDX",56,41,97,0.422680412371134,0.577319587628866,1
"6954","HEATR1",71,114,185,0.616216216216216,0.383783783783784,1
"6955","HEATR3",21,47,68,0.691176470588235,0.308823529411765,1
"6956","HEATR4",32,42,74,0.567567567567568,0.432432432432432,1
"6957","HEATR5A",50,79,129,0.612403100775194,0.387596899224806,1
"6958","HEATR5B",75,113,188,0.601063829787234,0.398936170212766,1
"6959","HEATR6",34,41,75,0.546666666666667,0.453333333333333,1
"6960","HEATR9",20,40,60,0.666666666666667,0.333333333333333,1
"6961","HEBP1",5,9,14,0.642857142857143,0.357142857142857,1
"6962","HEBP2",6,9,15,0.6,0.4,1
"6963","HECA",34,24,58,0.413793103448276,0.586206896551724,1
"6964","HECTD1",89,102,191,0.534031413612565,0.465968586387435,1
"6965","HECTD2",27,50,77,0.649350649350649,0.350649350649351,1
"6966","HECTD3",17,32,49,0.653061224489796,0.346938775510204,1
"6967","HECTD4",119,196,315,0.622222222222222,0.377777777777778,1
"6968","HECW1",122,227,349,0.650429799426934,0.349570200573066,1
"6969","HECW2",100,165,265,0.622641509433962,0.377358490566038,1
"6970","HEG1",43,71,114,0.62280701754386,0.37719298245614,1
"6971","HELB",42,66,108,0.611111111111111,0.388888888888889,1
"6972","HELLPAR",2,1,3,0.333333333333333,0.666666666666667,0.77
"6973","HELLS",30,38,68,0.558823529411765,0.441176470588235,1
"6974","HELQ",39,60,99,0.606060606060606,0.393939393939394,1
"6975","HELT",5,16,21,0.761904761904762,0.238095238095238,1
"6976","HELZ",57,121,178,0.679775280898876,0.320224719101124,1
"6977","HELZ2",65,106,171,0.619883040935672,0.380116959064327,1
"6978","HEMGN",19,43,62,0.693548387096774,0.306451612903226,1
"6979","HEMK1",9,11,20,0.55,0.45,1
"6980","HENMT1",13,25,38,0.657894736842105,0.342105263157895,1
"6981","HEPACAM",17,29,46,0.630434782608696,0.369565217391304,1
"6982","HEPACAM2",27,79,106,0.745283018867924,0.254716981132075,1
"6983","HEPH",106,112,218,0.513761467889908,0.486238532110092,1
"6984","HEPHL1",59,121,180,0.672222222222222,0.327777777777778,1
"6985","HEPN1",4,6,10,0.6,0.4,1
"6986","HERC1",137,231,368,0.627717391304348,0.372282608695652,1
"6987","HERC2",205,321,526,0.610266159695818,0.389733840304183,1
"6988","HERC2P3",79,170,249,0.682730923694779,0.317269076305221,1
"6989","HERC3",1,2,3,0.666666666666667,0.333333333333333,1
"6990","HERC4",29,58,87,0.666666666666667,0.333333333333333,1
"6991","HERC5",42,59,101,0.584158415841584,0.415841584158416,1
"6992","HERC6",31,46,77,0.597402597402597,0.402597402597403,1
"6993","HERPUD1",9,15,24,0.625,0.375,1
"6994","HERPUD2",13,30,43,0.697674418604651,0.302325581395349,1
"6995","HES1",8,17,25,0.68,0.32,1
"6996","HES2",1,6,7,0.857142857142857,0.142857142857143,1
"6997","HES3",3,3,6,0.5,0.5,1
"6998","HES4",2,2,4,0.5,0.5,1
"6999","HES5",2,0,2,0,1,1
"7000","HES6",3,3,6,0.5,0.5,1
"7001","HES7",1,2,3,0.666666666666667,0.333333333333333,1
"7002","HESX1",5,23,28,0.821428571428571,0.178571428571429,1
"7003","HEXA",24,17,41,0.414634146341463,0.585365853658537,1
"7004","HEXB",17,13,30,0.433333333333333,0.566666666666667,1
"7005","HEXD",13,19,32,0.59375,0.40625,1
"7006","HEXIM1",9,31,40,0.775,0.225,1
"7007","HEXIM2",7,17,24,0.708333333333333,0.291666666666667,1
"7008","HEY1",8,15,23,0.652173913043478,0.347826086956522,1
"7009","HEY2",18,28,46,0.608695652173913,0.391304347826087,1
"7010","HEYL",8,18,26,0.692307692307692,0.307692307692308,1
"7011","HFE",7,30,37,0.810810810810811,0.189189189189189,1
"7012","HFM1",81,143,224,0.638392857142857,0.361607142857143,1
"7013","HGD",25,42,67,0.626865671641791,0.373134328358209,1
"7014","HGF",93,123,216,0.569444444444444,0.430555555555556,1
"7015","HGFAC",21,41,62,0.661290322580645,0.338709677419355,1
"7016","HGH1",9,11,20,0.55,0.45,1
"7017","HGS",22,32,54,0.592592592592593,0.407407407407407,1
"7018","HGSNAT",27,29,56,0.517857142857143,0.482142857142857,1
"7019","HHAT",24,34,58,0.586206896551724,0.413793103448276,1
"7020","HHATL",18,32,50,0.64,0.36,1
"7021","HHEX",12,6,18,0.333333333333333,0.666666666666667,1
"7022","HHIP",55,72,127,0.566929133858268,0.433070866141732,1
"7023","HHIPL1",17,24,41,0.585365853658537,0.414634146341463,1
"7024","HHIPL2",45,100,145,0.689655172413793,0.310344827586207,1
"7025","HHLA1",0,6,6,1,0,1
"7026","HHLA2",14,51,65,0.784615384615385,0.215384615384615,1
"7027","HHLA3",1,2,3,0.666666666666667,0.333333333333333,1
"7028","HIBADH",13,9,22,0.409090909090909,0.590909090909091,1
"7029","HIBCH",11,13,24,0.541666666666667,0.458333333333333,1
"7030","HIC1",5,12,17,0.705882352941177,0.294117647058824,1
"7031","HIC2",26,37,63,0.587301587301587,0.412698412698413,1
"7032","HID1",29,34,63,0.53968253968254,0.46031746031746,1
"7033","HIF1A",26,33,59,0.559322033898305,0.440677966101695,1
"7034","HIF1AN",14,8,22,0.363636363636364,0.636363636363636,1
"7035","HIF3A",35,76,111,0.684684684684685,0.315315315315315,1
"7036","HIGD1A",2,5,7,0.714285714285714,0.285714285714286,1
"7037","HIGD1B",4,6,10,0.6,0.4,1
"7038","HIGD1C",1,3,4,0.75,0.25,1
"7039","HIGD2A",1,6,7,0.857142857142857,0.142857142857143,1
"7040","HIKESHI",5,13,18,0.722222222222222,0.277777777777778,1
"7041","HILPDA",1,1,2,0.5,0.5,1
"7042","HINFP",17,27,44,0.613636363636364,0.386363636363636,1
"7043","HINT1",3,0,3,0,1,1
"7044","HINT2",5,5,10,0.5,0.5,1
"7045","HINT3",2,9,11,0.818181818181818,0.181818181818182,1
"7046","HIP1",43,73,116,0.629310344827586,0.370689655172414,1
"7047","HIP1R",32,47,79,0.594936708860759,0.40506329113924,1
"7048","HIPK1",38,56,94,0.595744680851064,0.404255319148936,1
"7049","HIPK2",40,54,94,0.574468085106383,0.425531914893617,1
"7050","HIPK3",40,52,92,0.565217391304348,0.434782608695652,1
"7051","HIPK4",21,33,54,0.611111111111111,0.388888888888889,1
"7052","HIRA",48,61,109,0.559633027522936,0.440366972477064,1
"7053","HIRIP3",24,21,45,0.466666666666667,0.533333333333333,1
"7054","HIVEP1",78,163,241,0.676348547717842,0.323651452282158,1
"7055","HIVEP2",104,137,241,0.568464730290456,0.431535269709544,1
"7056","HIVEP3",94,163,257,0.634241245136187,0.365758754863813,1
"7057","HJURP",34,42,76,0.552631578947368,0.447368421052632,1
"7058","HJV",21,40,61,0.655737704918033,0.344262295081967,1
"7059","HK1",37,47,84,0.55952380952381,0.44047619047619,1
"7060","HK2",49,59,108,0.546296296296296,0.453703703703704,1
"7061","HK3",51,76,127,0.598425196850394,0.401574803149606,1
"7062","HKDC1",38,70,108,0.648148148148148,0.351851851851852,1
"7063","HLA-A",41,48,89,0.539325842696629,0.460674157303371,1
"7064","HLA-B",51,61,112,0.544642857142857,0.455357142857143,1
"7065","HLA-C",15,19,34,0.558823529411765,0.441176470588235,1
"7066","HLA-DMA",15,13,28,0.464285714285714,0.535714285714286,1
"7067","HLA-DMB",9,22,31,0.709677419354839,0.290322580645161,1
"7068","HLA-DOA",10,14,24,0.583333333333333,0.416666666666667,1
"7069","HLA-DOB",0,7,7,1,0,1
"7070","HLA-DPA1",12,14,26,0.538461538461538,0.461538461538462,1
"7071","HLA-DPB1",12,12,24,0.5,0.5,1
"7072","HLA-DQA1",2,13,15,0.866666666666667,0.133333333333333,1
"7073","HLA-DQA2",10,27,37,0.72972972972973,0.27027027027027,1
"7074","HLA-DQB1",15,14,29,0.482758620689655,0.517241379310345,1
"7075","HLA-DQB2",0,2,2,1,0,1
"7076","HLA-DRA",25,33,58,0.568965517241379,0.431034482758621,1
"7077","HLA-DRB1",2,8,10,0.8,0.2,1
"7078","HLA-DRB5",2,7,9,0.777777777777778,0.222222222222222,1
"7079","HLA-DRB9",10,15,25,0.6,0.4,1
"7080","HLA-E",12,21,33,0.636363636363636,0.363636363636364,1
"7081","HLA-F",11,16,27,0.592592592592593,0.407407407407407,1
"7082","HLA-G",15,27,42,0.642857142857143,0.357142857142857,1
"7083","HLA-L",4,13,17,0.764705882352941,0.235294117647059,1
"7084","HLCS",32,37,69,0.536231884057971,0.463768115942029,1
"7085","HLF",16,27,43,0.627906976744186,0.372093023255814,1
"7086","HLTF",35,53,88,0.602272727272727,0.397727272727273,1
"7087","HLX",27,45,72,0.625,0.375,1
"7088","HM13",10,20,30,0.666666666666667,0.333333333333333,1
"7089","HMBOX1",17,19,36,0.527777777777778,0.472222222222222,1
"7090","HMBS",10,15,25,0.6,0.4,1
"7091","HMCES",13,16,29,0.551724137931034,0.448275862068966,1
"7092","HMCN1",304,487,791,0.615676359039191,0.384323640960809,1
"7093","HMCN2",3,10,13,0.769230769230769,0.230769230769231,1
"7094","HMG20A",21,26,47,0.553191489361702,0.446808510638298,1
"7095","HMG20B",5,7,12,0.583333333333333,0.416666666666667,1
"7096","HMGA1",1,4,5,0.8,0.2,1
"7097","HMGA2",4,7,11,0.636363636363636,0.363636363636364,1
"7098","HMGB1",8,13,21,0.619047619047619,0.380952380952381,1
"7099","HMGB1P1",22,44,66,0.666666666666667,0.333333333333333,1
"7100","HMGB2",9,17,26,0.653846153846154,0.346153846153846,1
"7101","HMGB3",11,3,14,0.214285714285714,0.785714285714286,1
"7102","HMGB4",11,27,38,0.710526315789474,0.289473684210526,1
"7103","HMGCL",4,9,13,0.692307692307692,0.307692307692308,1
"7104","HMGCLL1",25,56,81,0.691358024691358,0.308641975308642,1
"7105","HMGCR",24,35,59,0.593220338983051,0.406779661016949,1
"7106","HMGCS1",16,24,40,0.6,0.4,1
"7107","HMGCS2",26,44,70,0.628571428571429,0.371428571428571,1
"7108","HMGN1",4,6,10,0.6,0.4,1
"7109","HMGN1P37",0,1,1,1,0,1
"7110","HMGN2",2,5,7,0.714285714285714,0.285714285714286,1
"7111","HMGN2P46",9,5,14,0.357142857142857,0.642857142857143,1
"7112","HMGN3",2,5,7,0.714285714285714,0.285714285714286,1
"7113","HMGN4",4,3,7,0.428571428571429,0.571428571428571,1
"7114","HMGN5",12,4,16,0.25,0.75,1
"7115","HMGXB3",0,7,7,1,0,1
"7116","HMGXB4",25,33,58,0.568965517241379,0.431034482758621,1
"7117","HMHB1",0,1,1,1,0,1
"7118","HMMR",37,43,80,0.5375,0.4625,1
"7119","HMOX1",12,15,27,0.555555555555556,0.444444444444444,1
"7120","HMOX2",5,11,16,0.6875,0.3125,1
"7121","HMSD",6,14,20,0.7,0.3,1
"7122","HMX2",14,20,34,0.588235294117647,0.411764705882353,1
"7123","HMX3",11,15,26,0.576923076923077,0.423076923076923,1
"7124","HNF1A",49,37,86,0.430232558139535,0.569767441860465,1
"7125","HNF1B",30,43,73,0.589041095890411,0.410958904109589,1
"7126","HNF4A",32,89,121,0.735537190082645,0.264462809917355,1
"7127","HNF4G",42,71,113,0.628318584070796,0.371681415929204,1
"7128","HNMT",8,19,27,0.703703703703704,0.296296296296296,1
"7129","HNRNPA0",2,11,13,0.846153846153846,0.153846153846154,1
"7130","HNRNPA1",19,28,47,0.595744680851064,0.404255319148936,1
"7131","HNRNPA1L2",10,11,21,0.523809523809524,0.476190476190476,1
"7132","HNRNPA2B1",24,50,74,0.675675675675676,0.324324324324324,1
"7133","HNRNPA3",17,32,49,0.653061224489796,0.346938775510204,1
"7134","HNRNPAB",17,15,32,0.46875,0.53125,1
"7135","HNRNPC",16,20,36,0.555555555555556,0.444444444444444,1
"7136","HNRNPCL1",19,56,75,0.746666666666667,0.253333333333333,1
"7137","HNRNPD",15,28,43,0.651162790697674,0.348837209302326,1
"7138","HNRNPDL",20,30,50,0.6,0.4,1
"7139","HNRNPF",21,30,51,0.588235294117647,0.411764705882353,1
"7140","HNRNPH1",20,25,45,0.555555555555556,0.444444444444444,1
"7141","HNRNPH2",27,20,47,0.425531914893617,0.574468085106383,1
"7142","HNRNPH3",10,16,26,0.615384615384615,0.384615384615385,1
"7143","HNRNPK",15,41,56,0.732142857142857,0.267857142857143,1
"7144","HNRNPL",35,48,83,0.578313253012048,0.421686746987952,1
"7145","HNRNPLL",11,18,29,0.620689655172414,0.379310344827586,1
"7146","HNRNPM",31,57,88,0.647727272727273,0.352272727272727,1
"7147","HNRNPR",20,23,43,0.534883720930233,0.465116279069767,1
"7148","HNRNPU",13,36,49,0.73469387755102,0.26530612244898,1
"7149","HNRNPUL1",38,52,90,0.577777777777778,0.422222222222222,1
"7150","HNRNPUL2",29,41,70,0.585714285714286,0.414285714285714,1
"7151","HOATZ",13,23,36,0.638888888888889,0.361111111111111,1
"7152","HOGA1",11,17,28,0.607142857142857,0.392857142857143,1
"7153","HOMER1",9,24,33,0.727272727272727,0.272727272727273,1
"7154","HOMER2",8,19,27,0.703703703703704,0.296296296296296,1
"7155","HOMER3",12,6,18,0.333333333333333,0.666666666666667,1
"7156","HOMEZ",19,34,53,0.641509433962264,0.358490566037736,1
"7157","HOOK1",36,44,80,0.55,0.45,1
"7158","HOOK2",24,32,56,0.571428571428571,0.428571428571429,1
"7159","HOOK3",20,36,56,0.642857142857143,0.357142857142857,1
"7160","HOPX",2,8,10,0.8,0.2,1
"7161","HORMAD1",17,43,60,0.716666666666667,0.283333333333333,1
"7162","HORMAD2",6,8,14,0.571428571428571,0.428571428571429,1
"7163","HOXA1",30,39,69,0.565217391304348,0.434782608695652,1
"7164","HOXA10",10,16,26,0.615384615384615,0.384615384615385,1
"7165","HOXA11",13,13,26,0.5,0.5,1
"7166","HOXA13",8,20,28,0.714285714285714,0.285714285714286,1
"7167","HOXA2",17,33,50,0.66,0.34,1
"7168","HOXA3",30,49,79,0.620253164556962,0.379746835443038,1
"7169","HOXA4",7,20,27,0.740740740740741,0.259259259259259,1
"7170","HOXA5",15,24,39,0.615384615384615,0.384615384615385,1
"7171","HOXA6",13,35,48,0.729166666666667,0.270833333333333,1
"7172","HOXA7",21,24,45,0.533333333333333,0.466666666666667,1
"7173","HOXA9",10,26,36,0.722222222222222,0.277777777777778,1
"7174","HOXB1",30,39,69,0.565217391304348,0.434782608695652,0.36
"7175","HOXB13",14,26,40,0.65,0.35,0.36
"7176","HOXB2",13,22,35,0.628571428571429,0.371428571428571,1
"7177","HOXB3",24,41,65,0.630769230769231,0.369230769230769,1
"7178","HOXB4",8,27,35,0.771428571428571,0.228571428571429,1
"7179","HOXB5",11,23,34,0.676470588235294,0.323529411764706,1
"7180","HOXB6",8,15,23,0.652173913043478,0.347826086956522,1
"7181","HOXB7",3,12,15,0.8,0.2,1
"7182","HOXB8",9,21,30,0.7,0.3,1
"7183","HOXB9",6,13,19,0.684210526315789,0.315789473684211,1
"7184","HOXC10",17,32,49,0.653061224489796,0.346938775510204,1
"7185","HOXC11",14,18,32,0.5625,0.4375,1
"7186","HOXC12",9,10,19,0.526315789473684,0.473684210526316,1
"7187","HOXC13",20,18,38,0.473684210526316,0.526315789473684,1
"7188","HOXC4",4,18,22,0.818181818181818,0.181818181818182,1
"7189","HOXC5",9,9,18,0.5,0.5,1
"7190","HOXC6",7,19,26,0.730769230769231,0.269230769230769,1
"7191","HOXC8",8,17,25,0.68,0.32,1
"7192","HOXC9",12,14,26,0.538461538461538,0.461538461538462,1
"7193","HOXD1",17,19,36,0.527777777777778,0.472222222222222,1
"7194","HOXD10",18,36,54,0.666666666666667,0.333333333333333,1
"7195","HOXD11",8,14,22,0.636363636363636,0.363636363636364,1
"7196","HOXD12",17,26,43,0.604651162790698,0.395348837209302,1
"7197","HOXD13",14,19,33,0.575757575757576,0.424242424242424,1
"7198","HOXD3",19,35,54,0.648148148148148,0.351851851851852,1
"7199","HOXD4",14,33,47,0.702127659574468,0.297872340425532,1
"7200","HOXD8",25,24,49,0.489795918367347,0.510204081632653,1
"7201","HOXD9",8,27,35,0.771428571428571,0.228571428571429,1
"7202","HP",9,15,24,0.625,0.375,1
"7203","HP1BP3",19,38,57,0.666666666666667,0.333333333333333,1
"7204","HPCA",5,10,15,0.666666666666667,0.333333333333333,1
"7205","HPCAL1",10,11,21,0.523809523809524,0.476190476190476,1
"7206","HPCAL4",13,12,25,0.48,0.52,1
"7207","HPD",20,25,45,0.555555555555556,0.444444444444444,1
"7208","HPDL",6,11,17,0.647058823529412,0.352941176470588,1
"7209","HPF1",8,14,22,0.636363636363636,0.363636363636364,1
"7210","HPGD",13,7,20,0.35,0.65,1
"7211","HPGDS",6,15,21,0.714285714285714,0.285714285714286,1
"7212","HPN",18,29,47,0.617021276595745,0.382978723404255,1
"7213","HPR",20,23,43,0.534883720930233,0.465116279069767,1
"7214","HPRT1",7,7,14,0.5,0.5,1
"7215","HPS1",20,30,50,0.6,0.4,1
"7216","HPS3",25,50,75,0.666666666666667,0.333333333333333,1
"7217","HPS4",23,34,57,0.596491228070175,0.403508771929825,1
"7218","HPS5",28,47,75,0.626666666666667,0.373333333333333,1
"7219","HPS6",17,27,44,0.613636363636364,0.386363636363636,1
"7220","HPSE",25,32,57,0.56140350877193,0.43859649122807,1
"7221","HPSE2",41,59,100,0.59,0.41,1
"7222","HPX",14,35,49,0.714285714285714,0.285714285714286,1
"7223","HR",38,47,85,0.552941176470588,0.447058823529412,1
"7224","HRAS",55,66,121,0.545454545454545,0.454545454545455,1
"7225","HRC",29,52,81,0.641975308641975,0.358024691358025,1
"7226","HRCT1",0,3,3,1,0,1
"7227","HRG",36,51,87,0.586206896551724,0.413793103448276,1
"7228","HRH1",19,40,59,0.677966101694915,0.322033898305085,1
"7229","HRH2",25,33,58,0.568965517241379,0.431034482758621,1
"7230","HRH3",14,32,46,0.695652173913043,0.304347826086957,1
"7231","HRH4",21,27,48,0.5625,0.4375,1
"7232","HRNR",122,202,324,0.623456790123457,0.376543209876543,1
"7233","HROB",28,22,50,0.44,0.56,1
"7234","HS1BP3",10,24,34,0.705882352941177,0.294117647058824,1
"7235","HS1BP3-IT1",0,1,1,1,0,1
"7236","HS2ST1",13,20,33,0.606060606060606,0.393939393939394,1
"7237","HS3ST1",20,26,46,0.565217391304348,0.434782608695652,1
"7238","HS3ST2",29,30,59,0.508474576271186,0.491525423728814,1
"7239","HS3ST3A1",29,21,50,0.42,0.58,1
"7240","HS3ST3B1",10,19,29,0.655172413793103,0.344827586206897,1
"7241","HS3ST4",28,71,99,0.717171717171717,0.282828282828283,1
"7242","HS3ST5",25,49,74,0.662162162162162,0.337837837837838,1
"7243","HS3ST6",9,19,28,0.678571428571429,0.321428571428571,1
"7244","HS6ST1",17,17,34,0.5,0.5,1
"7245","HS6ST2",30,11,41,0.268292682926829,0.731707317073171,1
"7246","HS6ST3",30,47,77,0.61038961038961,0.38961038961039,1
"7247","HSBP1",1,1,2,0.5,0.5,1
"7248","HSBP1L1",0,1,1,1,0,1
"7249","HSCB",6,20,26,0.769230769230769,0.230769230769231,1
"7250","HSD11B1",26,24,50,0.48,0.52,1
"7251","HSD11B1L",2,5,7,0.714285714285714,0.285714285714286,1
"7252","HSD11B2",11,8,19,0.421052631578947,0.578947368421053,1
"7253","HSD17B1",11,9,20,0.45,0.55,1
"7254","HSD17B10",14,2,16,0.125,0.875,1
"7255","HSD17B11",12,11,23,0.478260869565217,0.521739130434783,1
"7256","HSD17B12",9,15,24,0.625,0.375,1
"7257","HSD17B13",9,14,23,0.608695652173913,0.391304347826087,1
"7258","HSD17B14",9,16,25,0.64,0.36,1
"7259","HSD17B2",9,38,47,0.808510638297872,0.191489361702128,1
"7260","HSD17B3",12,14,26,0.538461538461538,0.461538461538462,1
"7261","HSD17B4",25,32,57,0.56140350877193,0.43859649122807,1
"7262","HSD17B6",11,15,26,0.576923076923077,0.423076923076923,1
"7263","HSD17B7",8,13,21,0.619047619047619,0.380952380952381,1
"7264","HSD17B8",5,12,17,0.705882352941177,0.294117647058824,1
"7265","HSD3B1",27,34,61,0.557377049180328,0.442622950819672,1
"7266","HSD3B2",17,43,60,0.716666666666667,0.283333333333333,1
"7267","HSD3B7",14,19,33,0.575757575757576,0.424242424242424,1
"7268","HSDL1",13,10,23,0.434782608695652,0.565217391304348,1
"7269","HSDL2",13,16,29,0.551724137931034,0.448275862068966,1
"7270","HSF1",14,22,36,0.611111111111111,0.388888888888889,1
"7271","HSF2",13,31,44,0.704545454545455,0.295454545454545,1
"7272","HSF2BP",8,2,10,0.2,0.8,1
"7273","HSF4",11,10,21,0.476190476190476,0.523809523809524,1
"7274","HSF5",21,36,57,0.631578947368421,0.368421052631579,1
"7275","HSFX1",7,1,8,0.125,0.875,1
"7276","HSH2D",14,13,27,0.481481481481481,0.518518518518518,1
"7277","HSP90AA1",30,55,85,0.647058823529412,0.352941176470588,1
"7278","HSP90AB1",28,50,78,0.641025641025641,0.358974358974359,1
"7279","HSP90B1",27,46,73,0.63013698630137,0.36986301369863,1
"7280","HSPA12A",35,62,97,0.639175257731959,0.360824742268041,1
"7281","HSPA12B",24,29,53,0.547169811320755,0.452830188679245,1
"7282","HSPA13",17,41,58,0.706896551724138,0.293103448275862,1
"7283","HSPA14",15,22,37,0.594594594594595,0.405405405405405,1
"7284","HSPA1A",9,9,18,0.5,0.5,1
"7285","HSPA1B",3,11,14,0.785714285714286,0.214285714285714,1
"7286","HSPA1L",38,51,89,0.573033707865168,0.426966292134831,1
"7287","HSPA2",41,36,77,0.467532467532468,0.532467532467532,1
"7288","HSPA4",23,31,54,0.574074074074074,0.425925925925926,1
"7289","HSPA4L",34,40,74,0.540540540540541,0.459459459459459,1
"7290","HSPA5",22,27,49,0.551020408163265,0.448979591836735,1
"7291","HSPA6",36,51,87,0.586206896551724,0.413793103448276,1
"7292","HSPA8",33,48,81,0.592592592592593,0.407407407407407,1
"7293","HSPA9",13,29,42,0.69047619047619,0.30952380952381,1
"7294","HSPB1",3,5,8,0.625,0.375,1
"7295","HSPB11",7,10,17,0.588235294117647,0.411764705882353,1
"7296","HSPB2",8,9,17,0.529411764705882,0.470588235294118,1
"7297","HSPB3",7,13,20,0.65,0.35,1
"7298","HSPB6",1,1,2,0.5,0.5,1
"7299","HSPB7",6,11,17,0.647058823529412,0.352941176470588,1
"7300","HSPB8",12,23,35,0.657142857142857,0.342857142857143,1
"7301","HSPB9",6,7,13,0.538461538461538,0.461538461538462,1
"7302","HSPBAP1",8,26,34,0.764705882352941,0.235294117647059,1
"7303","HSPBP1",4,14,18,0.777777777777778,0.222222222222222,1
"7304","HSPD1",17,23,40,0.575,0.425,1
"7305","HSPE1",2,1,3,0.333333333333333,0.666666666666667,1
"7306","HSPE1-MOB4",1,3,4,0.75,0.25,1
"7307","HSPG2",109,161,270,0.596296296296296,0.403703703703704,1
"7308","HSPH1",27,50,77,0.649350649350649,0.350649350649351,1
"7309","HTATIP2",11,5,16,0.3125,0.6875,1
"7310","HTATSF1",55,34,89,0.382022471910112,0.617977528089888,1
"7311","HTN1",7,8,15,0.533333333333333,0.466666666666667,1
"7312","HTN3",4,4,8,0.5,0.5,1
"7313","HTR1A",62,69,131,0.526717557251908,0.473282442748092,1
"7314","HTR1B",20,50,70,0.714285714285714,0.285714285714286,1
"7315","HTR1D",12,26,38,0.684210526315789,0.315789473684211,1
"7316","HTR1E",38,68,106,0.641509433962264,0.358490566037736,1
"7317","HTR1F",34,44,78,0.564102564102564,0.435897435897436,1
"7318","HTR2A",22,45,67,0.671641791044776,0.328358208955224,1
"7319","HTR2B",10,30,40,0.75,0.25,1
"7320","HTR2C",33,64,97,0.65979381443299,0.34020618556701,1
"7321","HTR3A",39,58,97,0.597938144329897,0.402061855670103,1
"7322","HTR3B",22,54,76,0.710526315789474,0.289473684210526,1
"7323","HTR3C",20,38,58,0.655172413793103,0.344827586206897,1
"7324","HTR3D",13,24,37,0.648648648648649,0.351351351351351,1
"7325","HTR3E",23,42,65,0.646153846153846,0.353846153846154,1
"7326","HTR4",18,36,54,0.666666666666667,0.333333333333333,1
"7327","HTR5A",51,76,127,0.598425196850394,0.401574803149606,1
"7328","HTR6",18,31,49,0.63265306122449,0.36734693877551,1
"7329","HTR7",41,57,98,0.581632653061224,0.418367346938776,1
"7330","HTRA1",19,39,58,0.672413793103448,0.327586206896552,1
"7331","HTRA2",12,23,35,0.657142857142857,0.342857142857143,1
"7332","HTRA3",19,20,39,0.512820512820513,0.487179487179487,1
"7333","HTRA4",17,23,40,0.575,0.425,1
"7334","HTT",81,149,230,0.647826086956522,0.352173913043478,1
"7335","HUNK",24,56,80,0.7,0.3,1
"7336","HUS1",10,13,23,0.565217391304348,0.434782608695652,1
"7337","HUS1B",11,22,33,0.666666666666667,0.333333333333333,1
"7338","HUWE1",225,155,380,0.407894736842105,0.592105263157895,1
"7339","HVCN1",16,19,35,0.542857142857143,0.457142857142857,1
"7340","HYAL1",14,19,33,0.575757575757576,0.424242424242424,1
"7341","HYAL2",10,21,31,0.67741935483871,0.32258064516129,1
"7342","HYAL3",13,11,24,0.458333333333333,0.541666666666667,1
"7343","HYAL4",34,45,79,0.569620253164557,0.430379746835443,1
"7344","HYDIN",212,412,624,0.66025641025641,0.33974358974359,1
"7345","HYI",10,4,14,0.285714285714286,0.714285714285714,1
"7346","HYKK",10,14,24,0.583333333333333,0.416666666666667,1
"7347","HYLS1",9,12,21,0.571428571428571,0.428571428571429,1
"7348","HYOU1",37,42,79,0.531645569620253,0.468354430379747,1
"7349","HYPK",2,5,7,0.714285714285714,0.285714285714286,1
"7350","IAH1",7,9,16,0.5625,0.4375,1
"7351","IAPP",10,7,17,0.411764705882353,0.588235294117647,1
"7352","IARS1",28,59,87,0.67816091954023,0.32183908045977,0.77
"7353","IARS2",48,64,112,0.571428571428571,0.428571428571429,0.77
"7354","IBA57",12,15,27,0.555555555555556,0.444444444444444,1
"7355","IBSP",23,44,67,0.656716417910448,0.343283582089552,1
"7356","IBTK",55,71,126,0.563492063492063,0.436507936507937,1
"7357","ICA1",27,44,71,0.619718309859155,0.380281690140845,1
"7358","ICA1L",12,28,40,0.7,0.3,1
"7359","ICAM1",20,20,40,0.5,0.5,1
"7360","ICAM2",10,13,23,0.565217391304348,0.434782608695652,1
"7361","ICAM3",18,14,32,0.4375,0.5625,1
"7362","ICAM4",11,17,28,0.607142857142857,0.392857142857143,1
"7363","ICAM5",34,44,78,0.564102564102564,0.435897435897436,1
"7364","ICE1",97,155,252,0.615079365079365,0.384920634920635,1
"7365","ICE2",37,44,81,0.54320987654321,0.45679012345679,1
"7366","ICMT",6,11,17,0.647058823529412,0.352941176470588,1
"7367","ICOS",10,19,29,0.655172413793103,0.344827586206897,1
"7368","ID1",4,8,12,0.666666666666667,0.333333333333333,1
"7369","ID2",4,4,8,0.5,0.5,1
"7370","ID3",3,8,11,0.727272727272727,0.272727272727273,1
"7371","ID4",2,2,4,0.5,0.5,1
"7372","IDE",41,39,80,0.4875,0.5125,1
"7373","IDH1",218,291,509,0.571709233791749,0.428290766208251,1
"7374","IDH2",34,29,63,0.46031746031746,0.53968253968254,1
"7375","IDH3A",9,17,26,0.653846153846154,0.346153846153846,1
"7376","IDH3B",6,17,23,0.739130434782609,0.260869565217391,1
"7377","IDH3G",27,7,34,0.205882352941176,0.794117647058823,1
"7378","IDI1",12,7,19,0.368421052631579,0.631578947368421,1
"7379","IDI2",11,10,21,0.476190476190476,0.523809523809524,1
"7380","IDNK",5,7,12,0.583333333333333,0.416666666666667,1
"7381","IDO1",28,39,67,0.582089552238806,0.417910447761194,1
"7382","IDO2",18,49,67,0.73134328358209,0.26865671641791,1
"7383","IDS",16,5,21,0.238095238095238,0.761904761904762,1
"7384","IDUA",11,17,28,0.607142857142857,0.392857142857143,1
"7385","IER2",3,10,13,0.769230769230769,0.230769230769231,1
"7386","IER3",3,2,5,0.4,0.6,1
"7387","IER3IP1",3,3,6,0.5,0.5,1
"7388","IER5",3,8,11,0.727272727272727,0.272727272727273,1
"7389","IER5L",3,1,4,0.25,0.75,1
"7390","IFFO1",24,24,48,0.5,0.5,1
"7391","IFFO2",0,1,1,1,0,1
"7392","IFI16",48,54,102,0.529411764705882,0.470588235294118,1
"7393","IFI27",2,8,10,0.8,0.2,1
"7394","IFI27L1",2,4,6,0.666666666666667,0.333333333333333,1
"7395","IFI27L2",5,6,11,0.545454545454545,0.454545454545455,1
"7396","IFI30",6,8,14,0.571428571428571,0.428571428571429,1
"7397","IFI35",8,16,24,0.666666666666667,0.333333333333333,1
"7398","IFI44",20,27,47,0.574468085106383,0.425531914893617,1
"7399","IFI44L",20,43,63,0.682539682539683,0.317460317460317,1
"7400","IFI6",5,3,8,0.375,0.625,1
"7401","IFIH1",38,56,94,0.595744680851064,0.404255319148936,1
"7402","IFIT1",14,21,35,0.6,0.4,1
"7403","IFIT1B",10,34,44,0.772727272727273,0.227272727272727,1
"7404","IFIT2",22,29,51,0.568627450980392,0.431372549019608,1
"7405","IFIT3",17,20,37,0.540540540540541,0.459459459459459,1
"7406","IFIT5",18,21,39,0.538461538461538,0.461538461538462,1
"7407","IFITM1",7,7,14,0.5,0.5,1
"7408","IFITM2",3,4,7,0.571428571428571,0.428571428571429,1
"7409","IFITM3",4,5,9,0.555555555555556,0.444444444444444,1
"7410","IFITM5",3,6,9,0.666666666666667,0.333333333333333,1
"7411","IFNA1",11,11,22,0.5,0.5,1
"7412","IFNA10",12,15,27,0.555555555555556,0.444444444444444,1
"7413","IFNA13",8,16,24,0.666666666666667,0.333333333333333,1
"7414","IFNA14",8,16,24,0.666666666666667,0.333333333333333,1
"7415","IFNA16",15,33,48,0.6875,0.3125,1
"7416","IFNA17",3,18,21,0.857142857142857,0.142857142857143,1
"7417","IFNA2",7,23,30,0.766666666666667,0.233333333333333,1
"7418","IFNA21",13,12,25,0.48,0.52,1
"7419","IFNA4",6,20,26,0.769230769230769,0.230769230769231,1
"7420","IFNA5",10,15,25,0.6,0.4,1
"7421","IFNA6",16,12,28,0.428571428571429,0.571428571428571,1
"7422","IFNA7",13,18,31,0.580645161290323,0.419354838709677,1
"7423","IFNA8",10,21,31,0.67741935483871,0.32258064516129,1
"7424","IFNAR1",19,19,38,0.5,0.5,0.77
"7425","IFNAR2",19,20,39,0.512820512820513,0.487179487179487,0.77
"7426","IFNB1",8,19,27,0.703703703703704,0.296296296296296,1
"7427","IFNE",10,15,25,0.6,0.4,1
"7428","IFNG",12,31,43,0.720930232558139,0.27906976744186,1
"7429","IFNGR1",17,32,49,0.653061224489796,0.346938775510204,1
"7430","IFNGR2",8,24,32,0.75,0.25,1
"7431","IFNK",8,9,17,0.529411764705882,0.470588235294118,1
"7432","IFNL1",5,12,17,0.705882352941177,0.294117647058824,1
"7433","IFNL2",8,11,19,0.578947368421053,0.421052631578947,1
"7434","IFNL3",8,23,31,0.741935483870968,0.258064516129032,1
"7435","IFNLR1",23,16,39,0.41025641025641,0.58974358974359,1
"7436","IFNW1",7,17,24,0.708333333333333,0.291666666666667,1
"7437","IFRD1",28,27,55,0.490909090909091,0.509090909090909,1
"7438","IFRD2",14,19,33,0.575757575757576,0.424242424242424,1
"7439","IFT122",51,65,116,0.560344827586207,0.439655172413793,1
"7440","IFT140",50,62,112,0.553571428571429,0.446428571428571,1
"7441","IFT172",74,91,165,0.551515151515152,0.448484848484848,1
"7442","IFT20",4,7,11,0.636363636363636,0.363636363636364,1
"7443","IFT22",6,8,14,0.571428571428571,0.428571428571429,1
"7444","IFT27",5,5,10,0.5,0.5,1
"7445","IFT43",7,21,28,0.75,0.25,1
"7446","IFT46",8,15,23,0.652173913043478,0.347826086956522,1
"7447","IFT52",19,21,40,0.525,0.475,1
"7448","IFT57",15,17,32,0.53125,0.46875,1
"7449","IFT74",16,22,38,0.578947368421053,0.421052631578947,1
"7450","IFT80",29,54,83,0.650602409638554,0.349397590361446,1
"7451","IFT81",29,28,57,0.491228070175439,0.508771929824561,1
"7452","IFT88",30,38,68,0.558823529411765,0.441176470588235,1
"7453","IFTAP",11,13,24,0.541666666666667,0.458333333333333,1
"7454","IGBP1",17,6,23,0.260869565217391,0.739130434782609,1
"7455","IGBP1P2",27,36,63,0.571428571428571,0.428571428571429,1
"7456","IGDCC3",40,50,90,0.555555555555556,0.444444444444444,1
"7457","IGDCC4",48,65,113,0.575221238938053,0.424778761061947,1
"7458","IGF1",11,21,32,0.65625,0.34375,1
"7459","IGF1R",46,76,122,0.622950819672131,0.377049180327869,1
"7460","IGF2",11,24,35,0.685714285714286,0.314285714285714,1
"7461","IGF2BP1",46,74,120,0.616666666666667,0.383333333333333,1
"7462","IGF2BP2",12,34,46,0.739130434782609,0.260869565217391,1
"7463","IGF2BP3",21,51,72,0.708333333333333,0.291666666666667,1
"7464","IGF2R",110,158,268,0.58955223880597,0.41044776119403,1
"7465","IGFALS",17,16,33,0.484848484848485,0.515151515151515,1
"7466","IGFBP1",16,22,38,0.578947368421053,0.421052631578947,1
"7467","IGFBP2",8,15,23,0.652173913043478,0.347826086956522,1
"7468","IGFBP3",19,17,36,0.472222222222222,0.527777777777778,1
"7469","IGFBP4",7,11,18,0.611111111111111,0.388888888888889,1
"7470","IGFBP5",8,11,19,0.578947368421053,0.421052631578947,1
"7471","IGFBP6",6,7,13,0.538461538461538,0.461538461538462,1
"7472","IGFBP7",12,9,21,0.428571428571429,0.571428571428571,1
"7473","IGFBPL1",6,15,21,0.714285714285714,0.285714285714286,1
"7474","IGFL1",6,13,19,0.684210526315789,0.315789473684211,1
"7475","IGFL2",5,16,21,0.761904761904762,0.238095238095238,1
"7476","IGFL3",5,15,20,0.75,0.25,1
"7477","IGFL4",3,9,12,0.75,0.25,1
"7478","IGFLR1",16,15,31,0.483870967741935,0.516129032258065,1
"7479","IGFN1",39,59,98,0.602040816326531,0.397959183673469,1
"7480","IGHA1",29,43,72,0.597222222222222,0.402777777777778,1
"7481","IGHA2",23,25,48,0.520833333333333,0.479166666666667,1
"7482","IGHD",18,22,40,0.55,0.45,1
"7483","IGHD1-20",0,1,1,1,0,1
"7484","IGHD1-7",0,1,1,1,0,1
"7485","IGHD2-21",0,3,3,1,0,1
"7486","IGHD3-22",0,1,1,1,0,1
"7487","IGHD3-9",1,1,2,0.5,0.5,1
"7488","IGHD4-17",1,0,1,0,1,1
"7489","IGHD5-18",1,0,1,0,1,1
"7490","IGHD6-13",1,2,3,0.666666666666667,0.333333333333333,1
"7491","IGHD6-19",2,0,2,0,1,1
"7492","IGHD6-25",0,1,1,1,0,1
"7493","IGHE",16,48,64,0.75,0.25,1
"7494","IGHG1",22,76,98,0.775510204081633,0.224489795918367,1
"7495","IGHG2",27,63,90,0.7,0.3,1
"7496","IGHG3",33,40,73,0.547945205479452,0.452054794520548,1
"7497","IGHG4",21,55,76,0.723684210526316,0.276315789473684,1
"7498","IGHJ2",0,1,1,1,0,1
"7499","IGHJ4",0,2,2,1,0,1
"7500","IGHJ5",0,2,2,1,0,1
"7501","IGHJ6",5,1,6,0.166666666666667,0.833333333333333,1
"7502","IGHM",40,78,118,0.661016949152542,0.338983050847458,1
"7503","IGHMBP2",35,66,101,0.653465346534653,0.346534653465347,1
"7504","IGHV1-12",8,17,25,0.68,0.32,1
"7505","IGHV1-18",12,20,32,0.625,0.375,1
"7506","IGHV1-2",10,23,33,0.696969696969697,0.303030303030303,1
"7507","IGHV1-24",12,21,33,0.636363636363636,0.363636363636364,1
"7508","IGHV1-3",6,18,24,0.75,0.25,1
"7509","IGHV1-45",15,28,43,0.651162790697674,0.348837209302326,1
"7510","IGHV1-46",13,19,32,0.59375,0.40625,1
"7511","IGHV1-58",11,20,31,0.645161290322581,0.354838709677419,1
"7512","IGHV1-69",4,5,9,0.555555555555556,0.444444444444444,1
"7513","IGHV1OR15-9",21,34,55,0.618181818181818,0.381818181818182,1
"7514","IGHV1OR21-1",36,77,113,0.68141592920354,0.31858407079646,1
"7515","IGHV2-26",9,17,26,0.653846153846154,0.346153846153846,1
"7516","IGHV2-5",7,13,20,0.65,0.35,1
"7517","IGHV2-70",7,21,28,0.75,0.25,1
"7518","IGHV2OR16-5",1,0,1,0,1,1
"7519","IGHV3-11",8,12,20,0.6,0.4,1
"7520","IGHV3-13",6,12,18,0.666666666666667,0.333333333333333,1
"7521","IGHV3-15",11,17,28,0.607142857142857,0.392857142857143,1
"7522","IGHV3-16",8,24,32,0.75,0.25,1
"7523","IGHV3-20",18,26,44,0.590909090909091,0.409090909090909,1
"7524","IGHV3-21",8,23,31,0.741935483870968,0.258064516129032,1
"7525","IGHV3-23",9,37,46,0.804347826086957,0.195652173913043,1
"7526","IGHV3-30",8,26,34,0.764705882352941,0.235294117647059,1
"7527","IGHV3-33",4,18,22,0.818181818181818,0.181818181818182,1
"7528","IGHV3-35",8,16,24,0.666666666666667,0.333333333333333,1
"7529","IGHV3-38",9,13,22,0.590909090909091,0.409090909090909,1
"7530","IGHV3-43",19,11,30,0.366666666666667,0.633333333333333,1
"7531","IGHV3-48",6,18,24,0.75,0.25,1
"7532","IGHV3-49",9,14,23,0.608695652173913,0.391304347826087,1
"7533","IGHV3-53",7,19,26,0.730769230769231,0.269230769230769,1
"7534","IGHV3-64",5,11,16,0.6875,0.3125,1
"7535","IGHV3-66",11,18,29,0.620689655172414,0.379310344827586,1
"7536","IGHV3-7",6,13,19,0.684210526315789,0.315789473684211,1
"7537","IGHV3-72",14,16,30,0.533333333333333,0.466666666666667,1
"7538","IGHV3-73",4,11,15,0.733333333333333,0.266666666666667,1
"7539","IGHV3-74",6,17,23,0.739130434782609,0.260869565217391,1
"7540","IGHV3OR16-8",23,28,51,0.549019607843137,0.450980392156863,1
"7541","IGHV4-28",11,22,33,0.666666666666667,0.333333333333333,1
"7542","IGHV4-31",8,16,24,0.666666666666667,0.333333333333333,1
"7543","IGHV4-34",13,20,33,0.606060606060606,0.393939393939394,1
"7544","IGHV4-39",7,9,16,0.5625,0.4375,1
"7545","IGHV4-4",2,1,3,0.333333333333333,0.666666666666667,1
"7546","IGHV4-59",3,25,28,0.892857142857143,0.107142857142857,1
"7547","IGHV4-61",8,11,19,0.578947368421053,0.421052631578947,1
"7548","IGHV5-51",14,22,36,0.611111111111111,0.388888888888889,1
"7549","IGHV6-1",9,21,30,0.7,0.3,1
"7550","IGHV7-81",9,12,21,0.571428571428571,0.428571428571429,1
"7551","IGIP",4,7,11,0.636363636363636,0.363636363636364,1
"7552","IGKC",5,17,22,0.772727272727273,0.227272727272727,1
"7553","IGKJ1",2,2,4,0.5,0.5,1
"7554","IGKJ2",2,0,2,0,1,1
"7555","IGKJ3",0,1,1,1,0,1
"7556","IGKJ4",2,2,4,0.5,0.5,1
"7557","IGKJ5",2,4,6,0.666666666666667,0.333333333333333,1
"7558","IGKV1-12",17,43,60,0.716666666666667,0.283333333333333,1
"7559","IGKV1-13",18,43,61,0.704918032786885,0.295081967213115,1
"7560","IGKV1-16",14,38,52,0.730769230769231,0.269230769230769,1
"7561","IGKV1-17",14,31,45,0.688888888888889,0.311111111111111,1
"7562","IGKV1-27",15,27,42,0.642857142857143,0.357142857142857,1
"7563","IGKV1-33",0,10,10,1,0,1
"7564","IGKV1-37",0,1,1,1,0,1
"7565","IGKV1-39",0,2,2,1,0,1
"7566","IGKV1-5",20,38,58,0.655172413793103,0.344827586206897,1
"7567","IGKV1-6",8,24,32,0.75,0.25,1
"7568","IGKV1-8",14,19,33,0.575757575757576,0.424242424242424,1
"7569","IGKV1-9",20,26,46,0.565217391304348,0.434782608695652,1
"7570","IGKV1D-12",2,5,7,0.714285714285714,0.285714285714286,1
"7571","IGKV1D-13",11,18,29,0.620689655172414,0.379310344827586,1
"7572","IGKV1D-16",20,30,50,0.6,0.4,1
"7573","IGKV1D-17",21,26,47,0.553191489361702,0.446808510638298,1
"7574","IGKV1D-33",4,8,12,0.666666666666667,0.333333333333333,1
"7575","IGKV1D-42",13,34,47,0.723404255319149,0.276595744680851,1
"7576","IGKV1D-43",13,33,46,0.717391304347826,0.282608695652174,1
"7577","IGKV1D-8",15,36,51,0.705882352941177,0.294117647058824,1
"7578","IGKV1OR22-5",9,11,20,0.55,0.45,1
"7579","IGKV2-24",19,30,49,0.612244897959184,0.387755102040816,1
"7580","IGKV2-28",3,7,10,0.7,0.3,1
"7581","IGKV2-30",14,22,36,0.611111111111111,0.388888888888889,1
"7582","IGKV2D-24",11,33,44,0.75,0.25,1
"7583","IGKV2D-28",10,9,19,0.473684210526316,0.526315789473684,1
"7584","IGKV2D-29",9,25,34,0.735294117647059,0.264705882352941,1
"7585","IGKV2D-30",11,26,37,0.702702702702703,0.297297297297297,1
"7586","IGKV2OR22-4",5,6,11,0.545454545454545,0.454545454545455,1
"7587","IGKV3-11",12,16,28,0.571428571428571,0.428571428571429,1
"7588","IGKV3-15",10,36,46,0.782608695652174,0.217391304347826,1
"7589","IGKV3-20",9,16,25,0.64,0.36,1
"7590","IGKV3-7",11,16,27,0.592592592592593,0.407407407407407,1
"7591","IGKV3D-11",16,27,43,0.627906976744186,0.372093023255814,1
"7592","IGKV3D-15",5,14,19,0.736842105263158,0.263157894736842,1
"7593","IGKV3D-20",20,26,46,0.565217391304348,0.434782608695652,1
"7594","IGKV3D-7",4,10,14,0.714285714285714,0.285714285714286,1
"7595","IGKV4-1",14,12,26,0.461538461538462,0.538461538461538,1
"7596","IGKV5-2",11,15,26,0.576923076923077,0.423076923076923,1
"7597","IGKV6-21",6,13,19,0.684210526315789,0.315789473684211,1
"7598","IGKV6D-21",9,16,25,0.64,0.36,1
"7599","IGKV6D-41",14,23,37,0.621621621621622,0.378378378378378,1
"7600","IGLC2",7,9,16,0.5625,0.4375,1
"7601","IGLC3",11,8,19,0.421052631578947,0.578947368421053,1
"7602","IGLC7",8,8,16,0.5,0.5,1
"7603","IGLJ3",1,4,5,0.8,0.2,1
"7604","IGLJ4",0,1,1,1,0,1
"7605","IGLJ5",1,2,3,0.666666666666667,0.333333333333333,1
"7606","IGLL1",6,10,16,0.625,0.375,1
"7607","IGLL3P",9,18,27,0.666666666666667,0.333333333333333,1
"7608","IGLL5",7,11,18,0.611111111111111,0.388888888888889,1
"7609","IGLON5",16,21,37,0.567567567567568,0.432432432432432,1
"7610","IGLV1-36",10,6,16,0.375,0.625,1
"7611","IGLV1-40",5,7,12,0.583333333333333,0.416666666666667,1
"7612","IGLV1-44",5,11,16,0.6875,0.3125,1
"7613","IGLV1-47",7,10,17,0.588235294117647,0.411764705882353,1
"7614","IGLV1-50",7,13,20,0.65,0.35,1
"7615","IGLV1-51",6,5,11,0.454545454545455,0.545454545454545,1
"7616","IGLV10-54",3,4,7,0.571428571428571,0.428571428571429,1
"7617","IGLV11-55",2,8,10,0.8,0.2,1
"7618","IGLV2-11",5,6,11,0.545454545454545,0.454545454545455,1
"7619","IGLV2-14",7,10,17,0.588235294117647,0.411764705882353,1
"7620","IGLV2-18",6,16,22,0.727272727272727,0.272727272727273,1
"7621","IGLV2-23",8,8,16,0.5,0.5,1
"7622","IGLV2-33",14,10,24,0.416666666666667,0.583333333333333,1
"7623","IGLV2-8",5,17,22,0.772727272727273,0.227272727272727,1
"7624","IGLV3-1",10,10,20,0.5,0.5,1
"7625","IGLV3-10",7,9,16,0.5625,0.4375,1
"7626","IGLV3-12",1,10,11,0.909090909090909,0.0909090909090909,1
"7627","IGLV3-16",10,12,22,0.545454545454545,0.454545454545455,1
"7628","IGLV3-19",4,10,14,0.714285714285714,0.285714285714286,1
"7629","IGLV3-21",3,10,13,0.769230769230769,0.230769230769231,1
"7630","IGLV3-22",5,10,15,0.666666666666667,0.333333333333333,1
"7631","IGLV3-25",8,15,23,0.652173913043478,0.347826086956522,1
"7632","IGLV3-27",11,13,24,0.541666666666667,0.458333333333333,1
"7633","IGLV3-32",3,8,11,0.727272727272727,0.272727272727273,1
"7634","IGLV3-9",9,11,20,0.55,0.45,1
"7635","IGLV4-3",8,10,18,0.555555555555556,0.444444444444444,1
"7636","IGLV4-60",9,9,18,0.5,0.5,1
"7637","IGLV4-69",5,11,16,0.6875,0.3125,1
"7638","IGLV5-37",3,7,10,0.7,0.3,1
"7639","IGLV5-45",4,11,15,0.733333333333333,0.266666666666667,1
"7640","IGLV5-48",4,4,8,0.5,0.5,1
"7641","IGLV5-52",4,6,10,0.6,0.4,1
"7642","IGLV6-57",3,9,12,0.75,0.25,1
"7643","IGLV7-43",7,10,17,0.588235294117647,0.411764705882353,1
"7644","IGLV7-46",7,8,15,0.533333333333333,0.466666666666667,1
"7645","IGLV8-61",7,14,21,0.666666666666667,0.333333333333333,1
"7646","IGLV8OR8-1",10,7,17,0.411764705882353,0.588235294117647,1
"7647","IGLV9-49",2,5,7,0.714285714285714,0.285714285714286,1
"7648","IGSF1",123,136,259,0.525096525096525,0.474903474903475,1
"7649","IGSF10",117,228,345,0.660869565217391,0.339130434782609,1
"7650","IGSF11",38,54,92,0.58695652173913,0.41304347826087,1
"7651","IGSF21",29,59,88,0.670454545454545,0.329545454545455,1
"7652","IGSF22",30,63,93,0.67741935483871,0.32258064516129,1
"7653","IGSF3",43,77,120,0.641666666666667,0.358333333333333,1
"7654","IGSF5",19,44,63,0.698412698412698,0.301587301587302,1
"7655","IGSF6",8,11,19,0.578947368421053,0.421052631578947,1
"7656","IGSF8",22,46,68,0.676470588235294,0.323529411764706,1
"7657","IGSF9",56,76,132,0.575757575757576,0.424242424242424,1
"7658","IGSF9B",76,128,204,0.627450980392157,0.372549019607843,1
"7659","IHH",18,25,43,0.581395348837209,0.418604651162791,1
"7660","IHO1",18,29,47,0.617021276595745,0.382978723404255,1
"7661","IK",12,21,33,0.636363636363636,0.363636363636364,1
"7662","IKBIP",12,28,40,0.7,0.3,1
"7663","IKBKB",32,51,83,0.614457831325301,0.385542168674699,1
"7664","IKBKE",32,46,78,0.58974358974359,0.41025641025641,1
"7665","IKBKG",4,5,9,0.555555555555556,0.444444444444444,1
"7666","IKZF1",34,83,117,0.709401709401709,0.290598290598291,1
"7667","IKZF2",23,81,104,0.778846153846154,0.221153846153846,1
"7668","IKZF3",24,52,76,0.684210526315789,0.315789473684211,1
"7669","IKZF4",19,28,47,0.595744680851064,0.404255319148936,1
"7670","IKZF5",10,12,22,0.545454545454545,0.454545454545455,1
"7671","IL10",4,12,16,0.75,0.25,1
"7672","IL10RA",27,34,61,0.557377049180328,0.442622950819672,1
"7673","IL10RB",13,23,36,0.638888888888889,0.361111111111111,1
"7674","IL11",5,6,11,0.545454545454545,0.454545454545455,1
"7675","IL11RA",12,18,30,0.6,0.4,1
"7676","IL12A",7,17,24,0.708333333333333,0.291666666666667,1
"7677","IL12B",21,17,38,0.447368421052632,0.552631578947368,1
"7678","IL12RB1",22,40,62,0.645161290322581,0.354838709677419,1
"7679","IL12RB2",37,57,94,0.606382978723404,0.393617021276596,1
"7680","IL13",5,4,9,0.444444444444444,0.555555555555556,1
"7681","IL13RA1",27,17,44,0.386363636363636,0.613636363636364,1
"7682","IL13RA2",31,21,52,0.403846153846154,0.596153846153846,1
"7683","IL15",7,7,14,0.5,0.5,1
"7684","IL15RA",12,17,29,0.586206896551724,0.413793103448276,1
"7685","IL16",63,83,146,0.568493150684932,0.431506849315068,1
"7686","IL17A",17,16,33,0.484848484848485,0.515151515151515,1
"7687","IL17B",7,10,17,0.588235294117647,0.411764705882353,1
"7688","IL17C",5,11,16,0.6875,0.3125,1
"7689","IL17D",2,3,5,0.6,0.4,1
"7690","IL17F",11,18,29,0.620689655172414,0.379310344827586,1
"7691","IL17RA",24,36,60,0.6,0.4,1
"7692","IL17RB",16,18,34,0.529411764705882,0.470588235294118,1
"7693","IL17RC",16,41,57,0.719298245614035,0.280701754385965,1
"7694","IL17RD",26,33,59,0.559322033898305,0.440677966101695,1
"7695","IL17RE",11,25,36,0.694444444444444,0.305555555555556,1
"7696","IL17REL",11,15,26,0.576923076923077,0.423076923076923,1
"7697","IL18",5,11,16,0.6875,0.3125,1
"7698","IL18BP",1,12,13,0.923076923076923,0.0769230769230769,1
"7699","IL18R1",40,50,90,0.555555555555556,0.444444444444444,1
"7700","IL18RAP",50,85,135,0.62962962962963,0.37037037037037,1
"7701","IL19",3,10,13,0.769230769230769,0.230769230769231,1
"7702","IL1A",11,14,25,0.56,0.44,1
"7703","IL1B",9,25,34,0.735294117647059,0.264705882352941,1
"7704","IL1F10",6,16,22,0.727272727272727,0.272727272727273,1
"7705","IL1R1",22,41,63,0.650793650793651,0.349206349206349,1
"7706","IL1R2",20,29,49,0.591836734693878,0.408163265306122,1
"7707","IL1RAP",16,38,54,0.703703703703704,0.296296296296296,1
"7708","IL1RAPL1",83,78,161,0.484472049689441,0.515527950310559,1
"7709","IL1RAPL2",66,71,137,0.518248175182482,0.481751824817518,1
"7710","IL1RL1",45,67,112,0.598214285714286,0.401785714285714,1
"7711","IL1RL2",27,51,78,0.653846153846154,0.346153846153846,1
"7712","IL1RN",8,13,21,0.619047619047619,0.380952380952381,1
"7713","IL2",4,18,22,0.818181818181818,0.181818181818182,1
"7714","IL20",7,8,15,0.533333333333333,0.466666666666667,1
"7715","IL20RA",17,39,56,0.696428571428571,0.303571428571429,1
"7716","IL20RB",12,18,30,0.6,0.4,1
"7717","IL21",13,17,30,0.566666666666667,0.433333333333333,1
"7718","IL21R",37,76,113,0.672566371681416,0.327433628318584,1
"7719","IL22",11,15,26,0.576923076923077,0.423076923076923,1
"7720","IL22RA1",15,26,41,0.634146341463415,0.365853658536585,1
"7721","IL22RA2",10,14,24,0.583333333333333,0.416666666666667,1
"7722","IL23A",3,8,11,0.727272727272727,0.272727272727273,1
"7723","IL23R",29,32,61,0.524590163934426,0.475409836065574,1
"7724","IL24",7,12,19,0.631578947368421,0.368421052631579,1
"7725","IL25",10,16,26,0.615384615384615,0.384615384615385,1
"7726","IL26",11,23,34,0.676470588235294,0.323529411764706,1
"7727","IL27",9,19,28,0.678571428571429,0.321428571428571,1
"7728","IL27RA",24,33,57,0.578947368421053,0.421052631578947,1
"7729","IL2RA",13,25,38,0.657894736842105,0.342105263157895,1
"7730","IL2RB",29,31,60,0.516666666666667,0.483333333333333,1
"7731","IL2RG",30,18,48,0.375,0.625,1
"7732","IL3",4,14,18,0.777777777777778,0.222222222222222,1
"7733","IL31",4,16,20,0.8,0.2,1
"7734","IL31RA",38,54,92,0.58695652173913,0.41304347826087,1
"7735","IL32",10,19,29,0.655172413793103,0.344827586206897,1
"7736","IL33",12,20,32,0.625,0.375,1
"7737","IL34",6,10,16,0.625,0.375,1
"7738","IL36A",13,26,39,0.666666666666667,0.333333333333333,1
"7739","IL36B",13,28,41,0.682926829268293,0.317073170731707,1
"7740","IL36G",6,17,23,0.739130434782609,0.260869565217391,1
"7741","IL36RN",10,13,23,0.565217391304348,0.434782608695652,1
"7742","IL37",11,38,49,0.775510204081633,0.224489795918367,1
"7743","IL3RA",18,35,53,0.660377358490566,0.339622641509434,1
"7744","IL4",8,9,17,0.529411764705882,0.470588235294118,1
"7745","IL4I1",22,27,49,0.551020408163265,0.448979591836735,1
"7746","IL4R",39,58,97,0.597938144329897,0.402061855670103,1
"7747","IL5",2,7,9,0.777777777777778,0.222222222222222,1
"7748","IL5RA",22,52,74,0.702702702702703,0.297297297297297,1
"7749","IL6",11,19,30,0.633333333333333,0.366666666666667,1
"7750","IL6R",11,25,36,0.694444444444444,0.305555555555556,1
"7751","IL6ST",40,40,80,0.5,0.5,1
"7752","IL7",10,12,22,0.545454545454545,0.454545454545455,1
"7753","IL7R",60,107,167,0.640718562874252,0.359281437125749,1
"7754","IL9",4,7,11,0.636363636363636,0.363636363636364,1
"7755","IL9R",25,46,71,0.647887323943662,0.352112676056338,1
"7756","ILDR1",37,57,94,0.606382978723404,0.393617021276596,1
"7757","ILDR2",45,58,103,0.563106796116505,0.436893203883495,1
"7758","ILF2",8,15,23,0.652173913043478,0.347826086956522,1
"7759","ILF3",33,47,80,0.5875,0.4125,1
"7760","ILK",10,22,32,0.6875,0.3125,1
"7761","ILKAP",14,24,38,0.631578947368421,0.368421052631579,1
"7762","ILRUN",7,15,22,0.681818181818182,0.318181818181818,1
"7763","ILVBL",19,35,54,0.648148148148148,0.351851851851852,1
"7764","IMMP1L",4,10,14,0.714285714285714,0.285714285714286,1
"7765","IMMP2L",11,19,30,0.633333333333333,0.366666666666667,1
"7766","IMMT",26,46,72,0.638888888888889,0.361111111111111,1
"7767","IMP3",3,8,11,0.727272727272727,0.272727272727273,1
"7768","IMP4",14,18,32,0.5625,0.4375,1
"7769","IMPA1",15,15,30,0.5,0.5,1
"7770","IMPA2",10,19,29,0.655172413793103,0.344827586206897,1
"7771","IMPACT",9,25,34,0.735294117647059,0.264705882352941,1
"7772","IMPDH1",20,25,45,0.555555555555556,0.444444444444444,1
"7773","IMPDH2",18,26,44,0.590909090909091,0.409090909090909,1
"7774","IMPG1",73,129,202,0.638613861386139,0.361386138613861,1
"7775","IMPG2",61,120,181,0.662983425414365,0.337016574585635,1
"7776","INA",13,33,46,0.717391304347826,0.282608695652174,1
"7777","INAVA",21,43,64,0.671875,0.328125,1
"7778","INCA1",6,9,15,0.6,0.4,1
"7779","INCENP",26,39,65,0.6,0.4,1
"7780","INF2",42,45,87,0.517241379310345,0.482758620689655,1
"7781","ING1",27,17,44,0.386363636363636,0.613636363636364,1
"7782","ING2",8,16,24,0.666666666666667,0.333333333333333,1
"7783","ING3",7,30,37,0.810810810810811,0.189189189189189,1
"7784","ING4",8,13,21,0.619047619047619,0.380952380952381,1
"7785","ING5",8,17,25,0.68,0.32,1
"7786","INHA",20,23,43,0.534883720930233,0.465116279069767,1
"7787","INHBA",58,66,124,0.532258064516129,0.467741935483871,1
"7788","INHBB",15,26,41,0.634146341463415,0.365853658536585,1
"7789","INHBC",13,31,44,0.704545454545455,0.295454545454545,1
"7790","INHBE",8,26,34,0.764705882352941,0.235294117647059,1
"7791","INIP",7,10,17,0.588235294117647,0.411764705882353,1
"7792","INKA1",11,8,19,0.421052631578947,0.578947368421053,1
"7793","INKA2",12,15,27,0.555555555555556,0.444444444444444,1
"7794","INMT",16,32,48,0.666666666666667,0.333333333333333,1
"7795","INO80",42,81,123,0.658536585365854,0.341463414634146,1
"7796","INO80B",13,10,23,0.434782608695652,0.565217391304348,1
"7797","INO80C",9,6,15,0.4,0.6,1
"7798","INO80D",27,44,71,0.619718309859155,0.380281690140845,1
"7799","INO80E",5,21,26,0.807692307692308,0.192307692307692,1
"7800","INPP1",14,20,34,0.588235294117647,0.411764705882353,1
"7801","INPP4A",30,33,63,0.523809523809524,0.476190476190476,1
"7802","INPP4B",53,78,131,0.595419847328244,0.404580152671756,1
"7803","INPP5A",19,29,48,0.604166666666667,0.395833333333333,1
"7804","INPP5B",26,44,70,0.628571428571429,0.371428571428571,1
"7805","INPP5D",56,81,137,0.591240875912409,0.408759124087591,1
"7806","INPP5E",13,11,24,0.458333333333333,0.541666666666667,1
"7807","INPP5F",46,59,105,0.561904761904762,0.438095238095238,1
"7808","INPP5J",18,26,44,0.590909090909091,0.409090909090909,1
"7809","INPP5K",9,19,28,0.678571428571429,0.321428571428571,1
"7810","INPPL1",64,89,153,0.581699346405229,0.418300653594771,1
"7811","INS",1,2,3,0.666666666666667,0.333333333333333,1
"7812","INS-IGF2",5,2,7,0.285714285714286,0.714285714285714,1
"7813","INSC",45,53,98,0.540816326530612,0.459183673469388,1
"7814","INSIG1",15,16,31,0.516129032258065,0.483870967741935,1
"7815","INSIG2",14,15,29,0.517241379310345,0.482758620689655,1
"7816","INSL3",6,2,8,0.25,0.75,1
"7817","INSL4",7,14,21,0.666666666666667,0.333333333333333,1
"7818","INSL5",5,16,21,0.761904761904762,0.238095238095238,1
"7819","INSL6",17,23,40,0.575,0.425,1
"7820","INSM1",6,9,15,0.6,0.4,1
"7821","INSM2",23,22,45,0.488888888888889,0.511111111111111,1
"7822","INSR",52,78,130,0.6,0.4,1
"7823","INSRR",74,125,199,0.628140703517588,0.371859296482412,1
"7824","INSYN1",10,28,38,0.736842105263158,0.263157894736842,1
"7825","INSYN2A",24,32,56,0.571428571428571,0.428571428571429,1
"7826","INSYN2B",0,6,6,1,0,1
"7827","INTS1",57,74,131,0.564885496183206,0.435114503816794,1
"7828","INTS10",22,28,50,0.56,0.44,1
"7829","INTS11",16,22,38,0.578947368421053,0.421052631578947,1
"7830","INTS12",19,25,44,0.568181818181818,0.431818181818182,1
"7831","INTS13",37,38,75,0.506666666666667,0.493333333333333,1
"7832","INTS14",12,18,30,0.6,0.4,1
"7833","INTS2",34,55,89,0.617977528089888,0.382022471910112,1
"7834","INTS3",30,49,79,0.620253164556962,0.379746835443038,1
"7835","INTS4",29,42,71,0.591549295774648,0.408450704225352,1
"7836","INTS5",22,59,81,0.728395061728395,0.271604938271605,1
"7837","INTS6",23,37,60,0.616666666666667,0.383333333333333,1
"7838","INTS6L",65,41,106,0.386792452830189,0.613207547169811,1
"7839","INTS7",36,49,85,0.576470588235294,0.423529411764706,1
"7840","INTS8",37,46,83,0.55421686746988,0.44578313253012,1
"7841","INTS9",17,23,40,0.575,0.425,1
"7842","INTU",36,71,107,0.663551401869159,0.336448598130841,1
"7843","INVS",26,49,75,0.653333333333333,0.346666666666667,1
"7844","IP6K1",15,18,33,0.545454545454545,0.454545454545455,1
"7845","IP6K2",13,23,36,0.638888888888889,0.361111111111111,1
"7846","IP6K3",14,33,47,0.702127659574468,0.297872340425532,1
"7847","IPCEF1",17,32,49,0.653061224489796,0.346938775510204,1
"7848","IPMK",16,25,41,0.609756097560976,0.390243902439024,1
"7849","IPO11",37,50,87,0.574712643678161,0.425287356321839,1
"7850","IPO13",22,45,67,0.671641791044776,0.328358208955224,1
"7851","IPO4",34,38,72,0.527777777777778,0.472222222222222,1
"7852","IPO5",33,48,81,0.592592592592593,0.407407407407407,1
"7853","IPO7",34,64,98,0.653061224489796,0.346938775510204,1
"7854","IPO8",40,76,116,0.655172413793103,0.344827586206897,1
"7855","IPO9",46,46,92,0.5,0.5,1
"7856","IPP",17,43,60,0.716666666666667,0.283333333333333,1
"7857","IPPK",13,29,42,0.69047619047619,0.30952380952381,1
"7858","IQCA1",33,56,89,0.629213483146067,0.370786516853933,1
"7859","IQCB1",17,33,50,0.66,0.34,1
"7860","IQCC",10,28,38,0.736842105263158,0.263157894736842,1
"7861","IQCD",11,11,22,0.5,0.5,1
"7862","IQCE",29,43,72,0.597222222222222,0.402777777777778,1
"7863","IQCF1",11,23,34,0.676470588235294,0.323529411764706,1
"7864","IQCF2",7,16,23,0.695652173913043,0.304347826086957,1
"7865","IQCG",20,37,57,0.649122807017544,0.350877192982456,1
"7866","IQCH",35,68,103,0.660194174757282,0.339805825242718,1
"7867","IQCJ",4,11,15,0.733333333333333,0.266666666666667,1
"7868","IQCJ-SCHIP1",25,39,64,0.609375,0.390625,1
"7869","IQCK",7,8,15,0.533333333333333,0.466666666666667,1
"7870","IQCN",37,71,108,0.657407407407407,0.342592592592593,1
"7871","IQGAP1",49,76,125,0.608,0.392,1
"7872","IQGAP2",55,137,192,0.713541666666667,0.286458333333333,1
"7873","IQGAP3",49,95,144,0.659722222222222,0.340277777777778,1
"7874","IQSEC1",42,46,88,0.522727272727273,0.477272727272727,1
"7875","IQSEC2",57,31,88,0.352272727272727,0.647727272727273,1
"7876","IQSEC3",45,67,112,0.598214285714286,0.401785714285714,1
"7877","IQUB",42,89,131,0.679389312977099,0.320610687022901,1
"7878","IRAG1",36,54,90,0.6,0.4,1
"7879","IRAG2",19,35,54,0.648148148148148,0.351851851851852,1
"7880","IRAK1",31,21,52,0.403846153846154,0.596153846153846,1
"7881","IRAK1BP1",9,11,20,0.55,0.45,1
"7882","IRAK2",22,42,64,0.65625,0.34375,1
"7883","IRAK3",32,52,84,0.619047619047619,0.380952380952381,0.54
"7884","IRAK4",29,18,47,0.382978723404255,0.617021276595745,1
"7885","IREB2",35,56,91,0.615384615384615,0.384615384615385,1
"7886","IRF1",16,18,34,0.529411764705882,0.470588235294118,1
"7887","IRF2",46,45,91,0.494505494505495,0.505494505494505,1
"7888","IRF2BP1",17,24,41,0.585365853658537,0.414634146341463,1
"7889","IRF2BP2",15,28,43,0.651162790697674,0.348837209302326,1
"7890","IRF2BPL",10,25,35,0.714285714285714,0.285714285714286,1
"7891","IRF3",12,15,27,0.555555555555556,0.444444444444444,1
"7892","IRF4",21,38,59,0.644067796610169,0.355932203389831,1
"7893","IRF5",14,25,39,0.641025641025641,0.358974358974359,1
"7894","IRF6",38,54,92,0.58695652173913,0.41304347826087,1
"7895","IRF7",18,24,42,0.571428571428571,0.428571428571429,1
"7896","IRF8",26,35,61,0.573770491803279,0.426229508196721,1
"7897","IRF9",22,15,37,0.405405405405405,0.594594594594595,1
"7898","IRGC",27,45,72,0.625,0.375,1
"7899","IRGM",0,1,1,1,0,1
"7900","IRGQ",27,18,45,0.4,0.6,1
"7901","IRS1",68,85,153,0.555555555555556,0.444444444444444,1
"7902","IRS2",17,29,46,0.630434782608696,0.369565217391304,1
"7903","IRS4",104,95,199,0.477386934673367,0.522613065326633,1
"7904","IRX1",49,72,121,0.59504132231405,0.40495867768595,1
"7905","IRX2",31,37,68,0.544117647058823,0.455882352941176,1
"7906","IRX3",13,18,31,0.580645161290323,0.419354838709677,1
"7907","IRX4",24,38,62,0.612903225806452,0.387096774193548,1
"7908","IRX5",19,37,56,0.660714285714286,0.339285714285714,1
"7909","IRX6",36,39,75,0.52,0.48,1
"7910","ISCA1",4,5,9,0.555555555555556,0.444444444444444,1
"7911","ISCA1P1",6,12,18,0.666666666666667,0.333333333333333,1
"7912","ISCA2",1,7,8,0.875,0.125,1
"7913","ISCU",3,2,5,0.4,0.6,1
"7914","ISG15",4,5,9,0.555555555555556,0.444444444444444,1
"7915","ISG20",10,6,16,0.375,0.625,1
"7916","ISG20L2",14,30,44,0.681818181818182,0.318181818181818,1
"7917","ISL1",29,47,76,0.618421052631579,0.381578947368421,1
"7918","ISL2",13,14,27,0.518518518518518,0.481481481481481,1
"7919","ISLR",23,35,58,0.603448275862069,0.396551724137931,1
"7920","ISLR2",33,40,73,0.547945205479452,0.452054794520548,1
"7921","ISM1",19,32,51,0.627450980392157,0.372549019607843,1
"7922","ISM2",27,42,69,0.608695652173913,0.391304347826087,1
"7923","ISOC1",8,18,26,0.692307692307692,0.307692307692308,1
"7924","ISOC2",8,12,20,0.6,0.4,1
"7925","IST1",16,10,26,0.384615384615385,0.615384615384615,1
"7926","ISX",13,33,46,0.717391304347826,0.282608695652174,1
"7927","ISY1",3,4,7,0.571428571428571,0.428571428571429,1
"7928","ISY1-RAB43",12,14,26,0.538461538461538,0.461538461538462,1
"7929","ISYNA1",11,14,25,0.56,0.44,1
"7930","ITCH",29,50,79,0.632911392405063,0.367088607594937,1
"7931","ITFG1",15,30,45,0.666666666666667,0.333333333333333,1
"7932","ITFG2",19,26,45,0.577777777777778,0.422222222222222,1
"7933","ITGA1",51,58,109,0.532110091743119,0.467889908256881,1
"7934","ITGA10",60,85,145,0.586206896551724,0.413793103448276,1
"7935","ITGA11",33,75,108,0.694444444444444,0.305555555555556,1
"7936","ITGA2",44,71,115,0.617391304347826,0.382608695652174,1
"7937","ITGA2B",31,57,88,0.647727272727273,0.352272727272727,1
"7938","ITGA3",36,53,89,0.595505617977528,0.404494382022472,1
"7939","ITGA4",86,122,208,0.586538461538462,0.413461538461538,1
"7940","ITGA5",35,68,103,0.660194174757282,0.339805825242718,1
"7941","ITGA6",34,61,95,0.642105263157895,0.357894736842105,1
"7942","ITGA7",58,81,139,0.58273381294964,0.41726618705036,1
"7943","ITGA8",96,170,266,0.639097744360902,0.360902255639098,1
"7944","ITGA9",36,48,84,0.571428571428571,0.428571428571429,1
"7945","ITGAD",70,114,184,0.619565217391304,0.380434782608696,1
"7946","ITGAE",52,80,132,0.606060606060606,0.393939393939394,1
"7947","ITGAL",58,105,163,0.644171779141104,0.355828220858896,1
"7948","ITGAM",51,97,148,0.655405405405405,0.344594594594595,1
"7949","ITGAV",40,80,120,0.666666666666667,0.333333333333333,1
"7950","ITGAX",69,128,197,0.649746192893401,0.350253807106599,1
"7951","ITGB1",33,48,81,0.592592592592593,0.407407407407407,1
"7952","ITGB1BP1",6,13,19,0.684210526315789,0.315789473684211,1
"7953","ITGB1BP2",21,17,38,0.447368421052632,0.552631578947368,1
"7954","ITGB2",30,65,95,0.684210526315789,0.315789473684211,1
"7955","ITGB3",45,63,108,0.583333333333333,0.416666666666667,1
"7956","ITGB3BP",5,10,15,0.666666666666667,0.333333333333333,1
"7957","ITGB4",68,105,173,0.606936416184971,0.393063583815029,1
"7958","ITGB5",24,36,60,0.6,0.4,1
"7959","ITGB6",29,56,85,0.658823529411765,0.341176470588235,1
"7960","ITGB7",15,26,41,0.634146341463415,0.365853658536585,1
"7961","ITGB8",48,70,118,0.593220338983051,0.406779661016949,1
"7962","ITGBL1",38,63,101,0.623762376237624,0.376237623762376,1
"7963","ITIH1",49,80,129,0.62015503875969,0.37984496124031,1
"7964","ITIH2",63,94,157,0.598726114649682,0.401273885350318,1
"7965","ITIH3",23,34,57,0.596491228070175,0.403508771929825,1
"7966","ITIH4",24,44,68,0.647058823529412,0.352941176470588,1
"7967","ITIH5",69,106,175,0.605714285714286,0.394285714285714,1
"7968","ITIH6",119,56,175,0.32,0.68,1
"7969","ITK",30,76,106,0.716981132075472,0.283018867924528,1
"7970","ITLN1",15,41,56,0.732142857142857,0.267857142857143,1
"7971","ITLN2",13,27,40,0.675,0.325,1
"7972","ITM2A",18,35,53,0.660377358490566,0.339622641509434,1
"7973","ITM2B",5,23,28,0.821428571428571,0.178571428571429,1
"7974","ITM2C",12,8,20,0.4,0.6,1
"7975","ITPA",6,11,17,0.647058823529412,0.352941176470588,1
"7976","ITPK1",15,32,47,0.680851063829787,0.319148936170213,1
"7977","ITPKA",8,9,17,0.529411764705882,0.470588235294118,1
"7978","ITPKB",47,46,93,0.494623655913978,0.505376344086022,1
"7979","ITPKC",15,25,40,0.625,0.375,1
"7980","ITPR1",90,183,273,0.67032967032967,0.32967032967033,1
"7981","ITPR2",124,184,308,0.597402597402597,0.402597402597403,1
"7982","ITPR3",112,125,237,0.527426160337553,0.472573839662447,1
"7983","ITPRID1",73,115,188,0.611702127659574,0.388297872340426,1
"7984","ITPRID2",38,63,101,0.623762376237624,0.376237623762376,1
"7985","ITPRIP",20,28,48,0.583333333333333,0.416666666666667,1
"7986","ITPRIPL1",15,29,44,0.659090909090909,0.340909090909091,1
"7987","ITPRIPL2",15,22,37,0.594594594594595,0.405405405405405,1
"7988","ITSN1",66,109,175,0.622857142857143,0.377142857142857,1
"7989","ITSN2",63,94,157,0.598726114649682,0.401273885350318,1
"7990","IVD",12,18,30,0.6,0.4,1
"7991","IVL",35,59,94,0.627659574468085,0.372340425531915,1
"7992","IVNS1ABP",23,41,64,0.640625,0.359375,1
"7993","IWS1",39,44,83,0.530120481927711,0.469879518072289,1
"7994","IYD",7,25,32,0.78125,0.21875,1
"7995","IZUMO1",8,34,42,0.80952380952381,0.19047619047619,1
"7996","IZUMO1R",18,17,35,0.485714285714286,0.514285714285714,1
"7997","IZUMO2",8,23,31,0.741935483870968,0.258064516129032,1
"7998","IZUMO3",0,3,3,1,0,1
"7999","IZUMO4",7,6,13,0.461538461538462,0.538461538461538,1
"8000","JADE1",29,40,69,0.579710144927536,0.420289855072464,1
"8001","JADE2",34,37,71,0.52112676056338,0.47887323943662,1
"8002","JADE3",40,27,67,0.402985074626866,0.597014925373134,1
"8003","JAG1",35,93,128,0.7265625,0.2734375,1
"8004","JAG2",42,51,93,0.548387096774194,0.451612903225806,1
"8005","JAGN1",4,13,17,0.764705882352941,0.235294117647059,1
"8006","JAK1",59,82,141,0.581560283687943,0.418439716312057,1
"8007","JAK2",53,68,121,0.56198347107438,0.43801652892562,1
"8008","JAK3",34,67,101,0.663366336633663,0.336633663366337,0.54
"8009","JAKMIP1",53,89,142,0.626760563380282,0.373239436619718,1
"8010","JAKMIP2",62,88,150,0.586666666666667,0.413333333333333,1
"8011","JAKMIP3",34,45,79,0.569620253164557,0.430379746835443,1
"8012","JAM2",21,24,45,0.533333333333333,0.466666666666667,1
"8013","JAM3",22,22,44,0.5,0.5,1
"8014","JAML",20,40,60,0.666666666666667,0.333333333333333,1
"8015","JARID2",74,91,165,0.551515151515152,0.448484848484848,0.79
"8016","JAZF1",8,15,23,0.652173913043478,0.347826086956522,1
"8017","JCAD",78,143,221,0.647058823529412,0.352941176470588,1
"8018","JCHAIN",7,24,31,0.774193548387097,0.225806451612903,1
"8019","JDP2",3,7,10,0.7,0.3,1
"8020","JHY",46,77,123,0.626016260162602,0.373983739837398,1
"8021","JKAMP",15,19,34,0.558823529411765,0.441176470588235,1
"8022","JMJD1C",85,143,228,0.62719298245614,0.37280701754386,1
"8023","JMJD4",6,19,25,0.76,0.24,1
"8024","JMJD6",10,17,27,0.62962962962963,0.37037037037037,1
"8025","JMJD7",3,4,7,0.571428571428571,0.428571428571429,1
"8026","JMJD7-PLA2G4B",30,35,65,0.538461538461538,0.461538461538462,1
"8027","JMJD8",5,1,6,0.166666666666667,0.833333333333333,1
"8028","JMY",17,36,53,0.679245283018868,0.320754716981132,1
"8029","JOSD1",6,6,12,0.5,0.5,1
"8030","JOSD2",2,8,10,0.8,0.2,1
"8031","JPH1",24,71,95,0.747368421052632,0.252631578947368,1
"8032","JPH2",37,52,89,0.584269662921348,0.415730337078652,1
"8033","JPH3",36,51,87,0.586206896551724,0.413793103448276,1
"8034","JPH4",19,26,45,0.577777777777778,0.422222222222222,1
"8035","JPT1",3,6,9,0.666666666666667,0.333333333333333,1
"8036","JPT2",9,18,27,0.666666666666667,0.333333333333333,1
"8037","JRK",13,28,41,0.682926829268293,0.317073170731707,1
"8038","JRKL",17,23,40,0.575,0.425,1
"8039","JSRP1",13,17,30,0.566666666666667,0.433333333333333,1
"8040","JTB",7,11,18,0.611111111111111,0.388888888888889,1
"8041","JUN",15,14,29,0.482758620689655,0.517241379310345,1
"8042","JUNB",7,17,24,0.708333333333333,0.291666666666667,1
"8043","JUND",7,7,14,0.5,0.5,1
"8044","JUP",30,50,80,0.625,0.375,1
"8045","KAAG1",4,5,9,0.555555555555556,0.444444444444444,1
"8046","KALRN",134,287,421,0.681710213776722,0.318289786223278,1
"8047","KANK1",38,61,99,0.616161616161616,0.383838383838384,0.44
"8048","KANK2",29,36,65,0.553846153846154,0.446153846153846,0.21
"8049","KANK3",6,20,26,0.769230769230769,0.230769230769231,0.14
"8050","KANK4",54,95,149,0.63758389261745,0.36241610738255,1
"8051","KANSL1",86,99,185,0.535135135135135,0.464864864864865,1
"8052","KANSL1L",35,62,97,0.639175257731959,0.360824742268041,1
"8053","KANSL2",17,21,38,0.552631578947368,0.447368421052632,1
"8054","KANSL3",23,30,53,0.566037735849057,0.433962264150943,1
"8055","KARS1",19,39,58,0.672413793103448,0.327586206896552,0.77
"8056","KASH5",15,31,46,0.673913043478261,0.326086956521739,1
"8057","KAT14",32,60,92,0.652173913043478,0.347826086956522,1
"8058","KAT2A",21,32,53,0.60377358490566,0.39622641509434,1
"8059","KAT2B",27,55,82,0.670731707317073,0.329268292682927,1
"8060","KAT5",15,22,37,0.594594594594595,0.405405405405405,1
"8061","KAT6A",66,128,194,0.65979381443299,0.34020618556701,1
"8062","KAT6B",69,105,174,0.603448275862069,0.396551724137931,1
"8063","KAT7",21,51,72,0.708333333333333,0.291666666666667,1
"8064","KAT8",21,33,54,0.611111111111111,0.388888888888889,1
"8065","KATNA1",24,24,48,0.5,0.5,1
"8066","KATNAL1",16,30,46,0.652173913043478,0.347826086956522,1
"8067","KATNAL2",21,43,64,0.671875,0.328125,1
"8068","KATNB1",25,23,48,0.479166666666667,0.520833333333333,1
"8069","KATNBL1",9,25,34,0.735294117647059,0.264705882352941,1
"8070","KATNIP",59,125,184,0.679347826086957,0.320652173913043,1
"8071","KAZALD1",6,11,17,0.647058823529412,0.352941176470588,1
"8072","KAZN",21,45,66,0.681818181818182,0.318181818181818,1
"8073","KBTBD11",1,9,10,0.9,0.1,1
"8074","KBTBD12",27,50,77,0.649350649350649,0.350649350649351,1
"8075","KBTBD13",6,11,17,0.647058823529412,0.352941176470588,1
"8076","KBTBD2",19,24,43,0.558139534883721,0.441860465116279,1
"8077","KBTBD3",34,47,81,0.580246913580247,0.419753086419753,1
"8078","KBTBD4",24,25,49,0.510204081632653,0.489795918367347,1
"8079","KBTBD6",45,39,84,0.464285714285714,0.535714285714286,1
"8080","KBTBD7",32,30,62,0.483870967741935,0.516129032258065,1
"8081","KBTBD8",23,50,73,0.684931506849315,0.315068493150685,1
"8082","KCMF1",12,16,28,0.571428571428571,0.428571428571429,1
"8083","KCNA1",59,82,141,0.581560283687943,0.418439716312057,1
"8084","KCNA10",34,46,80,0.575,0.425,1
"8085","KCNA2",32,49,81,0.604938271604938,0.395061728395062,1
"8086","KCNA3",28,57,85,0.670588235294118,0.329411764705882,1
"8087","KCNA4",100,125,225,0.555555555555556,0.444444444444444,1
"8088","KCNA5",53,96,149,0.644295302013423,0.355704697986577,1
"8089","KCNA6",57,82,139,0.589928057553957,0.410071942446043,1
"8090","KCNA7",11,20,31,0.645161290322581,0.354838709677419,1
"8091","KCNAB1",21,36,57,0.631578947368421,0.368421052631579,1
"8092","KCNAB2",13,19,32,0.59375,0.40625,1
"8093","KCNAB3",12,17,29,0.586206896551724,0.413793103448276,1
"8094","KCNB1",62,110,172,0.63953488372093,0.36046511627907,1
"8095","KCNB2",132,235,367,0.640326975476839,0.359673024523161,1
"8096","KCNC1",29,45,74,0.608108108108108,0.391891891891892,1
"8097","KCNC2",45,87,132,0.659090909090909,0.340909090909091,1
"8098","KCNC3",24,31,55,0.563636363636364,0.436363636363636,1
"8099","KCNC4",30,39,69,0.565217391304348,0.434782608695652,1
"8100","KCND1",37,24,61,0.39344262295082,0.60655737704918,1
"8101","KCND2",61,123,184,0.668478260869565,0.331521739130435,1
"8102","KCND3",41,78,119,0.65546218487395,0.34453781512605,1
"8103","KCNE1",7,9,16,0.5625,0.4375,1
"8104","KCNE2",1,11,12,0.916666666666667,0.0833333333333333,1
"8105","KCNE3",8,14,22,0.636363636363636,0.363636363636364,1
"8106","KCNE4",10,9,19,0.473684210526316,0.526315789473684,1
"8107","KCNE5",7,7,14,0.5,0.5,1
"8108","KCNF1",34,45,79,0.569620253164557,0.430379746835443,1
"8109","KCNG1",28,64,92,0.695652173913043,0.304347826086957,1
"8110","KCNG2",25,22,47,0.468085106382979,0.531914893617021,1
"8111","KCNG3",9,15,24,0.625,0.375,1
"8112","KCNG4",39,44,83,0.530120481927711,0.469879518072289,1
"8113","KCNH1",85,135,220,0.613636363636364,0.386363636363636,1
"8114","KCNH2",41,77,118,0.652542372881356,0.347457627118644,1
"8115","KCNH3",48,74,122,0.60655737704918,0.39344262295082,1
"8116","KCNH4",56,69,125,0.552,0.448,1
"8117","KCNH5",78,196,274,0.715328467153285,0.284671532846715,1
"8118","KCNH6",54,95,149,0.63758389261745,0.36241610738255,1
"8119","KCNH7",116,199,315,0.631746031746032,0.368253968253968,1
"8120","KCNH8",92,127,219,0.579908675799087,0.420091324200913,1
"8121","KCNIP1",13,35,48,0.729166666666667,0.270833333333333,1
"8122","KCNIP2",9,14,23,0.608695652173913,0.391304347826087,1
"8123","KCNIP3",10,23,33,0.696969696969697,0.303030303030303,1
"8124","KCNIP4",18,35,53,0.660377358490566,0.339622641509434,1
"8125","KCNJ1",27,39,66,0.590909090909091,0.409090909090909,1
"8126","KCNJ10",25,32,57,0.56140350877193,0.43859649122807,1
"8127","KCNJ11",8,23,31,0.741935483870968,0.258064516129032,1
"8128","KCNJ12",23,38,61,0.622950819672131,0.377049180327869,1
"8129","KCNJ13",7,18,25,0.72,0.28,1
"8130","KCNJ14",23,17,40,0.425,0.575,1
"8131","KCNJ15",20,48,68,0.705882352941177,0.294117647058824,1
"8132","KCNJ16",21,41,62,0.661290322580645,0.338709677419355,1
"8133","KCNJ2",32,50,82,0.609756097560976,0.390243902439024,1
"8134","KCNJ3",72,92,164,0.560975609756098,0.439024390243902,1
"8135","KCNJ4",20,44,64,0.6875,0.3125,1
"8136","KCNJ5",27,30,57,0.526315789473684,0.473684210526316,1
"8137","KCNJ6",31,58,89,0.651685393258427,0.348314606741573,1
"8138","KCNJ8",42,50,92,0.543478260869565,0.456521739130435,1
"8139","KCNJ9",12,18,30,0.6,0.4,1
"8140","KCNK1",20,37,57,0.649122807017544,0.350877192982456,1
"8141","KCNK10",45,80,125,0.64,0.36,1
"8142","KCNK12",4,4,8,0.5,0.5,1
"8143","KCNK13",37,45,82,0.548780487804878,0.451219512195122,1
"8144","KCNK15",15,16,31,0.516129032258065,0.483870967741935,1
"8145","KCNK16",21,24,45,0.533333333333333,0.466666666666667,1
"8146","KCNK17",17,27,44,0.613636363636364,0.386363636363636,1
"8147","KCNK18",29,59,88,0.670454545454545,0.329545454545455,1
"8148","KCNK2",38,46,84,0.547619047619048,0.452380952380952,1
"8149","KCNK3",18,29,47,0.617021276595745,0.382978723404255,1
"8150","KCNK4",6,17,23,0.739130434782609,0.260869565217391,1
"8151","KCNK5",25,52,77,0.675324675324675,0.324675324675325,1
"8152","KCNK6",9,21,30,0.7,0.3,1
"8153","KCNK7",11,14,25,0.56,0.44,1
"8154","KCNK9",42,65,107,0.607476635514019,0.392523364485981,1
"8155","KCNMA1",61,104,165,0.63030303030303,0.36969696969697,1
"8156","KCNMB1",17,24,41,0.585365853658537,0.414634146341463,1
"8157","KCNMB2",17,29,46,0.630434782608696,0.369565217391304,1
"8158","KCNMB3",10,21,31,0.67741935483871,0.32258064516129,1
"8159","KCNMB4",14,20,34,0.588235294117647,0.411764705882353,1
"8160","KCNN1",19,37,56,0.660714285714286,0.339285714285714,1
"8161","KCNN2",34,56,90,0.622222222222222,0.377777777777778,1
"8162","KCNN3",30,65,95,0.684210526315789,0.315789473684211,1
"8163","KCNN4",16,21,37,0.567567567567568,0.432432432432432,1
"8164","KCNQ1",25,35,60,0.583333333333333,0.416666666666667,1
"8165","KCNQ2",59,74,133,0.556390977443609,0.443609022556391,1
"8166","KCNQ3",67,138,205,0.673170731707317,0.326829268292683,1
"8167","KCNQ4",23,44,67,0.656716417910448,0.343283582089552,1
"8168","KCNQ5",74,123,197,0.624365482233503,0.375634517766497,1
"8169","KCNRG",6,21,27,0.777777777777778,0.222222222222222,1
"8170","KCNS1",14,26,40,0.65,0.35,1
"8171","KCNS2",48,54,102,0.529411764705882,0.470588235294118,1
"8172","KCNS3",31,46,77,0.597402597402597,0.402597402597403,1
"8173","KCNT1",56,96,152,0.631578947368421,0.368421052631579,1
"8174","KCNT2",108,204,312,0.653846153846154,0.346153846153846,1
"8175","KCNU1",84,111,195,0.569230769230769,0.430769230769231,1
"8176","KCNV1",44,76,120,0.633333333333333,0.366666666666667,1
"8177","KCNV2",42,48,90,0.533333333333333,0.466666666666667,1
"8178","KCP",0,6,6,1,0,1
"8179","KCTD1",11,11,22,0.5,0.5,1
"8180","KCTD10",18,26,44,0.590909090909091,0.409090909090909,1
"8181","KCTD11",15,17,32,0.53125,0.46875,1
"8182","KCTD12",8,4,12,0.333333333333333,0.666666666666667,1
"8183","KCTD13",14,11,25,0.44,0.56,1
"8184","KCTD14",10,11,21,0.523809523809524,0.476190476190476,1
"8185","KCTD15",13,11,24,0.458333333333333,0.541666666666667,1
"8186","KCTD16",38,61,99,0.616161616161616,0.383838383838384,1
"8187","KCTD17",3,10,13,0.769230769230769,0.230769230769231,1
"8188","KCTD18",19,20,39,0.512820512820513,0.487179487179487,1
"8189","KCTD19",45,55,100,0.55,0.45,1
"8190","KCTD2",11,15,26,0.576923076923077,0.423076923076923,1
"8191","KCTD20",12,32,44,0.727272727272727,0.272727272727273,1
"8192","KCTD21",11,18,29,0.620689655172414,0.379310344827586,1
"8193","KCTD3",38,66,104,0.634615384615385,0.365384615384615,1
"8194","KCTD4",6,14,20,0.7,0.3,1
"8195","KCTD5",7,5,12,0.416666666666667,0.583333333333333,1
"8196","KCTD6",6,19,25,0.76,0.24,1
"8197","KCTD7",9,11,20,0.55,0.45,1
"8198","KCTD8",44,84,128,0.65625,0.34375,1
"8199","KCTD9",15,18,33,0.545454545454545,0.454545454545455,1
"8200","KDELR1",9,8,17,0.470588235294118,0.529411764705882,1
"8201","KDELR2",7,6,13,0.461538461538462,0.538461538461538,1
"8202","KDELR3",11,10,21,0.476190476190476,0.523809523809524,1
"8203","KDF1",24,21,45,0.466666666666667,0.533333333333333,1
"8204","KDM1A",20,29,49,0.591836734693878,0.408163265306122,1
"8205","KDM1B",21,43,64,0.671875,0.328125,1
"8206","KDM2A",30,45,75,0.6,0.4,1
"8207","KDM2B",64,94,158,0.594936708860759,0.40506329113924,1
"8208","KDM3A",37,68,105,0.647619047619048,0.352380952380952,1
"8209","KDM3B",74,97,171,0.567251461988304,0.432748538011696,1
"8210","KDM4A",38,50,88,0.568181818181818,0.431818181818182,1
"8211","KDM4B",44,50,94,0.531914893617021,0.468085106382979,1
"8212","KDM4C",29,57,86,0.662790697674419,0.337209302325581,1
"8213","KDM4D",31,36,67,0.537313432835821,0.462686567164179,1
"8214","KDM5A",65,104,169,0.615384615384615,0.384615384615385,1
"8215","KDM5B",70,98,168,0.583333333333333,0.416666666666667,1
"8216","KDM5C",51,84,135,0.622222222222222,0.377777777777778,0.38
"8217","KDM5D",0,42,42,1,0,1
"8218","KDM6A",86,156,242,0.644628099173554,0.355371900826446,1
"8219","KDM6B",57,93,150,0.62,0.38,1
"8220","KDM7A",40,60,100,0.6,0.4,1
"8221","KDM8",10,22,32,0.6875,0.3125,1
"8222","KDR",111,192,303,0.633663366336634,0.366336633663366,1
"8223","KDSR",9,14,23,0.608695652173913,0.391304347826087,1
"8224","KEAP1",84,150,234,0.641025641025641,0.358974358974359,1
"8225","KEL",63,125,188,0.664893617021277,0.335106382978723,1
"8226","KERA",30,50,80,0.625,0.375,1
"8227","KHDC1",11,15,26,0.576923076923077,0.423076923076923,1
"8228","KHDC1L",0,2,2,1,0,1
"8229","KHDC3L",14,42,56,0.75,0.25,1
"8230","KHDC4",25,41,66,0.621212121212121,0.378787878787879,1
"8231","KHDRBS1",20,26,46,0.565217391304348,0.434782608695652,1
"8232","KHDRBS2",48,91,139,0.654676258992806,0.345323741007194,1
"8233","KHDRBS3",20,24,44,0.545454545454545,0.454545454545455,1
"8234","KHK",5,19,24,0.791666666666667,0.208333333333333,1
"8235","KHNYN",23,30,53,0.566037735849057,0.433962264150943,1
"8236","KHSRP",17,32,49,0.653061224489796,0.346938775510204,1
"8237","KIAA0100",71,113,184,0.614130434782609,0.385869565217391,1
"8238","KIAA0232",44,82,126,0.650793650793651,0.349206349206349,1
"8239","KIAA0319",47,116,163,0.711656441717791,0.288343558282209,1
"8240","KIAA0319L",35,56,91,0.615384615384615,0.384615384615385,1
"8241","KIAA0408",25,67,92,0.728260869565217,0.271739130434783,1
"8242","KIAA0513",13,29,42,0.69047619047619,0.30952380952381,1
"8243","KIAA0586",35,69,104,0.663461538461538,0.336538461538462,1
"8244","KIAA0753",29,47,76,0.618421052631579,0.381578947368421,1
"8245","KIAA0825",16,36,52,0.692307692307692,0.307692307692308,1
"8246","KIAA0895",18,39,57,0.684210526315789,0.315789473684211,1
"8247","KIAA0895L",10,20,30,0.666666666666667,0.333333333333333,1
"8248","KIAA0930",18,23,41,0.560975609756098,0.439024390243902,1
"8249","KIAA1109",228,290,518,0.55984555984556,0.44015444015444,1
"8250","KIAA1143",5,7,12,0.583333333333333,0.416666666666667,1
"8251","KIAA1191",8,9,17,0.529411764705882,0.470588235294118,1
"8252","KIAA1210",112,100,212,0.471698113207547,0.528301886792453,1
"8253","KIAA1217",101,178,279,0.637992831541219,0.362007168458781,1
"8254","KIAA1328",18,34,52,0.653846153846154,0.346153846153846,1
"8255","KIAA1522",42,73,115,0.634782608695652,0.365217391304348,1
"8256","KIAA1549",79,145,224,0.647321428571429,0.352678571428571,1
"8257","KIAA1549L",87,129,216,0.597222222222222,0.402777777777778,1
"8258","KIAA1586",26,44,70,0.628571428571429,0.371428571428571,1
"8259","KIAA1614",34,62,96,0.645833333333333,0.354166666666667,1
"8260","KIAA1671",4,2,6,0.333333333333333,0.666666666666667,1
"8261","KIAA1755",73,79,152,0.519736842105263,0.480263157894737,1
"8262","KIAA1841",32,45,77,0.584415584415584,0.415584415584416,1
"8263","KIAA1958",30,47,77,0.61038961038961,0.38961038961039,1
"8264","KIAA2012",1,2,3,0.666666666666667,0.333333333333333,1
"8265","KIAA2013",9,17,26,0.653846153846154,0.346153846153846,1
"8266","KIAA2026",50,100,150,0.666666666666667,0.333333333333333,1
"8267","KIDINS220",69,122,191,0.638743455497382,0.361256544502618,1
"8268","KIF11",25,30,55,0.545454545454545,0.454545454545455,1
"8269","KIF12",14,30,44,0.681818181818182,0.318181818181818,1
"8270","KIF13A",62,104,166,0.626506024096386,0.373493975903614,1
"8271","KIF13B",44,81,125,0.648,0.352,1
"8272","KIF14",57,94,151,0.622516556291391,0.377483443708609,1
"8273","KIF15",41,58,99,0.585858585858586,0.414141414141414,1
"8274","KIF16B",62,105,167,0.62874251497006,0.37125748502994,1
"8275","KIF17",54,66,120,0.55,0.45,1
"8276","KIF18A",35,49,84,0.583333333333333,0.416666666666667,1
"8277","KIF18B",26,33,59,0.559322033898305,0.440677966101695,1
"8278","KIF19",40,78,118,0.661016949152542,0.338983050847458,1
"8279","KIF1A",75,130,205,0.634146341463415,0.365853658536585,1
"8280","KIF1B",58,112,170,0.658823529411765,0.341176470588235,1
"8281","KIF1C",43,51,94,0.542553191489362,0.457446808510638,1
"8282","KIF20A",21,36,57,0.631578947368421,0.368421052631579,1
"8283","KIF20B",64,95,159,0.59748427672956,0.40251572327044,1
"8284","KIF21A",91,143,234,0.611111111111111,0.388888888888889,1
"8285","KIF21B",91,140,231,0.606060606060606,0.393939393939394,1
"8286","KIF22",23,30,53,0.566037735849057,0.433962264150943,1
"8287","KIF23",22,41,63,0.650793650793651,0.349206349206349,1
"8288","KIF24",27,44,71,0.619718309859155,0.380281690140845,1
"8289","KIF25",15,27,42,0.642857142857143,0.357142857142857,1
"8290","KIF26A",59,63,122,0.516393442622951,0.483606557377049,1
"8291","KIF26B",80,134,214,0.626168224299065,0.373831775700935,1
"8292","KIF27",61,66,127,0.519685039370079,0.480314960629921,1
"8293","KIF28P",0,4,4,1,0,1
"8294","KIF2A",19,31,50,0.62,0.38,1
"8295","KIF2B",110,164,274,0.598540145985402,0.401459854014599,1
"8296","KIF2C",24,36,60,0.6,0.4,1
"8297","KIF3A",22,37,59,0.627118644067797,0.372881355932203,1
"8298","KIF3B",23,50,73,0.684931506849315,0.315068493150685,1
"8299","KIF3C",39,38,77,0.493506493506494,0.506493506493506,1
"8300","KIF4A",63,30,93,0.32258064516129,0.67741935483871,1
"8301","KIF4B",106,128,234,0.547008547008547,0.452991452991453,1
"8302","KIF5A",47,96,143,0.671328671328671,0.328671328671329,1
"8303","KIF5B",30,50,80,0.625,0.375,1
"8304","KIF5C",37,63,100,0.63,0.37,1
"8305","KIF6",35,85,120,0.708333333333333,0.291666666666667,1
"8306","KIF7",28,47,75,0.626666666666667,0.373333333333333,1
"8307","KIF9",32,40,72,0.555555555555556,0.444444444444444,1
"8308","KIFAP3",30,59,89,0.662921348314607,0.337078651685393,1
"8309","KIFBP",10,30,40,0.75,0.25,1
"8310","KIFC1",23,42,65,0.646153846153846,0.353846153846154,1
"8311","KIFC2",29,34,63,0.53968253968254,0.46031746031746,1
"8312","KIFC3",26,36,62,0.580645161290323,0.419354838709677,1
"8313","KIN",19,30,49,0.612244897959184,0.387755102040816,1
"8314","KIR2DL1",34,81,115,0.704347826086957,0.295652173913043,1
"8315","KIR2DL3",28,63,91,0.692307692307692,0.307692307692308,1
"8316","KIR2DL4",29,75,104,0.721153846153846,0.278846153846154,1
"8317","KIR2DS4",18,26,44,0.590909090909091,0.409090909090909,1
"8318","KIR3DL1",40,81,121,0.669421487603306,0.330578512396694,1
"8319","KIR3DL2",31,96,127,0.755905511811024,0.244094488188976,1
"8320","KIR3DL3",44,67,111,0.603603603603604,0.396396396396396,1
"8321","KIR3DX1",41,76,117,0.64957264957265,0.35042735042735,1
"8322","KIRREL1",44,51,95,0.536842105263158,0.463157894736842,1
"8323","KIRREL2",55,86,141,0.609929078014184,0.390070921985816,1
"8324","KIRREL3",28,52,80,0.65,0.35,1
"8325","KISS1",2,3,5,0.6,0.4,1
"8326","KISS1R",0,2,2,1,0,1
"8327","KIT",60,94,154,0.61038961038961,0.38961038961039,1
"8328","KITLG",13,27,40,0.675,0.325,1
"8329","KIZ",27,28,55,0.509090909090909,0.490909090909091,1
"8330","KL",48,96,144,0.666666666666667,0.333333333333333,1
"8331","KLB",36,71,107,0.663551401869159,0.336448598130841,1
"8332","KLC1",25,21,46,0.456521739130435,0.543478260869565,1
"8333","KLC2",34,28,62,0.451612903225806,0.548387096774194,1
"8334","KLC3",11,22,33,0.666666666666667,0.333333333333333,1
"8335","KLC4",16,31,47,0.659574468085106,0.340425531914894,1
"8336","KLF1",6,8,14,0.571428571428571,0.428571428571429,1
"8337","KLF10",22,27,49,0.551020408163265,0.448979591836735,1
"8338","KLF11",8,29,37,0.783783783783784,0.216216216216216,1
"8339","KLF12",18,24,42,0.571428571428571,0.428571428571429,1
"8340","KLF13",7,8,15,0.533333333333333,0.466666666666667,1
"8341","KLF14",8,14,22,0.636363636363636,0.363636363636364,1
"8342","KLF15",16,23,39,0.58974358974359,0.41025641025641,1
"8343","KLF16",2,4,6,0.666666666666667,0.333333333333333,1
"8344","KLF17",24,41,65,0.630769230769231,0.369230769230769,1
"8345","KLF2",4,6,10,0.6,0.4,1
"8346","KLF3",29,44,73,0.602739726027397,0.397260273972603,1
"8347","KLF4",18,21,39,0.538461538461538,0.461538461538462,1
"8348","KLF5",25,38,63,0.603174603174603,0.396825396825397,1
"8349","KLF6",15,30,45,0.666666666666667,0.333333333333333,1
"8350","KLF7",15,19,34,0.558823529411765,0.441176470588235,1
"8351","KLF8",25,17,42,0.404761904761905,0.595238095238095,1
"8352","KLF9",8,14,22,0.636363636363636,0.363636363636364,1
"8353","KLHDC1",5,14,19,0.736842105263158,0.263157894736842,1
"8354","KLHDC10",10,24,34,0.705882352941177,0.294117647058824,1
"8355","KLHDC2",9,24,33,0.727272727272727,0.272727272727273,1
"8356","KLHDC3",12,16,28,0.571428571428571,0.428571428571429,1
"8357","KLHDC4",16,30,46,0.652173913043478,0.347826086956522,1
"8358","KLHDC7A",37,83,120,0.691666666666667,0.308333333333333,1
"8359","KLHDC7B",9,34,43,0.790697674418605,0.209302325581395,1
"8360","KLHDC8A",14,29,43,0.674418604651163,0.325581395348837,1
"8361","KLHDC8B",15,19,34,0.558823529411765,0.441176470588235,1
"8362","KLHDC9",7,16,23,0.695652173913043,0.304347826086957,1
"8363","KLHL1",94,159,253,0.628458498023715,0.371541501976285,1
"8364","KLHL10",31,25,56,0.446428571428571,0.553571428571429,1
"8365","KLHL11",23,37,60,0.616666666666667,0.383333333333333,1
"8366","KLHL12",14,25,39,0.641025641025641,0.358974358974359,1
"8367","KLHL13",57,62,119,0.521008403361345,0.478991596638655,1
"8368","KLHL14",53,58,111,0.522522522522523,0.477477477477477,1
"8369","KLHL15",25,23,48,0.479166666666667,0.520833333333333,1
"8370","KLHL17",16,24,40,0.6,0.4,1
"8371","KLHL18",15,38,53,0.716981132075472,0.283018867924528,1
"8372","KLHL2",25,30,55,0.545454545454545,0.454545454545455,1
"8373","KLHL20",23,36,59,0.610169491525424,0.389830508474576,1
"8374","KLHL21",6,18,24,0.75,0.25,1
"8375","KLHL22",21,48,69,0.695652173913043,0.304347826086957,1
"8376","KLHL23",16,48,64,0.75,0.25,1
"8377","KLHL24",24,49,73,0.671232876712329,0.328767123287671,1
"8378","KLHL25",24,30,54,0.555555555555556,0.444444444444444,1
"8379","KLHL26",24,31,55,0.563636363636364,0.436363636363636,1
"8380","KLHL28",28,28,56,0.5,0.5,1
"8381","KLHL29",1,5,6,0.833333333333333,0.166666666666667,1
"8382","KLHL3",17,42,59,0.711864406779661,0.288135593220339,1
"8383","KLHL30",14,24,38,0.631578947368421,0.368421052631579,1
"8384","KLHL31",26,33,59,0.559322033898305,0.440677966101695,1
"8385","KLHL32",28,60,88,0.681818181818182,0.318181818181818,1
"8386","KLHL33",1,3,4,0.75,0.25,1
"8387","KLHL34",62,18,80,0.225,0.775,1
"8388","KLHL35",11,7,18,0.388888888888889,0.611111111111111,1
"8389","KLHL36",25,25,50,0.5,0.5,1
"8390","KLHL38",26,54,80,0.675,0.325,1
"8391","KLHL4",92,133,225,0.591111111111111,0.408888888888889,1
"8392","KLHL40",25,44,69,0.63768115942029,0.36231884057971,1
"8393","KLHL41",26,30,56,0.535714285714286,0.464285714285714,1
"8394","KLHL42",28,31,59,0.525423728813559,0.474576271186441,1
"8395","KLHL5",39,45,84,0.535714285714286,0.464285714285714,1
"8396","KLHL6",43,76,119,0.638655462184874,0.361344537815126,1
"8397","KLHL7",22,44,66,0.666666666666667,0.333333333333333,1
"8398","KLHL8",16,27,43,0.627906976744186,0.372093023255814,1
"8399","KLHL9",25,37,62,0.596774193548387,0.403225806451613,1
"8400","KLK1",21,19,40,0.475,0.525,1
"8401","KLK10",4,9,13,0.692307692307692,0.307692307692308,1
"8402","KLK11",13,18,31,0.580645161290323,0.419354838709677,1
"8403","KLK12",12,15,27,0.555555555555556,0.444444444444444,1
"8404","KLK13",14,31,45,0.688888888888889,0.311111111111111,1
"8405","KLK14",7,11,18,0.611111111111111,0.388888888888889,1
"8406","KLK15",23,50,73,0.684931506849315,0.315068493150685,1
"8407","KLK2",13,19,32,0.59375,0.40625,1
"8408","KLK3",9,31,40,0.775,0.225,1
"8409","KLK4",22,27,49,0.551020408163265,0.448979591836735,1
"8410","KLK5",20,40,60,0.666666666666667,0.333333333333333,1
"8411","KLK6",26,27,53,0.509433962264151,0.490566037735849,1
"8412","KLK7",9,15,24,0.625,0.375,1
"8413","KLK8",14,32,46,0.695652173913043,0.304347826086957,1
"8414","KLK9",13,20,33,0.606060606060606,0.393939393939394,1
"8415","KLKB1",37,58,95,0.610526315789474,0.389473684210526,1
"8416","KLRA1P",10,16,26,0.615384615384615,0.384615384615385,1
"8417","KLRB1",6,20,26,0.769230769230769,0.230769230769231,1
"8418","KLRC1",15,24,39,0.615384615384615,0.384615384615385,1
"8419","KLRC2",16,28,44,0.636363636363636,0.363636363636364,1
"8420","KLRC3",17,16,33,0.484848484848485,0.515151515151515,1
"8421","KLRC4",5,18,23,0.782608695652174,0.217391304347826,1
"8422","KLRD1",12,18,30,0.6,0.4,1
"8423","KLRF1",15,19,34,0.558823529411765,0.441176470588235,1
"8424","KLRG1",12,15,27,0.555555555555556,0.444444444444444,1
"8425","KLRG2",11,12,23,0.521739130434783,0.478260869565217,1
"8426","KLRK1",22,29,51,0.568627450980392,0.431372549019608,1
"8427","KMO",34,38,72,0.527777777777778,0.472222222222222,1
"8428","KMT2A",159,214,373,0.57372654155496,0.42627345844504,1
"8429","KMT2B",129,207,336,0.616071428571429,0.383928571428571,1
"8430","KMT2C",228,377,605,0.623140495867769,0.376859504132231,1
"8431","KMT2D",293,504,797,0.63237139272271,0.36762860727729,1
"8432","KMT2E",71,128,199,0.64321608040201,0.35678391959799,1
"8433","KMT5A",9,13,22,0.590909090909091,0.409090909090909,1
"8434","KMT5B",38,74,112,0.660714285714286,0.339285714285714,1
"8435","KMT5C",18,12,30,0.4,0.6,1
"8436","KNCN",5,7,12,0.583333333333333,0.416666666666667,1
"8437","KNDC1",59,116,175,0.662857142857143,0.337142857142857,1
"8438","KNG1",36,67,103,0.650485436893204,0.349514563106796,1
"8439","KNL1",64,132,196,0.673469387755102,0.326530612244898,1
"8440","KNOP1",24,33,57,0.578947368421053,0.421052631578947,1
"8441","KNOP1P1",25,47,72,0.652777777777778,0.347222222222222,1
"8442","KNSTRN",23,35,58,0.603448275862069,0.396551724137931,1
"8443","KNTC1",66,103,169,0.609467455621302,0.390532544378698,1
"8444","KPNA1",19,31,50,0.62,0.38,1
"8445","KPNA2",12,37,49,0.755102040816326,0.244897959183673,1
"8446","KPNA3",22,23,45,0.511111111111111,0.488888888888889,1
"8447","KPNA4",17,31,48,0.645833333333333,0.354166666666667,1
"8448","KPNA5",16,29,45,0.644444444444444,0.355555555555556,1
"8449","KPNA6",17,28,45,0.622222222222222,0.377777777777778,1
"8450","KPNA7",0,7,7,1,0,1
"8451","KPNB1",23,35,58,0.603448275862069,0.396551724137931,1
"8452","KPRP",49,100,149,0.671140939597315,0.328859060402685,1
"8453","KPTN",18,12,30,0.4,0.6,1
"8454","KRAS",287,352,639,0.550860719874804,0.449139280125196,1
"8455","KRBA1",27,48,75,0.64,0.36,1
"8456","KRBA2",18,23,41,0.560975609756098,0.439024390243902,1
"8457","KRBOX4",14,3,17,0.176470588235294,0.823529411764706,1
"8458","KRCC1",9,20,29,0.689655172413793,0.310344827586207,1
"8459","KREMEN1",15,28,43,0.651162790697674,0.348837209302326,1
"8460","KREMEN2",9,6,15,0.4,0.6,1
"8461","KRI1",25,35,60,0.583333333333333,0.416666666666667,1
"8462","KRIT1",20,45,65,0.692307692307692,0.307692307692308,1
"8463","KRR1",16,20,36,0.555555555555556,0.444444444444444,1
"8464","KRT1",32,56,88,0.636363636363636,0.363636363636364,1
"8465","KRT10",22,46,68,0.676470588235294,0.323529411764706,1
"8466","KRT12",29,39,68,0.573529411764706,0.426470588235294,1
"8467","KRT13",27,37,64,0.578125,0.421875,1
"8468","KRT14",20,30,50,0.6,0.4,1
"8469","KRT15",15,37,52,0.711538461538462,0.288461538461538,1
"8470","KRT16",26,40,66,0.606060606060606,0.393939393939394,1
"8471","KRT17",24,32,56,0.571428571428571,0.428571428571429,1
"8472","KRT17P1",0,3,3,1,0,1
"8473","KRT17P2",0,2,2,1,0,1
"8474","KRT18",12,21,33,0.636363636363636,0.363636363636364,1
"8475","KRT18P55",9,26,35,0.742857142857143,0.257142857142857,1
"8476","KRT19",20,25,45,0.555555555555556,0.444444444444444,1
"8477","KRT2",40,49,89,0.550561797752809,0.449438202247191,1
"8478","KRT20",17,41,58,0.706896551724138,0.293103448275862,1
"8479","KRT222",28,28,56,0.5,0.5,1
"8480","KRT23",24,41,65,0.630769230769231,0.369230769230769,1
"8481","KRT24",18,38,56,0.678571428571429,0.321428571428571,1
"8482","KRT25",18,49,67,0.73134328358209,0.26865671641791,1
"8483","KRT26",24,39,63,0.619047619047619,0.380952380952381,1
"8484","KRT27",20,34,54,0.62962962962963,0.37037037037037,1
"8485","KRT28",26,46,72,0.638888888888889,0.361111111111111,1
"8486","KRT3",34,51,85,0.6,0.4,1
"8487","KRT31",36,43,79,0.544303797468354,0.455696202531646,1
"8488","KRT32",19,33,52,0.634615384615385,0.365384615384615,1
"8489","KRT33A",25,35,60,0.583333333333333,0.416666666666667,1
"8490","KRT33B",28,40,68,0.588235294117647,0.411764705882353,1
"8491","KRT34",28,64,92,0.695652173913043,0.304347826086957,1
"8492","KRT35",20,43,63,0.682539682539683,0.317460317460317,1
"8493","KRT36",29,43,72,0.597222222222222,0.402777777777778,1
"8494","KRT37",24,46,70,0.657142857142857,0.342857142857143,1
"8495","KRT38",22,42,64,0.65625,0.34375,1
"8496","KRT39",18,46,64,0.71875,0.28125,1
"8497","KRT4",32,56,88,0.636363636363636,0.363636363636364,1
"8498","KRT40",16,35,51,0.686274509803922,0.313725490196078,1
"8499","KRT5",44,59,103,0.572815533980582,0.427184466019417,1
"8500","KRT6A",37,68,105,0.647619047619048,0.352380952380952,1
"8501","KRT6B",35,33,68,0.485294117647059,0.514705882352941,1
"8502","KRT6C",28,54,82,0.658536585365854,0.341463414634146,1
"8503","KRT7",21,26,47,0.553191489361702,0.446808510638298,1
"8504","KRT71",28,51,79,0.645569620253165,0.354430379746835,1
"8505","KRT72",31,39,70,0.557142857142857,0.442857142857143,1
"8506","KRT73",31,66,97,0.680412371134021,0.319587628865979,1
"8507","KRT74",32,54,86,0.627906976744186,0.372093023255814,1
"8508","KRT75",40,45,85,0.529411764705882,0.470588235294118,1
"8509","KRT76",20,41,61,0.672131147540984,0.327868852459016,1
"8510","KRT77",16,40,56,0.714285714285714,0.285714285714286,1
"8511","KRT78",27,47,74,0.635135135135135,0.364864864864865,1
"8512","KRT79",31,42,73,0.575342465753425,0.424657534246575,1
"8513","KRT8",13,21,34,0.617647058823529,0.382352941176471,1
"8514","KRT80",14,24,38,0.631578947368421,0.368421052631579,1
"8515","KRT81",17,14,31,0.451612903225806,0.548387096774194,1
"8516","KRT82",21,59,80,0.7375,0.2625,1
"8517","KRT83",24,40,64,0.625,0.375,1
"8518","KRT84",18,54,72,0.75,0.25,1
"8519","KRT85",31,38,69,0.550724637681159,0.449275362318841,1
"8520","KRT86",12,24,36,0.666666666666667,0.333333333333333,1
"8521","KRT9",34,46,80,0.575,0.425,1
"8522","KRTAP1-1",9,6,15,0.4,0.6,1
"8523","KRTAP1-3",10,10,20,0.5,0.5,1
"8524","KRTAP1-5",13,11,24,0.458333333333333,0.541666666666667,1
"8525","KRTAP10-1",6,24,30,0.8,0.2,1
"8526","KRTAP10-10",12,18,30,0.6,0.4,1
"8527","KRTAP10-11",11,28,39,0.717948717948718,0.282051282051282,1
"8528","KRTAP10-12",11,18,29,0.620689655172414,0.379310344827586,1
"8529","KRTAP10-2",9,19,28,0.678571428571429,0.321428571428571,1
"8530","KRTAP10-3",15,17,32,0.53125,0.46875,1
"8531","KRTAP10-4",21,39,60,0.65,0.35,1
"8532","KRTAP10-5",7,34,41,0.829268292682927,0.170731707317073,1
"8533","KRTAP10-6",22,17,39,0.435897435897436,0.564102564102564,1
"8534","KRTAP10-7",21,40,61,0.655737704918033,0.344262295081967,1
"8535","KRTAP10-8",18,29,47,0.617021276595745,0.382978723404255,1
"8536","KRTAP10-9",22,28,50,0.56,0.44,1
"8537","KRTAP11-1",19,26,45,0.577777777777778,0.422222222222222,1
"8538","KRTAP12-1",6,11,17,0.647058823529412,0.352941176470588,1
"8539","KRTAP12-2",11,10,21,0.476190476190476,0.523809523809524,1
"8540","KRTAP12-3",5,10,15,0.666666666666667,0.333333333333333,1
"8541","KRTAP12-4",3,13,16,0.8125,0.1875,1
"8542","KRTAP13-1",10,41,51,0.803921568627451,0.196078431372549,1
"8543","KRTAP13-2",15,19,34,0.558823529411765,0.441176470588235,1
"8544","KRTAP13-3",12,21,33,0.636363636363636,0.363636363636364,1
"8545","KRTAP13-4",18,23,41,0.560975609756098,0.439024390243902,1
"8546","KRTAP15-1",17,25,42,0.595238095238095,0.404761904761905,1
"8547","KRTAP17-1",4,10,14,0.714285714285714,0.285714285714286,1
"8548","KRTAP19-1",6,13,19,0.684210526315789,0.315789473684211,1
"8549","KRTAP19-2",4,4,8,0.5,0.5,1
"8550","KRTAP19-3",5,18,23,0.782608695652174,0.217391304347826,1
"8551","KRTAP19-4",8,10,18,0.555555555555556,0.444444444444444,1
"8552","KRTAP19-5",10,25,35,0.714285714285714,0.285714285714286,1
"8553","KRTAP19-6",4,10,14,0.714285714285714,0.285714285714286,1
"8554","KRTAP19-7",7,12,19,0.631578947368421,0.368421052631579,1
"8555","KRTAP19-8",1,8,9,0.888888888888889,0.111111111111111,1
"8556","KRTAP2-4",1,0,1,0,1,1
"8557","KRTAP20-1",4,12,16,0.75,0.25,1
"8558","KRTAP20-2",7,7,14,0.5,0.5,1
"8559","KRTAP20-4",0,1,1,1,0,1
"8560","KRTAP21-1",7,9,16,0.5625,0.4375,1
"8561","KRTAP21-2",6,20,26,0.769230769230769,0.230769230769231,1
"8562","KRTAP22-1",6,7,13,0.538461538461538,0.461538461538462,1
"8563","KRTAP23-1",6,8,14,0.571428571428571,0.428571428571429,1
"8564","KRTAP24-1",33,33,66,0.5,0.5,1
"8565","KRTAP25-1",0,3,3,1,0,1
"8566","KRTAP26-1",19,22,41,0.536585365853659,0.463414634146341,1
"8567","KRTAP27-1",21,20,41,0.48780487804878,0.51219512195122,1
"8568","KRTAP3-1",2,6,8,0.75,0.25,1
"8569","KRTAP3-2",5,5,10,0.5,0.5,1
"8570","KRTAP3-3",7,7,14,0.5,0.5,1
"8571","KRTAP4-1",6,11,17,0.647058823529412,0.352941176470588,1
"8572","KRTAP4-11",0,1,1,1,0,1
"8573","KRTAP4-12",8,15,23,0.652173913043478,0.347826086956522,1
"8574","KRTAP4-16",0,1,1,1,0,1
"8575","KRTAP4-2",8,14,22,0.636363636363636,0.363636363636364,1
"8576","KRTAP4-3",9,9,18,0.5,0.5,1
"8577","KRTAP4-4",8,11,19,0.578947368421053,0.421052631578947,1
"8578","KRTAP4-5",7,10,17,0.588235294117647,0.411764705882353,1
"8579","KRTAP4-7",0,1,1,1,0,1
"8580","KRTAP4-9",0,1,1,1,0,1
"8581","KRTAP5-1",10,29,39,0.743589743589744,0.256410256410256,1
"8582","KRTAP5-10",26,26,52,0.5,0.5,1
"8583","KRTAP5-11",7,11,18,0.611111111111111,0.388888888888889,1
"8584","KRTAP5-2",4,19,23,0.826086956521739,0.173913043478261,1
"8585","KRTAP5-3",20,24,44,0.545454545454545,0.454545454545455,1
"8586","KRTAP5-4",0,1,1,1,0,1
"8587","KRTAP5-5",11,20,31,0.645161290322581,0.354838709677419,1
"8588","KRTAP5-6",7,15,22,0.681818181818182,0.318181818181818,1
"8589","KRTAP5-7",5,10,15,0.666666666666667,0.333333333333333,1
"8590","KRTAP5-8",8,11,19,0.578947368421053,0.421052631578947,1
"8591","KRTAP5-9",7,8,15,0.533333333333333,0.466666666666667,1
"8592","KRTAP6-1",5,16,21,0.761904761904762,0.238095238095238,1
"8593","KRTAP6-2",13,15,28,0.535714285714286,0.464285714285714,1
"8594","KRTAP6-3",10,13,23,0.565217391304348,0.434782608695652,1
"8595","KRTAP8-1",3,11,14,0.785714285714286,0.214285714285714,1
"8596","KRTAP9-1",0,2,2,1,0,1
"8597","KRTAP9-2",10,16,26,0.615384615384615,0.384615384615385,1
"8598","KRTAP9-3",8,18,26,0.692307692307692,0.307692307692308,1
"8599","KRTAP9-4",10,7,17,0.411764705882353,0.588235294117647,1
"8600","KRTAP9-6",0,1,1,1,0,1
"8601","KRTAP9-7",0,1,1,1,0,1
"8602","KRTAP9-8",8,9,17,0.529411764705882,0.470588235294118,1
"8603","KRTAP9-9",3,4,7,0.571428571428571,0.428571428571429,1
"8604","KRTCAP2",0,5,5,1,0,1
"8605","KRTCAP3",12,7,19,0.368421052631579,0.631578947368421,1
"8606","KRTDAP",2,9,11,0.818181818181818,0.181818181818182,1
"8607","KSR1",36,40,76,0.526315789473684,0.473684210526316,1
"8608","KSR2",77,114,191,0.596858638743455,0.403141361256544,1
"8609","KTI12",14,14,28,0.5,0.5,1
"8610","KTN1",38,57,95,0.6,0.4,1
"8611","KXD1",6,9,15,0.6,0.4,1
"8612","KY",13,43,56,0.767857142857143,0.232142857142857,1
"8613","KYAT3",11,30,41,0.731707317073171,0.268292682926829,1
"8614","KYNU",38,61,99,0.616161616161616,0.383838383838384,1
"8615","L1CAM",100,77,177,0.435028248587571,0.564971751412429,1
"8616","L1TD1",38,59,97,0.608247422680412,0.391752577319588,1
"8617","L2HGDH",11,23,34,0.676470588235294,0.323529411764706,1
"8618","L34079.1",1,2,3,0.666666666666667,0.333333333333333,1
"8619","L3HYPDH",13,12,25,0.48,0.52,1
"8620","L3MBTL1",28,54,82,0.658536585365854,0.341463414634146,1
"8621","L3MBTL2",25,29,54,0.537037037037037,0.462962962962963,1
"8622","L3MBTL3",31,46,77,0.597402597402597,0.402597402597403,1
"8623","L3MBTL4",26,84,110,0.763636363636364,0.236363636363636,1
"8624","LACC1",12,22,34,0.647058823529412,0.352941176470588,1
"8625","LACRT",18,23,41,0.560975609756098,0.439024390243902,0.37
"8626","LACTB",10,27,37,0.72972972972973,0.27027027027027,0.47
"8627","LACTB2",12,16,28,0.571428571428571,0.428571428571429,0.47
"8628","LACTBL1",0,1,1,1,0,0.47
"8629","LAD1",28,54,82,0.658536585365854,0.341463414634146,1
"8630","LAG3",19,21,40,0.525,0.475,1
"8631","LAGE3",4,5,9,0.555555555555556,0.444444444444444,1
"8632","LAIR1",21,26,47,0.553191489361702,0.446808510638298,1
"8633","LAIR2",13,24,37,0.648648648648649,0.351351351351351,1
"8634","LALBA",4,12,16,0.75,0.25,0.86
"8635","LAMA1",169,295,464,0.635775862068966,0.364224137931034,1
"8636","LAMA2",182,319,501,0.636726546906188,0.363273453093812,1
"8637","LAMA3",122,225,347,0.648414985590778,0.351585014409222,1
"8638","LAMA4",102,133,235,0.565957446808511,0.434042553191489,1
"8639","LAMA5",93,185,278,0.665467625899281,0.334532374100719,1
"8640","LAMB1",94,93,187,0.497326203208556,0.502673796791444,1
"8641","LAMB2",56,92,148,0.621621621621622,0.378378378378378,1
"8642","LAMB3",53,87,140,0.621428571428571,0.378571428571429,1
"8643","LAMB4",107,154,261,0.590038314176245,0.409961685823755,1
"8644","LAMC1",55,107,162,0.660493827160494,0.339506172839506,1
"8645","LAMC2",45,82,127,0.645669291338583,0.354330708661417,1
"8646","LAMC3",62,94,156,0.602564102564103,0.397435897435897,1
"8647","LAMP1",13,23,36,0.638888888888889,0.361111111111111,1
"8648","LAMP2",21,8,29,0.275862068965517,0.724137931034483,1
"8649","LAMP3",20,45,65,0.692307692307692,0.307692307692308,1
"8650","LAMP5",32,42,74,0.567567567567568,0.432432432432432,1
"8651","LAMTOR1",5,2,7,0.285714285714286,0.714285714285714,1
"8652","LAMTOR2",2,8,10,0.8,0.2,1
"8653","LAMTOR3",2,5,7,0.714285714285714,0.285714285714286,1
"8654","LAMTOR4",4,1,5,0.2,0.8,1
"8655","LAMTOR5",2,5,7,0.714285714285714,0.285714285714286,1
"8656","LANCL1",14,16,30,0.533333333333333,0.466666666666667,1
"8657","LANCL2",32,26,58,0.448275862068966,0.551724137931034,1
"8658","LANCL3",17,10,27,0.37037037037037,0.62962962962963,1
"8659","LAP3",14,26,40,0.65,0.35,1
"8660","LAPTM4A",7,9,16,0.5625,0.4375,1
"8661","LAPTM4B",4,6,10,0.6,0.4,1
"8662","LAPTM5",10,20,30,0.666666666666667,0.333333333333333,1
"8663","LARGE1",49,56,105,0.533333333333333,0.466666666666667,0.77
"8664","LARGE2",14,28,42,0.666666666666667,0.333333333333333,0.77
"8665","LARP1",49,86,135,0.637037037037037,0.362962962962963,0.77
"8666","LARP1B",32,43,75,0.573333333333333,0.426666666666667,0.77
"8667","LARP4",36,45,81,0.555555555555556,0.444444444444444,0.77
"8668","LARP4B",66,89,155,0.574193548387097,0.425806451612903,0.77
"8669","LARP6",20,22,42,0.523809523809524,0.476190476190476,0.77
"8670","LARP7",26,30,56,0.535714285714286,0.464285714285714,0.77
"8671","LARS1",41,52,93,0.559139784946237,0.440860215053763,0.77
"8672","LARS2",15,22,37,0.594594594594595,0.405405405405405,0.77
"8673","LAS1L",35,22,57,0.385964912280702,0.614035087719298,1
"8674","LASP1",7,10,17,0.588235294117647,0.411764705882353,1
"8675","LAT",9,13,22,0.590909090909091,0.409090909090909,1
"8676","LAT2",11,12,23,0.521739130434783,0.478260869565217,1
"8677","LATS1",42,97,139,0.697841726618705,0.302158273381295,1
"8678","LATS2",38,66,104,0.634615384615385,0.365384615384615,1
"8679","LAX1",26,22,48,0.458333333333333,0.541666666666667,1
"8680","LAYN",18,23,41,0.560975609756098,0.439024390243902,1
"8681","LBH",6,8,14,0.571428571428571,0.428571428571429,1
"8682","LBHD1",6,10,16,0.625,0.375,1
"8683","LBP",20,41,61,0.672131147540984,0.327868852459016,1
"8684","LBR",29,40,69,0.579710144927536,0.420289855072464,1
"8685","LBX1",7,12,19,0.631578947368421,0.368421052631579,1
"8686","LBX2",4,8,12,0.666666666666667,0.333333333333333,1
"8687","LCA5",31,68,99,0.686868686868687,0.313131313131313,1
"8688","LCA5L",14,40,54,0.740740740740741,0.259259259259259,1
"8689","LCAT",9,21,30,0.7,0.3,1
"8690","LCE1A",8,14,22,0.636363636363636,0.363636363636364,1
"8691","LCE1B",14,26,40,0.65,0.35,1
"8692","LCE1C",5,21,26,0.807692307692308,0.192307692307692,1
"8693","LCE1D",8,17,25,0.68,0.32,1
"8694","LCE1E",14,19,33,0.575757575757576,0.424242424242424,1
"8695","LCE1F",19,24,43,0.558139534883721,0.441860465116279,1
"8696","LCE2A",10,10,20,0.5,0.5,1
"8697","LCE2B",12,28,40,0.7,0.3,1
"8698","LCE2C",12,20,32,0.625,0.375,1
"8699","LCE2D",11,17,28,0.607142857142857,0.392857142857143,1
"8700","LCE3A",10,6,16,0.375,0.625,1
"8701","LCE3B",3,5,8,0.625,0.375,1
"8702","LCE3C",1,1,2,0.5,0.5,1
"8703","LCE3D",12,17,29,0.586206896551724,0.413793103448276,1
"8704","LCE3E",8,18,26,0.692307692307692,0.307692307692308,1
"8705","LCE4A",5,8,13,0.615384615384615,0.384615384615385,1
"8706","LCE5A",6,18,24,0.75,0.25,1
"8707","LCK",28,46,74,0.621621621621622,0.378378378378378,1
"8708","LCLAT1",18,28,46,0.608695652173913,0.391304347826087,1
"8709","LCMT1",11,17,28,0.607142857142857,0.392857142857143,1
"8710","LCMT2",23,44,67,0.656716417910448,0.343283582089552,1
"8711","LCN1",7,16,23,0.695652173913043,0.304347826086957,1
"8712","LCN10",4,1,5,0.2,0.8,1
"8713","LCN12",2,9,11,0.818181818181818,0.181818181818182,1
"8714","LCN15",9,7,16,0.4375,0.5625,1
"8715","LCN1P1",0,1,1,1,0,1
"8716","LCN2",7,18,25,0.72,0.28,1
"8717","LCN6",6,7,13,0.538461538461538,0.461538461538462,1
"8718","LCN8",10,9,19,0.473684210526316,0.526315789473684,1
"8719","LCN9",6,10,16,0.625,0.375,1
"8720","LCNL1",2,5,7,0.714285714285714,0.285714285714286,1
"8721","LCOR",73,111,184,0.603260869565217,0.396739130434783,1
"8722","LCORL",6,12,18,0.666666666666667,0.333333333333333,1
"8723","LCP1",29,62,91,0.681318681318681,0.318681318681319,1
"8724","LCP2",27,39,66,0.590909090909091,0.409090909090909,1
"8725","LCT",114,205,319,0.642633228840125,0.357366771159875,1
"8726","LCTL",18,44,62,0.709677419354839,0.290322580645161,1
"8727","LDAH",14,23,37,0.621621621621622,0.378378378378378,1
"8728","LDB1",19,21,40,0.525,0.475,1
"8729","LDB2",35,64,99,0.646464646464647,0.353535353535354,1
"8730","LDB3",24,45,69,0.652173913043478,0.347826086956522,1
"8731","LDHA",9,23,32,0.71875,0.28125,1
"8732","LDHAL6A",13,19,32,0.59375,0.40625,1
"8733","LDHAL6B",10,32,42,0.761904761904762,0.238095238095238,1
"8734","LDHB",13,25,38,0.657894736842105,0.342105263157895,1
"8735","LDHC",13,28,41,0.682926829268293,0.317073170731707,1
"8736","LDHD",8,22,30,0.733333333333333,0.266666666666667,1
"8737","LDLR",22,64,86,0.744186046511628,0.255813953488372,1
"8738","LDLRAD1",6,9,15,0.6,0.4,1
"8739","LDLRAD2",8,12,20,0.6,0.4,1
"8740","LDLRAD3",18,17,35,0.485714285714286,0.514285714285714,1
"8741","LDLRAD4",23,24,47,0.51063829787234,0.48936170212766,1
"8742","LDLRAP1",20,24,44,0.545454545454545,0.454545454545455,1
"8743","LDOC1",15,23,38,0.605263157894737,0.394736842105263,1
"8744","LEAP2",0,3,3,1,0,1
"8745","LECT2",10,9,19,0.473684210526316,0.526315789473684,1
"8746","LEF1",30,35,65,0.538461538461538,0.461538461538462,1
"8747","LEFTY1",12,18,30,0.6,0.4,1
"8748","LEFTY2",13,18,31,0.580645161290323,0.419354838709677,1
"8749","LEKR1",1,3,4,0.75,0.25,1
"8750","LELP1",12,28,40,0.7,0.3,1
"8751","LEMD1",5,12,17,0.705882352941177,0.294117647058824,1
"8752","LEMD2",14,8,22,0.363636363636364,0.636363636363636,1
"8753","LEMD3",31,41,72,0.569444444444444,0.430555555555556,1
"8754","LENEP",1,7,8,0.875,0.125,1
"8755","LENG1",6,19,25,0.76,0.24,1
"8756","LENG8",35,52,87,0.597701149425287,0.402298850574713,1
"8757","LENG9",7,24,31,0.774193548387097,0.225806451612903,1
"8758","LEO1",14,46,60,0.766666666666667,0.233333333333333,1
"8759","LEP",5,14,19,0.736842105263158,0.263157894736842,1
"8760","LEPR",59,131,190,0.689473684210526,0.310526315789474,1
"8761","LEPROT",10,3,13,0.230769230769231,0.769230769230769,1
"8762","LEPROTL1",5,6,11,0.545454545454545,0.454545454545455,1
"8763","LETM1",25,28,53,0.528301886792453,0.471698113207547,1
"8764","LETM2",6,20,26,0.769230769230769,0.230769230769231,1
"8765","LETMD1",16,26,42,0.619047619047619,0.380952380952381,1
"8766","LEUTX",0,1,1,1,0,1
"8767","LEXM",22,33,55,0.6,0.4,1
"8768","LFNG",11,17,28,0.607142857142857,0.392857142857143,1
"8769","LGALS1",7,2,9,0.222222222222222,0.777777777777778,1
"8770","LGALS12",15,24,39,0.615384615384615,0.384615384615385,1
"8771","LGALS13",12,17,29,0.586206896551724,0.413793103448276,1
"8772","LGALS14",13,9,22,0.409090909090909,0.590909090909091,1
"8773","LGALS2",8,14,22,0.636363636363636,0.363636363636364,0.09
"8774","LGALS3",4,11,15,0.733333333333333,0.266666666666667,1
"8775","LGALS3BP",9,29,38,0.763157894736842,0.236842105263158,1
"8776","LGALS4",15,26,41,0.634146341463415,0.365853658536585,1
"8777","LGALS7",1,2,3,0.666666666666667,0.333333333333333,1
"8778","LGALS7B",1,4,5,0.8,0.2,1
"8779","LGALS8",6,17,23,0.739130434782609,0.260869565217391,1
"8780","LGALS9",14,32,46,0.695652173913043,0.304347826086957,1
"8781","LGALS9B",15,18,33,0.545454545454545,0.454545454545455,1
"8782","LGALS9C",11,8,19,0.421052631578947,0.578947368421053,1
"8783","LGALSL",3,8,11,0.727272727272727,0.272727272727273,1
"8784","LGI1",21,50,71,0.704225352112676,0.295774647887324,1
"8785","LGI2",27,51,78,0.653846153846154,0.346153846153846,1
"8786","LGI3",17,41,58,0.706896551724138,0.293103448275862,1
"8787","LGI4",11,19,30,0.633333333333333,0.366666666666667,1
"8788","LGMN",9,26,35,0.742857142857143,0.257142857142857,1
"8789","LGR4",50,58,108,0.537037037037037,0.462962962962963,1
"8790","LGR5",51,72,123,0.585365853658537,0.414634146341463,1
"8791","LGR6",34,83,117,0.709401709401709,0.290598290598291,1
"8792","LGSN",32,80,112,0.714285714285714,0.285714285714286,1
"8793","LHB",6,11,17,0.647058823529412,0.352941176470588,1
"8794","LHCGR",50,106,156,0.67948717948718,0.320512820512821,1
"8795","LHFPL1",16,16,32,0.5,0.5,1
"8796","LHFPL2",6,10,16,0.625,0.375,1
"8797","LHFPL3",16,24,40,0.6,0.4,1
"8798","LHFPL4",9,28,37,0.756756756756757,0.243243243243243,1
"8799","LHFPL5",20,20,40,0.5,0.5,1
"8800","LHFPL6",10,22,32,0.6875,0.3125,1
"8801","LHPP",15,9,24,0.375,0.625,1
"8802","LHX1",24,34,58,0.586206896551724,0.413793103448276,1
"8803","LHX2",14,30,44,0.681818181818182,0.318181818181818,1
"8804","LHX3",9,19,28,0.678571428571429,0.321428571428571,1
"8805","LHX4",13,28,41,0.682926829268293,0.317073170731707,1
"8806","LHX5",11,21,32,0.65625,0.34375,1
"8807","LHX6",8,21,29,0.724137931034483,0.275862068965517,1
"8808","LHX8",33,46,79,0.582278481012658,0.417721518987342,1
"8809","LHX9",20,42,62,0.67741935483871,0.32258064516129,1
"8810","LIAS",17,20,37,0.540540540540541,0.459459459459459,1
"8811","LIF",9,8,17,0.470588235294118,0.529411764705882,1
"8812","LIFR",55,133,188,0.707446808510638,0.292553191489362,1
"8813","LIG1",34,46,80,0.575,0.425,1
"8814","LIG3",25,60,85,0.705882352941177,0.294117647058824,1
"8815","LIG4",37,64,101,0.633663366336634,0.366336633663366,1
"8816","LILRA1",35,86,121,0.710743801652893,0.289256198347107,1
"8817","LILRA2",40,80,120,0.666666666666667,0.333333333333333,1
"8818","LILRA4",30,63,93,0.67741935483871,0.32258064516129,1
"8819","LILRA5",22,42,64,0.65625,0.34375,1
"8820","LILRA6",23,40,63,0.634920634920635,0.365079365079365,1
"8821","LILRB1",67,107,174,0.614942528735632,0.385057471264368,1
"8822","LILRB2",42,73,115,0.634782608695652,0.365217391304348,1
"8823","LILRB3",34,65,99,0.656565656565657,0.343434343434343,1
"8824","LILRB4",53,71,124,0.57258064516129,0.42741935483871,1
"8825","LILRB5",48,86,134,0.641791044776119,0.358208955223881,1
"8826","LIM2",10,16,26,0.615384615384615,0.384615384615385,1
"8827","LIMA1",29,49,78,0.628205128205128,0.371794871794872,1
"8828","LIMCH1",44,83,127,0.653543307086614,0.346456692913386,1
"8829","LIMD1",18,29,47,0.617021276595745,0.382978723404255,1
"8830","LIMD2",5,6,11,0.545454545454545,0.454545454545455,1
"8831","LIME1",4,8,12,0.666666666666667,0.333333333333333,1
"8832","LIMK1",27,34,61,0.557377049180328,0.442622950819672,1
"8833","LIMK2",25,33,58,0.568965517241379,0.431034482758621,1
"8834","LIMS1",3,13,16,0.8125,0.1875,1
"8835","LIMS2",15,22,37,0.594594594594595,0.405405405405405,1
"8836","LIN28A",7,18,25,0.72,0.28,1
"8837","LIN28B",14,30,44,0.681818181818182,0.318181818181818,1
"8838","LIN37",5,14,19,0.736842105263158,0.263157894736842,1
"8839","LIN52",4,5,9,0.555555555555556,0.444444444444444,1
"8840","LIN54",18,24,42,0.571428571428571,0.428571428571429,1
"8841","LIN7A",24,39,63,0.619047619047619,0.380952380952381,1
"8842","LIN7B",4,10,14,0.714285714285714,0.285714285714286,1
"8843","LIN7C",4,11,15,0.733333333333333,0.266666666666667,1
"8844","LIN9",20,22,42,0.523809523809524,0.476190476190476,1
"8845","LINC00173",7,11,18,0.611111111111111,0.388888888888889,1
"8846","LINC00174",7,5,12,0.416666666666667,0.583333333333333,1
"8847","LINC00205",1,0,1,0,1,1
"8848","LINC00303",5,5,10,0.5,0.5,1
"8849","LINC00471",1,0,1,0,1,1
"8850","LINC00482",6,7,13,0.538461538461538,0.461538461538462,1
"8851","LINC00518",2,8,10,0.8,0.2,1
"8852","LINC00544",1,1,2,0.5,0.5,1
"8853","LINC00587",0,2,2,1,0,1
"8854","LINC00618",0,1,1,1,0,1
"8855","LINC00840",1,0,1,0,1,1
"8856","LINC00922",5,7,12,0.583333333333333,0.416666666666667,1
"8857","LINC01098",10,12,22,0.545454545454545,0.454545454545455,1
"8858","LINC01118",0,1,1,1,0,1
"8859","LINC01205",0,2,2,1,0,1
"8860","LINC01276",0,1,1,1,0,1
"8861","LINC01517",0,1,1,1,0,1
"8862","LINC01546",0,1,1,1,0,1
"8863","LINC01548",0,3,3,1,0,1
"8864","LINC01553",1,5,6,0.833333333333333,0.166666666666667,1
"8865","LINC01555",1,0,1,0,1,1
"8866","LINC01559",5,24,29,0.827586206896552,0.172413793103448,1
"8867","LINC01561",0,4,4,1,0,1
"8868","LINC01565",8,9,17,0.529411764705882,0.470588235294118,1
"8869","LINC01587",4,8,12,0.666666666666667,0.333333333333333,1
"8870","LINC01588",6,14,20,0.7,0.3,1
"8871","LINC01600",6,21,27,0.777777777777778,0.222222222222222,1
"8872","LINC01644",1,1,2,0.5,0.5,1
"8873","LINC01804",0,1,1,1,0,1
"8874","LINC01973",0,1,1,1,0,1
"8875","LINC02145",4,14,18,0.777777777777778,0.222222222222222,1
"8876","LINC02210-CRHR1",12,25,37,0.675675675675676,0.324324324324324,1
"8877","LINC02692",0,1,1,1,0,1
"8878","LINC02694",11,20,31,0.645161290322581,0.354838709677419,1
"8879","LINC02724",0,2,2,1,0,1
"8880","LINC02843",6,20,26,0.769230769230769,0.230769230769231,1
"8881","LINC02868",0,1,1,1,0,1
"8882","LINC02870",4,10,14,0.714285714285714,0.285714285714286,1
"8883","LINC02872",7,13,20,0.65,0.35,1
"8884","LINC02876",0,1,1,1,0,1
"8885","LINC02877",6,7,13,0.538461538461538,0.461538461538462,1
"8886","LINGO1",30,47,77,0.61038961038961,0.38961038961039,1
"8887","LINGO2",56,91,147,0.619047619047619,0.380952380952381,1
"8888","LINGO3",13,17,30,0.566666666666667,0.433333333333333,1
"8889","LINGO4",24,30,54,0.555555555555556,0.444444444444444,1
"8890","LINS1",30,26,56,0.464285714285714,0.535714285714286,1
"8891","LIPA",13,11,24,0.458333333333333,0.541666666666667,1
"8892","LIPC",23,47,70,0.671428571428571,0.328571428571429,1
"8893","LIPE",35,51,86,0.593023255813954,0.406976744186047,1
"8894","LIPF",24,35,59,0.593220338983051,0.406779661016949,1
"8895","LIPG",33,31,64,0.484375,0.515625,1
"8896","LIPH",14,37,51,0.725490196078431,0.274509803921569,1
"8897","LIPI",40,85,125,0.68,0.32,1
"8898","LIPJ",9,26,35,0.742857142857143,0.257142857142857,1
"8899","LIPK",12,27,39,0.692307692307692,0.307692307692308,1
"8900","LIPM",1,3,4,0.75,0.25,1
"8901","LIPN",12,23,35,0.657142857142857,0.342857142857143,1
"8902","LIPT1",22,28,50,0.56,0.44,1
"8903","LITAF",1,8,9,0.888888888888889,0.111111111111111,1
"8904","LIX1",13,19,32,0.59375,0.40625,1
"8905","LIX1L",11,11,22,0.5,0.5,1
"8906","LKAAEAR1",1,0,1,0,1,0.77
"8907","LLCFC1",7,12,19,0.631578947368421,0.368421052631579,1
"8908","LLGL1",26,32,58,0.551724137931034,0.448275862068966,1
"8909","LLGL2",36,58,94,0.617021276595745,0.382978723404255,1
"8910","LLPH",4,5,9,0.555555555555556,0.444444444444444,1
"8911","LMAN1",34,45,79,0.569620253164557,0.430379746835443,1
"8912","LMAN1L",20,43,63,0.682539682539683,0.317460317460317,1
"8913","LMAN2",12,21,33,0.636363636363636,0.363636363636364,1
"8914","LMAN2L",12,20,32,0.625,0.375,1
"8915","LMBR1",15,29,44,0.659090909090909,0.340909090909091,1
"8916","LMBR1L",14,16,30,0.533333333333333,0.466666666666667,1
"8917","LMBRD1",34,35,69,0.507246376811594,0.492753623188406,1
"8918","LMBRD2",35,54,89,0.606741573033708,0.393258426966292,1
"8919","LMCD1",13,29,42,0.69047619047619,0.30952380952381,1
"8920","LMF1",14,16,30,0.533333333333333,0.466666666666667,1
"8921","LMF2",14,28,42,0.666666666666667,0.333333333333333,1
"8922","LMLN",18,41,59,0.694915254237288,0.305084745762712,1
"8923","LMNA",11,27,38,0.710526315789474,0.289473684210526,1
"8924","LMNB1",13,21,34,0.617647058823529,0.382352941176471,1
"8925","LMNB2",17,28,45,0.622222222222222,0.377777777777778,1
"8926","LMNTD1",17,38,55,0.690909090909091,0.309090909090909,1
"8927","LMNTD2",10,22,32,0.6875,0.3125,1
"8928","LMO1",5,8,13,0.615384615384615,0.384615384615385,1
"8929","LMO2",7,14,21,0.666666666666667,0.333333333333333,1
"8930","LMO3",3,15,18,0.833333333333333,0.166666666666667,1
"8931","LMO4",9,17,26,0.653846153846154,0.346153846153846,1
"8932","LMO7",68,133,201,0.661691542288557,0.338308457711443,1
"8933","LMOD1",25,35,60,0.583333333333333,0.416666666666667,1
"8934","LMOD2",28,34,62,0.548387096774194,0.451612903225806,1
"8935","LMOD3",13,42,55,0.763636363636364,0.236363636363636,1
"8936","LMTK2",55,77,132,0.583333333333333,0.416666666666667,1
"8937","LMTK3",43,53,96,0.552083333333333,0.447916666666667,1
"8938","LMX1A",34,59,93,0.634408602150538,0.365591397849462,1
"8939","LMX1B",19,21,40,0.525,0.475,1
"8940","LNP1",6,17,23,0.739130434782609,0.260869565217391,1
"8941","LNPEP",41,65,106,0.613207547169811,0.386792452830189,1
"8942","LNPK",23,33,56,0.589285714285714,0.410714285714286,1
"8943","LNX1",37,52,89,0.584269662921348,0.415730337078652,1
"8944","LNX2",22,37,59,0.627118644067797,0.372881355932203,1
"8945","LONP1",35,30,65,0.461538461538462,0.538461538461538,1
"8946","LONP2",32,55,87,0.632183908045977,0.367816091954023,1
"8947","LONRF1",22,34,56,0.607142857142857,0.392857142857143,1
"8948","LONRF2",34,50,84,0.595238095238095,0.404761904761905,1
"8949","LONRF3",43,34,77,0.441558441558442,0.558441558441558,1
"8950","LORICRIN",6,1,7,0.142857142857143,0.857142857142857,1
"8951","LOX",14,28,42,0.666666666666667,0.333333333333333,1
"8952","LOXHD1",1,12,13,0.923076923076923,0.0769230769230769,1
"8953","LOXL1",9,19,28,0.678571428571429,0.321428571428571,1
"8954","LOXL2",33,61,94,0.648936170212766,0.351063829787234,1
"8955","LOXL3",27,54,81,0.666666666666667,0.333333333333333,1
"8956","LOXL4",19,44,63,0.698412698412698,0.301587301587302,1
"8957","LPA",104,214,318,0.672955974842767,0.327044025157233,1
"8958","LPAL2",11,20,31,0.645161290322581,0.354838709677419,1
"8959","LPAR1",22,44,66,0.666666666666667,0.333333333333333,0.77
"8960","LPAR2",13,19,32,0.59375,0.40625,0.77
"8961","LPAR3",22,38,60,0.633333333333333,0.366666666666667,0.77
"8962","LPAR4",48,50,98,0.510204081632653,0.489795918367347,0.77
"8963","LPAR5",6,16,22,0.727272727272727,0.272727272727273,0.77
"8964","LPAR6",6,22,28,0.785714285714286,0.214285714285714,0.77
"8965","LPCAT1",24,32,56,0.571428571428571,0.428571428571429,1
"8966","LPCAT2",19,29,48,0.604166666666667,0.395833333333333,1
"8967","LPCAT3",12,21,33,0.636363636363636,0.363636363636364,1
"8968","LPCAT4",15,25,40,0.625,0.375,1
"8969","LPGAT1",6,19,25,0.76,0.24,1
"8970","LPIN1",26,65,91,0.714285714285714,0.285714285714286,1
"8971","LPIN2",29,59,88,0.670454545454545,0.329545454545455,1
"8972","LPIN3",26,34,60,0.566666666666667,0.433333333333333,1
"8973","LPL",23,34,57,0.596491228070175,0.403508771929825,1
"8974","LPO",29,60,89,0.674157303370786,0.325842696629214,1
"8975","LPP",30,59,89,0.662921348314607,0.337078651685393,1
"8976","LPXN",12,11,23,0.478260869565217,0.521739130434783,1
"8977","LRAT",16,25,41,0.609756097560976,0.390243902439024,1
"8978","LRATD1",13,14,27,0.518518518518518,0.481481481481481,1
"8979","LRATD2",7,10,17,0.588235294117647,0.411764705882353,1
"8980","LRBA",81,172,253,0.679841897233202,0.320158102766798,1
"8981","LRCH1",26,25,51,0.490196078431373,0.509803921568627,1
"8982","LRCH2",34,27,61,0.442622950819672,0.557377049180328,1
"8983","LRCH3",21,48,69,0.695652173913043,0.304347826086957,1
"8984","LRCH4",29,32,61,0.524590163934426,0.475409836065574,1
"8985","LRFN1",29,30,59,0.508474576271186,0.491525423728814,1
"8986","LRFN2",74,101,175,0.577142857142857,0.422857142857143,1
"8987","LRFN3",32,37,69,0.536231884057971,0.463768115942029,1
"8988","LRFN4",15,21,36,0.583333333333333,0.416666666666667,1
"8989","LRFN5",114,151,265,0.569811320754717,0.430188679245283,1
"8990","LRG1",22,21,43,0.488372093023256,0.511627906976744,1
"8991","LRGUK",37,78,115,0.678260869565217,0.321739130434783,1
"8992","LRIF1",24,60,84,0.714285714285714,0.285714285714286,1
"8993","LRIG1",23,64,87,0.735632183908046,0.264367816091954,1
"8994","LRIG2",38,62,100,0.62,0.38,1
"8995","LRIG3",44,72,116,0.620689655172414,0.379310344827586,1
"8996","LRIT1",38,60,98,0.612244897959184,0.387755102040816,1
"8997","LRIT2",28,65,93,0.698924731182796,0.301075268817204,1
"8998","LRIT3",20,44,64,0.6875,0.3125,1
"8999","LRMDA",8,14,22,0.636363636363636,0.363636363636364,1
"9000","LRP1",201,279,480,0.58125,0.41875,1
"9001","LRP10",37,46,83,0.55421686746988,0.44578313253012,1
"9002","LRP11",10,9,19,0.473684210526316,0.526315789473684,1
"9003","LRP12",63,106,169,0.627218934911243,0.372781065088757,1
"9004","LRP1B",569,1041,1610,0.646583850931677,0.353416149068323,1
"9005","LRP2",225,511,736,0.69429347826087,0.30570652173913,1
"9006","LRP2BP",11,15,26,0.576923076923077,0.423076923076923,1
"9007","LRP3",17,38,55,0.690909090909091,0.309090909090909,1
"9008","LRP4",63,116,179,0.64804469273743,0.35195530726257,1
"9009","LRP5",63,87,150,0.58,0.42,1
"9010","LRP5L",12,25,37,0.675675675675676,0.324324324324324,1
"9011","LRP6",55,114,169,0.674556213017751,0.325443786982249,1
"9012","LRP8",18,39,57,0.684210526315789,0.315789473684211,1
"9013","LRPAP1",5,18,23,0.782608695652174,0.217391304347826,1
"9014","LRPPRC",35,79,114,0.692982456140351,0.307017543859649,1
"9015","LRR1",15,15,30,0.5,0.5,1
"9016","LRRC1",24,26,50,0.52,0.48,1
"9017","LRRC10",15,22,37,0.594594594594595,0.405405405405405,1
"9018","LRRC14",24,21,45,0.466666666666667,0.533333333333333,1
"9019","LRRC14B",12,21,33,0.636363636363636,0.363636363636364,1
"9020","LRRC15",32,49,81,0.604938271604938,0.395061728395062,1
"9021","LRRC17",37,36,73,0.493150684931507,0.506849315068493,1
"9022","LRRC18",20,34,54,0.62962962962963,0.37037037037037,1
"9023","LRRC19",10,14,24,0.583333333333333,0.416666666666667,1
"9024","LRRC2",13,24,37,0.648648648648649,0.351351351351351,1
"9025","LRRC20",4,8,12,0.666666666666667,0.333333333333333,1
"9026","LRRC23",9,18,27,0.666666666666667,0.333333333333333,1
"9027","LRRC24",3,9,12,0.75,0.25,1
"9028","LRRC25",9,23,32,0.71875,0.28125,1
"9029","LRRC26",1,0,1,0,1,1
"9030","LRRC27",18,27,45,0.6,0.4,1
"9031","LRRC28",12,29,41,0.707317073170732,0.292682926829268,1
"9032","LRRC29",2,6,8,0.75,0.25,1
"9033","LRRC3",14,21,35,0.6,0.4,1
"9034","LRRC30",29,57,86,0.662790697674419,0.337209302325581,1
"9035","LRRC31",35,51,86,0.593023255813954,0.406976744186047,1
"9036","LRRC32",45,52,97,0.536082474226804,0.463917525773196,1
"9037","LRRC34",14,19,33,0.575757575757576,0.424242424242424,1
"9038","LRRC36",25,45,70,0.642857142857143,0.357142857142857,1
"9039","LRRC37A",9,15,24,0.625,0.375,1
"9040","LRRC37A2",23,26,49,0.530612244897959,0.469387755102041,1
"9041","LRRC37A3",40,78,118,0.661016949152542,0.338983050847458,1
"9042","LRRC37B",33,62,95,0.652631578947368,0.347368421052632,1
"9043","LRRC38",1,1,2,0.5,0.5,1
"9044","LRRC39",8,15,23,0.652173913043478,0.347826086956522,1
"9045","LRRC3B",30,41,71,0.577464788732394,0.422535211267606,1
"9046","LRRC4",28,41,69,0.594202898550725,0.405797101449275,1
"9047","LRRC40",20,36,56,0.642857142857143,0.357142857142857,1
"9048","LRRC41",30,43,73,0.589041095890411,0.410958904109589,1
"9049","LRRC42",12,30,42,0.714285714285714,0.285714285714286,1
"9050","LRRC43",38,43,81,0.530864197530864,0.469135802469136,1
"9051","LRRC45",15,17,32,0.53125,0.46875,1
"9052","LRRC46",9,14,23,0.608695652173913,0.391304347826087,1
"9053","LRRC47",17,17,34,0.5,0.5,1
"9054","LRRC49",46,52,98,0.530612244897959,0.469387755102041,1
"9055","LRRC4B",42,70,112,0.625,0.375,1
"9056","LRRC4C",91,161,252,0.638888888888889,0.361111111111111,1
"9057","LRRC52",15,35,50,0.7,0.3,1
"9058","LRRC55",20,37,57,0.649122807017544,0.350877192982456,1
"9059","LRRC56",12,26,38,0.684210526315789,0.315789473684211,1
"9060","LRRC57",5,22,27,0.814814814814815,0.185185185185185,1
"9061","LRRC58",7,13,20,0.65,0.35,1
"9062","LRRC59",12,15,27,0.555555555555556,0.444444444444444,1
"9063","LRRC6",23,50,73,0.684931506849315,0.315068493150685,1
"9064","LRRC61",13,8,21,0.380952380952381,0.619047619047619,1
"9065","LRRC63",0,3,3,1,0,1
"9066","LRRC66",61,114,175,0.651428571428571,0.348571428571429,1
"9067","LRRC69",0,1,1,1,0,1
"9068","LRRC7",148,291,439,0.662870159453303,0.337129840546697,1
"9069","LRRC70",0,4,4,1,0,1
"9070","LRRC71",13,16,29,0.551724137931034,0.448275862068966,1
"9071","LRRC73",4,17,21,0.80952380952381,0.19047619047619,1
"9072","LRRC74A",19,22,41,0.536585365853659,0.463414634146341,1
"9073","LRRC74B",0,3,3,1,0,1
"9074","LRRC75A",8,2,10,0.2,0.8,1
"9075","LRRC75B",6,9,15,0.6,0.4,1
"9076","LRRC8A",22,47,69,0.681159420289855,0.318840579710145,1
"9077","LRRC8B",24,29,53,0.547169811320755,0.452830188679245,1
"9078","LRRC8C",23,43,66,0.651515151515151,0.348484848484849,1
"9079","LRRC8D",21,39,60,0.65,0.35,1
"9080","LRRC8E",20,30,50,0.6,0.4,1
"9081","LRRCC1",53,81,134,0.604477611940298,0.395522388059701,1
"9082","LRRD1",1,9,10,0.9,0.1,1
"9083","LRRFIP1",23,36,59,0.610169491525424,0.389830508474576,1
"9084","LRRFIP2",29,39,68,0.573529411764706,0.426470588235294,1
"9085","LRRIQ1",127,207,334,0.619760479041916,0.380239520958084,1
"9086","LRRIQ3",76,132,208,0.634615384615385,0.365384615384615,1
"9087","LRRIQ4",28,54,82,0.658536585365854,0.341463414634146,1
"9088","LRRK1",78,102,180,0.566666666666667,0.433333333333333,1
"9089","LRRK2",166,251,417,0.601918465227818,0.398081534772182,1
"9090","LRRN1",36,75,111,0.675675675675676,0.324324324324324,1
"9091","LRRN2",46,63,109,0.577981651376147,0.422018348623853,1
"9092","LRRN3",59,89,148,0.601351351351351,0.398648648648649,1
"9093","LRRN4",19,35,54,0.648148148148148,0.351851851851852,1
"9094","LRRN4CL",9,7,16,0.4375,0.5625,1
"9095","LRRTM1",54,90,144,0.625,0.375,1
"9096","LRRTM2",13,21,34,0.617647058823529,0.382352941176471,1
"9097","LRRTM3",44,77,121,0.636363636363636,0.363636363636364,1
"9098","LRRTM4",70,119,189,0.62962962962963,0.37037037037037,1
"9099","LRSAM1",17,20,37,0.540540540540541,0.459459459459459,1
"9100","LRTM1",23,56,79,0.708860759493671,0.291139240506329,1
"9101","LRTM2",18,38,56,0.678571428571429,0.321428571428571,1
"9102","LRTOMT",3,4,7,0.571428571428571,0.428571428571429,1
"9103","LRWD1",16,23,39,0.58974358974359,0.41025641025641,1
"9104","LSAMP",29,35,64,0.546875,0.453125,1
"9105","LSG1",24,29,53,0.547169811320755,0.452830188679245,1
"9106","LSM1",6,14,20,0.7,0.3,1
"9107","LSM10",5,11,16,0.6875,0.3125,1
"9108","LSM11",13,11,24,0.458333333333333,0.541666666666667,1
"9109","LSM12",4,3,7,0.428571428571429,0.571428571428571,1
"9110","LSM14A",27,27,54,0.5,0.5,1
"9111","LSM14B",12,19,31,0.612903225806452,0.387096774193548,1
"9112","LSM2",3,4,7,0.571428571428571,0.428571428571429,1
"9113","LSM3",7,7,14,0.5,0.5,1
"9114","LSM4",3,8,11,0.727272727272727,0.272727272727273,1
"9115","LSM5",3,2,5,0.4,0.6,1
"9116","LSM6",3,0,3,0,1,1
"9117","LSM7",0,4,4,1,0,1
"9118","LSM8",5,11,16,0.6875,0.3125,1
"9119","LSMEM1",8,7,15,0.466666666666667,0.533333333333333,1
"9120","LSMEM2",4,7,11,0.636363636363636,0.363636363636364,1
"9121","LSP1",17,28,45,0.622222222222222,0.377777777777778,1
"9122","LSR",21,42,63,0.666666666666667,0.333333333333333,1
"9123","LSS",27,40,67,0.597014925373134,0.402985074626866,1
"9124","LST1",0,3,3,1,0,1
"9125","LTA",5,16,21,0.761904761904762,0.238095238095238,1
"9126","LTA4H",16,29,45,0.644444444444444,0.355555555555556,1
"9127","LTB",9,12,21,0.571428571428571,0.428571428571429,1
"9128","LTB4R",5,16,21,0.761904761904762,0.238095238095238,1
"9129","LTB4R2",16,9,25,0.36,0.64,1
"9130","LTBP1",109,166,275,0.603636363636364,0.396363636363636,1
"9131","LTBP2",69,146,215,0.67906976744186,0.32093023255814,1
"9132","LTBP3",43,39,82,0.475609756097561,0.524390243902439,1
"9133","LTBP4",49,78,127,0.614173228346457,0.385826771653543,1
"9134","LTBR",11,19,30,0.633333333333333,0.366666666666667,1
"9135","LTC4S",1,1,2,0.5,0.5,1
"9136","LTF",29,58,87,0.666666666666667,0.333333333333333,1
"9137","LTK",24,34,58,0.586206896551724,0.413793103448276,1
"9138","LTN1",47,103,150,0.686666666666667,0.313333333333333,1
"9139","LTO1",5,10,15,0.666666666666667,0.333333333333333,1
"9140","LTV1",10,21,31,0.67741935483871,0.32258064516129,1
"9141","LUC7L",9,22,31,0.709677419354839,0.290322580645161,1
"9142","LUC7L2",13,28,41,0.682926829268293,0.317073170731707,1
"9143","LUC7L3",17,33,50,0.66,0.34,1
"9144","LUM",39,50,89,0.561797752808989,0.438202247191011,1
"9145","LURAP1",6,9,15,0.6,0.4,1
"9146","LURAP1L",11,8,19,0.421052631578947,0.578947368421053,1
"9147","LUZP1",39,42,81,0.518518518518518,0.481481481481481,1
"9148","LUZP2",36,80,116,0.689655172413793,0.310344827586207,1
"9149","LUZP4",29,25,54,0.462962962962963,0.537037037037037,1
"9150","LVRN",71,97,168,0.577380952380952,0.422619047619048,1
"9151","LXN",4,8,12,0.666666666666667,0.333333333333333,1
"9152","LY6D",5,11,16,0.6875,0.3125,1
"9153","LY6E",8,1,9,0.111111111111111,0.888888888888889,1
"9154","LY6G5B",6,7,13,0.538461538461538,0.461538461538462,1
"9155","LY6G5C",7,4,11,0.363636363636364,0.636363636363636,1
"9156","LY6G6C",7,8,15,0.533333333333333,0.466666666666667,1
"9157","LY6G6D",0,6,6,1,0,1
"9158","LY6G6F",1,3,4,0.75,0.25,1
"9159","LY6G6F-LY6G6D",23,27,50,0.54,0.46,1
"9160","LY6H",8,10,18,0.555555555555556,0.444444444444444,1
"9161","LY6K",12,11,23,0.478260869565217,0.521739130434783,1
"9162","LY75",66,120,186,0.645161290322581,0.354838709677419,1
"9163","LY75-CD302",7,14,21,0.666666666666667,0.333333333333333,1
"9164","LY86",10,15,25,0.6,0.4,1
"9165","LY9",22,71,93,0.763440860215054,0.236559139784946,1
"9166","LY96",10,23,33,0.696969696969697,0.303030303030303,1
"9167","LYAR",17,25,42,0.595238095238095,0.404761904761905,0.77
"9168","LYG1",4,16,20,0.8,0.2,1
"9169","LYG2",5,21,26,0.807692307692308,0.192307692307692,1
"9170","LYL1",5,5,10,0.5,0.5,1
"9171","LYN",30,48,78,0.615384615384615,0.384615384615385,1
"9172","LYNX1",4,6,10,0.6,0.4,1
"9173","LYNX1-SLURP2",9,5,14,0.357142857142857,0.642857142857143,1
"9174","LYPD1",6,4,10,0.4,0.6,1
"9175","LYPD2",5,8,13,0.615384615384615,0.384615384615385,1
"9176","LYPD3",10,24,34,0.705882352941177,0.294117647058824,1
"9177","LYPD4",9,21,30,0.7,0.3,1
"9178","LYPD5",6,4,10,0.4,0.6,1
"9179","LYPD6",5,7,12,0.583333333333333,0.416666666666667,1
"9180","LYPD6B",13,12,25,0.48,0.52,1
"9181","LYPD8",0,2,2,1,0,1
"9182","LYPLA1",6,6,12,0.5,0.5,1
"9183","LYPLA2",2,9,11,0.818181818181818,0.181818181818182,1
"9184","LYPLAL1",7,13,20,0.65,0.35,1
"9185","LYRM1",1,5,6,0.833333333333333,0.166666666666667,1
"9186","LYRM2",2,3,5,0.6,0.4,1
"9187","LYRM4",3,4,7,0.571428571428571,0.428571428571429,1
"9188","LYRM7",1,3,4,0.75,0.25,1
"9189","LYRM9",1,1,2,0.5,0.5,1
"9190","LYSMD1",7,13,20,0.65,0.35,1
"9191","LYSMD2",9,9,18,0.5,0.5,1
"9192","LYSMD3",11,15,26,0.576923076923077,0.423076923076923,1
"9193","LYSMD4",7,15,22,0.681818181818182,0.318181818181818,1
"9194","LYST",119,216,335,0.644776119402985,0.355223880597015,1
"9195","LYVE1",13,12,25,0.48,0.52,1
"9196","LYZ",5,14,19,0.736842105263158,0.263157894736842,1
"9197","LYZL1",15,15,30,0.5,0.5,1
"9198","LYZL2",10,18,28,0.642857142857143,0.357142857142857,1
"9199","LYZL4",2,14,16,0.875,0.125,1
"9200","LYZL6",8,18,26,0.692307692307692,0.307692307692308,1
"9201","LZIC",7,5,12,0.416666666666667,0.583333333333333,1
"9202","LZTFL1",11,19,30,0.633333333333333,0.366666666666667,1
"9203","LZTR1",52,64,116,0.551724137931034,0.448275862068966,1
"9204","LZTS1",32,38,70,0.542857142857143,0.457142857142857,1
"9205","LZTS2",23,36,59,0.610169491525424,0.389830508474576,1
"9206","LZTS3",23,33,56,0.589285714285714,0.410714285714286,1
"9207","M1AP",17,45,62,0.725806451612903,0.274193548387097,1
"9208","M6PR",9,7,16,0.4375,0.5625,1
"9209","MAB21L1",20,39,59,0.661016949152542,0.338983050847458,1
"9210","MAB21L2",22,43,65,0.661538461538462,0.338461538461538,1
"9211","MAB21L3",7,16,23,0.695652173913043,0.304347826086957,1
"9212","MAB21L4",11,20,31,0.645161290322581,0.354838709677419,1
"9213","MACC1",45,82,127,0.645669291338583,0.354330708661417,1
"9214","MACF1",210,404,614,0.657980456026059,0.342019543973941,1
"9215","MACIR",8,12,20,0.6,0.4,1
"9216","MACO1",26,41,67,0.611940298507463,0.388059701492537,0.58
"9217","MACROD1",6,8,14,0.571428571428571,0.428571428571429,0.37
"9218","MACROD2",23,64,87,0.735632183908046,0.264367816091954,0.37
"9219","MACROH2A1",11,24,35,0.685714285714286,0.314285714285714,0.37
"9220","MACROH2A2",21,28,49,0.571428571428571,0.428571428571429,0.37
"9221","MAD1L1",23,33,56,0.589285714285714,0.410714285714286,1
"9222","MAD2L1",6,13,19,0.684210526315789,0.315789473684211,1
"9223","MAD2L1BP",8,12,20,0.6,0.4,1
"9224","MAD2L2",3,8,11,0.727272727272727,0.272727272727273,1
"9225","MADCAM1",5,8,13,0.615384615384615,0.384615384615385,1
"9226","MADD",53,101,154,0.655844155844156,0.344155844155844,1
"9227","MAEA",14,23,37,0.621621621621622,0.378378378378378,1
"9228","MAEL",33,75,108,0.694444444444444,0.305555555555556,1
"9229","MAF",18,22,40,0.55,0.45,1
"9230","MAF1",14,7,21,0.333333333333333,0.666666666666667,1
"9231","MAFA",1,6,7,0.857142857142857,0.142857142857143,1
"9232","MAFB",8,17,25,0.68,0.32,1
"9233","MAFF",3,1,4,0.25,0.75,1
"9234","MAFG",2,3,5,0.6,0.4,1
"9235","MAFK",1,5,6,0.833333333333333,0.166666666666667,1
"9236","MAG",34,63,97,0.649484536082474,0.350515463917526,1
"9237","MAGEA1",26,19,45,0.422222222222222,0.577777777777778,1
"9238","MAGEA10",49,45,94,0.478723404255319,0.521276595744681,1
"9239","MAGEA11",53,38,91,0.417582417582418,0.582417582417582,1
"9240","MAGEA12",37,43,80,0.5375,0.4625,1
"9241","MAGEA3",30,25,55,0.454545454545455,0.545454545454545,1
"9242","MAGEA4",31,38,69,0.550724637681159,0.449275362318841,1
"9243","MAGEA5",24,17,41,0.414634146341463,0.585365853658537,1
"9244","MAGEA6",40,36,76,0.473684210526316,0.526315789473684,1
"9245","MAGEA8",26,19,45,0.422222222222222,0.577777777777778,1
"9246","MAGEA9",1,0,1,0,1,1
"9247","MAGEA9B",2,1,3,0.333333333333333,0.666666666666667,1
"9248","MAGEB1",39,41,80,0.5125,0.4875,1
"9249","MAGEB10",29,32,61,0.524590163934426,0.475409836065574,1
"9250","MAGEB16",29,40,69,0.579710144927536,0.420289855072464,1
"9251","MAGEB18",33,51,84,0.607142857142857,0.392857142857143,1
"9252","MAGEB2",39,35,74,0.472972972972973,0.527027027027027,1
"9253","MAGEB3",36,27,63,0.428571428571429,0.571428571428571,1
"9254","MAGEB4",49,30,79,0.379746835443038,0.620253164556962,1
"9255","MAGEB5",1,2,3,0.666666666666667,0.333333333333333,1
"9256","MAGEB6",63,60,123,0.48780487804878,0.51219512195122,1
"9257","MAGEB6B",76,91,167,0.544910179640719,0.455089820359281,1
"9258","MAGEC1",186,243,429,0.566433566433566,0.433566433566434,1
"9259","MAGEC2",58,76,134,0.567164179104478,0.432835820895522,1
"9260","MAGEC3",72,112,184,0.608695652173913,0.391304347826087,1
"9261","MAGED1",44,32,76,0.421052631578947,0.578947368421053,1
"9262","MAGED2",41,21,62,0.338709677419355,0.661290322580645,1
"9263","MAGEE1",81,59,140,0.421428571428571,0.578571428571429,1
"9264","MAGEE2",41,61,102,0.598039215686274,0.401960784313726,1
"9265","MAGEF1",8,16,24,0.666666666666667,0.333333333333333,1
"9266","MAGEH1",13,13,26,0.5,0.5,1
"9267","MAGEL2",60,102,162,0.62962962962963,0.37037037037037,1
"9268","MAGI1",50,137,187,0.732620320855615,0.267379679144385,1
"9269","MAGI2",97,152,249,0.610441767068273,0.389558232931727,1
"9270","MAGI3",47,79,126,0.626984126984127,0.373015873015873,1
"9271","MAGIX",22,13,35,0.371428571428571,0.628571428571429,1
"9272","MAGOH",2,7,9,0.777777777777778,0.222222222222222,1
"9273","MAGOHB",6,7,13,0.538461538461538,0.461538461538462,1
"9274","MAGT1",33,16,49,0.326530612244898,0.673469387755102,0.88
"9275","MAIP1",6,10,16,0.625,0.375,1
"9276","MAJIN",3,18,21,0.857142857142857,0.142857142857143,1
"9277","MAK",18,44,62,0.709677419354839,0.290322580645161,1
"9278","MAK16",12,14,26,0.538461538461538,0.461538461538462,1
"9279","MAL",4,13,17,0.764705882352941,0.235294117647059,1
"9280","MAL2",8,12,20,0.6,0.4,1
"9281","MALAT1",2,4,6,0.666666666666667,0.333333333333333,1
"9282","MALL",6,5,11,0.454545454545455,0.545454545454545,1
"9283","MALRD1",3,6,9,0.666666666666667,0.333333333333333,1
"9284","MALSU1",9,8,17,0.470588235294118,0.529411764705882,1
"9285","MALT1",38,29,67,0.432835820895522,0.567164179104478,1
"9286","MAMDC2",22,47,69,0.681159420289855,0.318840579710145,1
"9287","MAMDC4",14,38,52,0.730769230769231,0.269230769230769,1
"9288","MAML1",29,55,84,0.654761904761905,0.345238095238095,1
"9289","MAML2",32,56,88,0.636363636363636,0.363636363636364,1
"9290","MAML3",30,40,70,0.571428571428571,0.428571428571429,1
"9291","MAMLD1",56,32,88,0.363636363636364,0.636363636363636,1
"9292","MAMSTR",8,17,25,0.68,0.32,1
"9293","MAN1A1",23,65,88,0.738636363636364,0.261363636363636,1
"9294","MAN1A2",33,36,69,0.521739130434783,0.478260869565217,1
"9295","MAN1B1",21,25,46,0.543478260869565,0.456521739130435,1
"9296","MAN1C1",22,39,61,0.639344262295082,0.360655737704918,1
"9297","MAN2A1",54,77,131,0.587786259541985,0.412213740458015,1
"9298","MAN2A2",32,41,73,0.561643835616438,0.438356164383562,1
"9299","MAN2B1",37,39,76,0.513157894736842,0.486842105263158,1
"9300","MAN2B2",32,46,78,0.58974358974359,0.41025641025641,1
"9301","MAN2C1",24,55,79,0.69620253164557,0.30379746835443,1
"9302","MANBA",28,36,64,0.5625,0.4375,1
"9303","MANBAL",6,7,13,0.538461538461538,0.461538461538462,1
"9304","MANEA",20,49,69,0.710144927536232,0.289855072463768,1
"9305","MANEAL",15,16,31,0.516129032258065,0.483870967741935,1
"9306","MANF",7,7,14,0.5,0.5,1
"9307","MANSC1",12,29,41,0.707317073170732,0.292682926829268,1
"9308","MANSC4",1,0,1,0,1,1
"9309","MAOA",17,15,32,0.46875,0.53125,1
"9310","MAOB",29,21,50,0.42,0.58,1
"9311","MAP10",36,65,101,0.643564356435644,0.356435643564356,1
"9312","MAP11",10,17,27,0.62962962962963,0.37037037037037,1
"9313","MAP1A",98,156,254,0.614173228346457,0.385826771653543,1
"9314","MAP1B",115,162,277,0.584837545126354,0.415162454873646,1
"9315","MAP1LC3A",7,14,21,0.666666666666667,0.333333333333333,1
"9316","MAP1LC3B",2,3,5,0.6,0.4,1
"9317","MAP1LC3B2",11,11,22,0.5,0.5,1
"9318","MAP1LC3C",11,15,26,0.576923076923077,0.423076923076923,1
"9319","MAP1S",27,51,78,0.653846153846154,0.346153846153846,1
"9320","MAP2",120,174,294,0.591836734693878,0.408163265306122,1
"9321","MAP2K1",30,48,78,0.615384615384615,0.384615384615385,1
"9322","MAP2K2",14,32,46,0.695652173913043,0.304347826086957,1
"9323","MAP2K3",24,41,65,0.630769230769231,0.369230769230769,1
"9324","MAP2K4",38,44,82,0.536585365853659,0.463414634146341,1
"9325","MAP2K5",16,19,35,0.542857142857143,0.457142857142857,1
"9326","MAP2K6",15,22,37,0.594594594594595,0.405405405405405,1
"9327","MAP2K7",33,52,85,0.611764705882353,0.388235294117647,1
"9328","MAP3K1",48,62,110,0.563636363636364,0.436363636363636,1
"9329","MAP3K10",21,43,64,0.671875,0.328125,1
"9330","MAP3K11",23,57,80,0.7125,0.2875,1
"9331","MAP3K12",37,62,99,0.626262626262626,0.373737373737374,1
"9332","MAP3K13",37,76,113,0.672566371681416,0.327433628318584,1
"9333","MAP3K14",31,35,66,0.53030303030303,0.46969696969697,1
"9334","MAP3K15",63,47,110,0.427272727272727,0.572727272727273,1
"9335","MAP3K19",66,134,200,0.67,0.33,1
"9336","MAP3K2",18,31,49,0.63265306122449,0.36734693877551,1
"9337","MAP3K20",33,30,63,0.476190476190476,0.523809523809524,1
"9338","MAP3K21",56,112,168,0.666666666666667,0.333333333333333,1
"9339","MAP3K3",24,33,57,0.578947368421053,0.421052631578947,1
"9340","MAP3K4",74,116,190,0.610526315789474,0.389473684210526,1
"9341","MAP3K5",41,86,127,0.677165354330709,0.322834645669291,1
"9342","MAP3K6",23,49,72,0.680555555555556,0.319444444444444,1
"9343","MAP3K7",24,45,69,0.652173913043478,0.347826086956522,1
"9344","MAP3K7CL",3,12,15,0.8,0.2,1
"9345","MAP3K8",12,19,31,0.612903225806452,0.387096774193548,1
"9346","MAP3K9",46,78,124,0.629032258064516,0.370967741935484,1
"9347","MAP4",33,42,75,0.56,0.44,1
"9348","MAP4K1",28,53,81,0.654320987654321,0.345679012345679,1
"9349","MAP4K2",25,33,58,0.568965517241379,0.431034482758621,1
"9350","MAP4K3",40,47,87,0.540229885057471,0.459770114942529,1
"9351","MAP4K4",42,57,99,0.575757575757576,0.424242424242424,1
"9352","MAP4K5",17,19,36,0.527777777777778,0.472222222222222,1
"9353","MAP6",23,33,56,0.589285714285714,0.410714285714286,1
"9354","MAP6D1",0,1,1,1,0,1
"9355","MAP7",38,59,97,0.608247422680412,0.391752577319588,1
"9356","MAP7D1",42,48,90,0.533333333333333,0.466666666666667,1
"9357","MAP7D2",37,39,76,0.513157894736842,0.486842105263158,1
"9358","MAP7D3",64,34,98,0.346938775510204,0.653061224489796,1
"9359","MAP9",33,61,94,0.648936170212766,0.351063829787234,1
"9360","MAPK1",16,25,41,0.609756097560976,0.390243902439024,1
"9361","MAPK10",30,41,71,0.577464788732394,0.422535211267606,1
"9362","MAPK11",4,8,12,0.666666666666667,0.333333333333333,1
"9363","MAPK12",6,10,16,0.625,0.375,1
"9364","MAPK13",10,21,31,0.67741935483871,0.32258064516129,1
"9365","MAPK14",14,20,34,0.588235294117647,0.411764705882353,1
"9366","MAPK15",22,35,57,0.614035087719298,0.385964912280702,1
"9367","MAPK1IP1L",4,9,13,0.692307692307692,0.307692307692308,1
"9368","MAPK3",11,24,35,0.685714285714286,0.314285714285714,1
"9369","MAPK4",22,55,77,0.714285714285714,0.285714285714286,1
"9370","MAPK6",12,33,45,0.733333333333333,0.266666666666667,1
"9371","MAPK7",25,31,56,0.553571428571429,0.446428571428571,1
"9372","MAPK8",23,31,54,0.574074074074074,0.425925925925926,1
"9373","MAPK8IP1",21,38,59,0.644067796610169,0.355932203389831,1
"9374","MAPK8IP2",11,21,32,0.65625,0.34375,1
"9375","MAPK8IP3",46,70,116,0.603448275862069,0.396551724137931,1
"9376","MAPK9",20,30,50,0.6,0.4,1
"9377","MAPKAP1",24,26,50,0.52,0.48,1
"9378","MAPKAPK2",8,21,29,0.724137931034483,0.275862068965517,1
"9379","MAPKAPK3",9,22,31,0.709677419354839,0.290322580645161,1
"9380","MAPKAPK5",13,16,29,0.551724137931034,0.448275862068966,1
"9381","MAPKBP1",56,77,133,0.578947368421053,0.421052631578947,1
"9382","MAPRE1",8,14,22,0.636363636363636,0.363636363636364,1
"9383","MAPRE2",11,28,39,0.717948717948718,0.282051282051282,1
"9384","MAPRE3",36,33,69,0.478260869565217,0.521739130434783,1
"9385","MAPT",34,70,104,0.673076923076923,0.326923076923077,1
"9386","MARCHF1",19,27,46,0.58695652173913,0.41304347826087,0.24
"9387","MARCHF10",37,77,114,0.675438596491228,0.324561403508772,0.24
"9388","MARCHF11",25,45,70,0.642857142857143,0.357142857142857,0.24
"9389","MARCHF2",7,19,26,0.730769230769231,0.269230769230769,0.24
"9390","MARCHF3",7,14,21,0.666666666666667,0.333333333333333,0.24
"9391","MARCHF4",30,41,71,0.577464788732394,0.422535211267606,0.24
"9392","MARCHF5",10,6,16,0.375,0.625,0.24
"9393","MARCHF6",31,59,90,0.655555555555556,0.344444444444444,0.24
"9394","MARCHF7",33,40,73,0.547945205479452,0.452054794520548,0.24
"9395","MARCHF8",10,23,33,0.696969696969697,0.303030303030303,0.24
"9396","MARCHF9",6,8,14,0.571428571428571,0.428571428571429,0.24
"9397","MARCKS",11,8,19,0.421052631578947,0.578947368421053,0.24
"9398","MARCKSL1",16,7,23,0.304347826086957,0.695652173913043,0.24
"9399","MARCO",67,108,175,0.617142857142857,0.382857142857143,0.24
"9400","MARF1",47,83,130,0.638461538461538,0.361538461538462,0.6
"9401","MARK1",55,87,142,0.612676056338028,0.387323943661972,0.77
"9402","MARK2",37,59,96,0.614583333333333,0.385416666666667,0.77
"9403","MARK3",28,43,71,0.605633802816901,0.394366197183099,0.77
"9404","MARK4",31,40,71,0.563380281690141,0.436619718309859,0.77
"9405","MARS1",31,34,65,0.523076923076923,0.476923076923077,0.77
"9406","MARS2",20,31,51,0.607843137254902,0.392156862745098,0.77
"9407","MARVELD2",26,37,63,0.587301587301587,0.412698412698413,0.77
"9408","MARVELD3",21,20,41,0.48780487804878,0.51219512195122,0.77
"9409","MAS1",17,19,36,0.527777777777778,0.472222222222222,1
"9410","MAS1L",14,35,49,0.714285714285714,0.285714285714286,1
"9411","MASP1",35,66,101,0.653465346534653,0.346534653465347,1
"9412","MASP2",19,41,60,0.683333333333333,0.316666666666667,1
"9413","MAST1",58,83,141,0.588652482269504,0.411347517730496,1
"9414","MAST2",42,87,129,0.674418604651163,0.325581395348837,1
"9415","MAST3",41,64,105,0.60952380952381,0.39047619047619,1
"9416","MAST4",85,124,209,0.593301435406699,0.406698564593301,1
"9417","MASTL",26,46,72,0.638888888888889,0.361111111111111,1
"9418","MAT1A",24,37,61,0.60655737704918,0.39344262295082,1
"9419","MAT2A",10,11,21,0.523809523809524,0.476190476190476,1
"9420","MAT2B",12,10,22,0.454545454545455,0.545454545454545,1
"9421","MATK",24,60,84,0.714285714285714,0.285714285714286,1
"9422","MATN1",15,20,35,0.571428571428571,0.428571428571429,1
"9423","MATN2",30,57,87,0.655172413793103,0.344827586206897,1
"9424","MATN3",18,25,43,0.581395348837209,0.418604651162791,1
"9425","MATN4",32,66,98,0.673469387755102,0.326530612244898,1
"9426","MATR3",29,42,71,0.591549295774648,0.408450704225352,1
"9427","MAU2",20,28,48,0.583333333333333,0.416666666666667,1
"9428","MAVS",14,30,44,0.681818181818182,0.318181818181818,1
"9429","MAX",18,17,35,0.485714285714286,0.514285714285714,1
"9430","MAZ",17,20,37,0.540540540540541,0.459459459459459,1
"9431","MB",2,10,12,0.833333333333333,0.166666666666667,1
"9432","MB21D2",33,49,82,0.597560975609756,0.402439024390244,1
"9433","MBD1",29,61,90,0.677777777777778,0.322222222222222,1
"9434","MBD2",18,9,27,0.333333333333333,0.666666666666667,1
"9435","MBD3",11,16,27,0.592592592592593,0.407407407407407,1
"9436","MBD3L1",11,23,34,0.676470588235294,0.323529411764706,1
"9437","MBD3L2",2,1,3,0.333333333333333,0.666666666666667,1
"9438","MBD4",17,28,45,0.622222222222222,0.377777777777778,1
"9439","MBD5",53,145,198,0.732323232323232,0.267676767676768,1
"9440","MBD6",73,86,159,0.540880503144654,0.459119496855346,1
"9441","MBIP",13,17,30,0.566666666666667,0.433333333333333,1
"9442","MBL2",22,44,66,0.666666666666667,0.333333333333333,1
"9443","MBLAC1",2,9,11,0.818181818181818,0.181818181818182,1
"9444","MBLAC2",6,7,13,0.538461538461538,0.461538461538462,1
"9445","MBNL1",15,23,38,0.605263157894737,0.394736842105263,1
"9446","MBNL2",20,16,36,0.444444444444444,0.555555555555556,1
"9447","MBNL3",17,8,25,0.32,0.68,1
"9448","MBOAT1",26,28,54,0.518518518518518,0.481481481481481,1
"9449","MBOAT2",26,22,48,0.458333333333333,0.541666666666667,1
"9450","MBOAT4",0,1,1,1,0,1
"9451","MBOAT7",13,19,32,0.59375,0.40625,1
"9452","MBP",15,20,35,0.571428571428571,0.428571428571429,1
"9453","MBTD1",8,19,27,0.703703703703704,0.296296296296296,1
"9454","MBTPS1",43,54,97,0.556701030927835,0.443298969072165,1
"9455","MBTPS2",21,13,34,0.382352941176471,0.617647058823529,1
"9456","MC1R",14,11,25,0.44,0.56,1
"9457","MC2R",20,30,50,0.6,0.4,1
"9458","MC3R",28,46,74,0.621621621621622,0.378378378378378,1
"9459","MC4R",18,27,45,0.6,0.4,1
"9460","MC5R",40,38,78,0.487179487179487,0.512820512820513,1
"9461","MCAM",19,36,55,0.654545454545455,0.345454545454545,1
"9462","MCAT",8,13,21,0.619047619047619,0.380952380952381,1
"9463","MCC",50,69,119,0.579831932773109,0.420168067226891,1
"9464","MCCC1",33,38,71,0.535211267605634,0.464788732394366,1
"9465","MCCC2",21,32,53,0.60377358490566,0.39622641509434,1
"9466","MCCD1",4,4,8,0.5,0.5,1
"9467","MCEE",16,14,30,0.466666666666667,0.533333333333333,1
"9468","MCEMP1",2,14,16,0.875,0.125,1
"9469","MCF2",93,80,173,0.46242774566474,0.53757225433526,1
"9470","MCF2L",32,59,91,0.648351648351648,0.351648351648352,1
"9471","MCF2L2",51,114,165,0.690909090909091,0.309090909090909,1
"9472","MCFD2",6,7,13,0.538461538461538,0.461538461538462,1
"9473","MCHR1",27,27,54,0.5,0.5,1
"9474","MCHR2",47,86,133,0.646616541353383,0.353383458646617,1
"9475","MCL1",5,15,20,0.75,0.25,1
"9476","MCM10",30,63,93,0.67741935483871,0.32258064516129,1
"9477","MCM2",19,50,69,0.72463768115942,0.27536231884058,1
"9478","MCM3",19,43,62,0.693548387096774,0.306451612903226,1
"9479","MCM3AP",51,103,154,0.668831168831169,0.331168831168831,1
"9480","MCM4",42,66,108,0.611111111111111,0.388888888888889,1
"9481","MCM5",23,30,53,0.566037735849057,0.433962264150943,1
"9482","MCM6",28,58,86,0.674418604651163,0.325581395348837,1
"9483","MCM7",33,40,73,0.547945205479452,0.452054794520548,1
"9484","MCM8",25,40,65,0.615384615384615,0.384615384615385,1
"9485","MCM9",14,20,34,0.588235294117647,0.411764705882353,1
"9486","MCMBP",18,28,46,0.608695652173913,0.391304347826087,1
"9487","MCMDC2",25,41,66,0.621212121212121,0.378787878787879,1
"9488","MCOLN1",28,28,56,0.5,0.5,1
"9489","MCOLN2",32,35,67,0.522388059701492,0.477611940298507,1
"9490","MCOLN3",26,45,71,0.633802816901408,0.366197183098592,1
"9491","MCPH1",36,68,104,0.653846153846154,0.346153846153846,1
"9492","MCRIP2",1,4,5,0.8,0.2,1
"9493","MCRS1",21,27,48,0.5625,0.4375,1
"9494","MCTP1",46,103,149,0.691275167785235,0.308724832214765,1
"9495","MCTP2",51,100,151,0.662251655629139,0.337748344370861,1
"9496","MCTS1",20,6,26,0.230769230769231,0.769230769230769,1
"9497","MCU",10,18,28,0.642857142857143,0.357142857142857,1
"9498","MCUB",8,15,23,0.652173913043478,0.347826086956522,1
"9499","MCUR1",8,16,24,0.666666666666667,0.333333333333333,1
"9500","MDC1",75,117,192,0.609375,0.390625,1
"9501","MDFI",8,10,18,0.555555555555556,0.444444444444444,1
"9502","MDFIC",11,18,29,0.620689655172414,0.379310344827586,1
"9503","MDGA1",45,51,96,0.53125,0.46875,1
"9504","MDGA2",88,135,223,0.605381165919282,0.394618834080717,1
"9505","MDH1",9,18,27,0.666666666666667,0.333333333333333,1
"9506","MDH1B",20,45,65,0.692307692307692,0.307692307692308,1
"9507","MDH2",8,7,15,0.466666666666667,0.533333333333333,1
"9508","MDK",5,5,10,0.5,0.5,1
"9509","MDM1",33,42,75,0.56,0.44,1
"9510","MDM2",28,24,52,0.461538461538462,0.538461538461538,1
"9511","MDM4",13,17,30,0.566666666666667,0.433333333333333,1
"9512","MDN1",186,289,475,0.608421052631579,0.391578947368421,1
"9513","MDP1",5,11,16,0.6875,0.3125,1
"9514","MDS2",8,12,20,0.6,0.4,1
"9515","ME1",29,58,87,0.666666666666667,0.333333333333333,1
"9516","ME2",17,33,50,0.66,0.34,1
"9517","ME3",23,41,64,0.640625,0.359375,1
"9518","MEA1",4,6,10,0.6,0.4,1
"9519","MEAF6",10,5,15,0.333333333333333,0.666666666666667,1
"9520","MEAK7",17,20,37,0.540540540540541,0.459459459459459,0.58
"9521","MECOM",92,189,281,0.672597864768683,0.327402135231317,1
"9522","MECP2",34,17,51,0.333333333333333,0.666666666666667,1
"9523","MECR",11,22,33,0.666666666666667,0.333333333333333,1
"9524","MED1",52,79,131,0.603053435114504,0.396946564885496,1
"9525","MED10",4,10,14,0.714285714285714,0.285714285714286,1
"9526","MED11",4,3,7,0.428571428571429,0.571428571428571,1
"9527","MED12",149,85,234,0.363247863247863,0.636752136752137,1
"9528","MED12L",117,176,293,0.600682593856655,0.399317406143345,1
"9529","MED13",72,140,212,0.660377358490566,0.339622641509434,1
"9530","MED13L",74,94,168,0.55952380952381,0.44047619047619,1
"9531","MED14",44,37,81,0.45679012345679,0.54320987654321,1
"9532","MED15",28,35,63,0.555555555555556,0.444444444444444,1
"9533","MED16",26,46,72,0.638888888888889,0.361111111111111,1
"9534","MED17",16,29,45,0.644444444444444,0.355555555555556,1
"9535","MED18",5,14,19,0.736842105263158,0.263157894736842,1
"9536","MED19",2,2,4,0.5,0.5,1
"9537","MED20",3,6,9,0.666666666666667,0.333333333333333,1
"9538","MED21",7,9,16,0.5625,0.4375,1
"9539","MED22",6,6,12,0.5,0.5,1
"9540","MED23",47,81,128,0.6328125,0.3671875,1
"9541","MED24",19,49,68,0.720588235294118,0.279411764705882,1
"9542","MED25",28,44,72,0.611111111111111,0.388888888888889,1
"9543","MED26",24,24,48,0.5,0.5,1
"9544","MED27",6,15,21,0.714285714285714,0.285714285714286,1
"9545","MED28",3,13,16,0.8125,0.1875,1
"9546","MED29",7,8,15,0.533333333333333,0.466666666666667,1
"9547","MED30",6,8,14,0.571428571428571,0.428571428571429,1
"9548","MED31",6,8,14,0.571428571428571,0.428571428571429,1
"9549","MED4",9,13,22,0.590909090909091,0.409090909090909,1
"9550","MED6",9,13,22,0.590909090909091,0.409090909090909,1
"9551","MED7",10,12,22,0.545454545454545,0.454545454545455,1
"9552","MED8",8,7,15,0.466666666666667,0.533333333333333,1
"9553","MED9",3,7,10,0.7,0.3,1
"9554","MEDAG",11,18,29,0.620689655172414,0.379310344827586,1
"9555","MEF2A",12,28,40,0.7,0.3,1
"9556","MEF2B",9,22,31,0.709677419354839,0.290322580645161,1
"9557","MEF2C",30,41,71,0.577464788732394,0.422535211267606,1
"9558","MEF2D",15,28,43,0.651162790697674,0.348837209302326,1
"9559","MEFV",49,88,137,0.642335766423358,0.357664233576642,1
"9560","MEGF10",70,85,155,0.548387096774194,0.451612903225806,1
"9561","MEGF11",13,44,57,0.771929824561403,0.228070175438596,1
"9562","MEGF6",39,62,101,0.613861386138614,0.386138613861386,1
"9563","MEGF8",117,139,256,0.54296875,0.45703125,1
"9564","MEGF9",16,22,38,0.578947368421053,0.421052631578947,1
"9565","MEI1",44,79,123,0.642276422764228,0.357723577235772,1
"9566","MEIG1",1,6,7,0.857142857142857,0.142857142857143,1
"9567","MEIOB",4,15,19,0.789473684210526,0.210526315789474,1
"9568","MEIOC",15,48,63,0.761904761904762,0.238095238095238,1
"9569","MEIS1",17,54,71,0.76056338028169,0.23943661971831,1
"9570","MEIS2",33,47,80,0.5875,0.4125,1
"9571","MEIS3",19,27,46,0.58695652173913,0.41304347826087,1
"9572","MELK",16,30,46,0.652173913043478,0.347826086956522,1
"9573","MELTF",27,29,56,0.517857142857143,0.482142857142857,1
"9574","MEMO1",11,26,37,0.702702702702703,0.297297297297297,1
"9575","MEN1",31,31,62,0.5,0.5,1
"9576","MEOX1",20,9,29,0.310344827586207,0.689655172413793,1
"9577","MEOX2",22,33,55,0.6,0.4,1
"9578","MEP1A",37,78,115,0.678260869565217,0.321739130434783,1
"9579","MEP1B",17,52,69,0.753623188405797,0.246376811594203,1
"9580","MEPCE",28,28,56,0.5,0.5,1
"9581","MEPE",35,52,87,0.597701149425287,0.402298850574713,1
"9582","MERTK",55,81,136,0.595588235294118,0.404411764705882,1
"9583","MESD",14,17,31,0.548387096774194,0.451612903225806,1
"9584","MESP1",4,2,6,0.333333333333333,0.666666666666667,1
"9585","MESP2",5,14,19,0.736842105263158,0.263157894736842,1
"9586","MEST",14,23,37,0.621621621621622,0.378378378378378,1
"9587","MET",80,98,178,0.550561797752809,0.449438202247191,1
"9588","METAP1",11,11,22,0.5,0.5,1
"9589","METAP1D",10,21,31,0.67741935483871,0.32258064516129,1
"9590","METAP2",11,26,37,0.702702702702703,0.297297297297297,1
"9591","METRN",1,1,2,0.5,0.5,1
"9592","METRNL",5,13,18,0.722222222222222,0.277777777777778,1
"9593","METTL1",6,22,28,0.785714285714286,0.214285714285714,1
"9594","METTL11B",0,1,1,1,0,1
"9595","METTL14",19,27,46,0.58695652173913,0.41304347826087,1
"9596","METTL15",11,17,28,0.607142857142857,0.392857142857143,1
"9597","METTL16",21,38,59,0.644067796610169,0.355932203389831,1
"9598","METTL17",23,28,51,0.549019607843137,0.450980392156863,1
"9599","METTL18",13,15,28,0.535714285714286,0.464285714285714,1
"9600","METTL21A",6,15,21,0.714285714285714,0.285714285714286,1
"9601","METTL21C",17,28,45,0.622222222222222,0.377777777777778,1
"9602","METTL22",14,35,49,0.714285714285714,0.285714285714286,1
"9603","METTL23",5,9,14,0.642857142857143,0.357142857142857,1
"9604","METTL24",10,25,35,0.714285714285714,0.285714285714286,1
"9605","METTL25",19,41,60,0.683333333333333,0.316666666666667,1
"9606","METTL26",2,5,7,0.714285714285714,0.285714285714286,1
"9607","METTL27",8,13,21,0.619047619047619,0.380952380952381,1
"9608","METTL2A",6,15,21,0.714285714285714,0.285714285714286,1
"9609","METTL2B",14,20,34,0.588235294117647,0.411764705882353,1
"9610","METTL3",23,31,54,0.574074074074074,0.425925925925926,1
"9611","METTL4",9,36,45,0.8,0.2,1
"9612","METTL5",1,9,10,0.9,0.1,1
"9613","METTL6",22,17,39,0.435897435897436,0.564102564102564,1
"9614","METTL7A",8,16,24,0.666666666666667,0.333333333333333,1
"9615","METTL7B",11,19,30,0.633333333333333,0.366666666666667,1
"9616","METTL8",9,19,28,0.678571428571429,0.321428571428571,1
"9617","METTL9",7,14,21,0.666666666666667,0.333333333333333,1
"9618","MEX3A",17,24,41,0.585365853658537,0.414634146341463,1
"9619","MEX3B",22,43,65,0.661538461538462,0.338461538461538,1
"9620","MEX3C",12,30,42,0.714285714285714,0.285714285714286,1
"9621","MEX3D",10,15,25,0.6,0.4,1
"9622","MFAP1",19,21,40,0.525,0.475,1
"9623","MFAP2",5,7,12,0.583333333333333,0.416666666666667,1
"9624","MFAP3",2,22,24,0.916666666666667,0.0833333333333333,1
"9625","MFAP3L",14,27,41,0.658536585365854,0.341463414634146,1
"9626","MFAP4",8,9,17,0.529411764705882,0.470588235294118,1
"9627","MFAP5",19,22,41,0.536585365853659,0.463414634146341,1
"9628","MFF",14,24,38,0.631578947368421,0.368421052631579,1
"9629","MFGE8",11,31,42,0.738095238095238,0.261904761904762,1
"9630","MFHAS1",30,41,71,0.577464788732394,0.422535211267606,1
"9631","MFN1",29,50,79,0.632911392405063,0.367088607594937,1
"9632","MFN2",20,32,52,0.615384615384615,0.384615384615385,1
"9633","MFNG",7,14,21,0.666666666666667,0.333333333333333,1
"9634","MFRP",10,18,28,0.642857142857143,0.357142857142857,1
"9635","MFSD1",18,37,55,0.672727272727273,0.327272727272727,1
"9636","MFSD10",7,15,22,0.681818181818182,0.318181818181818,1
"9637","MFSD11",16,26,42,0.619047619047619,0.380952380952381,1
"9638","MFSD12",11,25,36,0.694444444444444,0.305555555555556,1
"9639","MFSD13A",9,18,27,0.666666666666667,0.333333333333333,1
"9640","MFSD14A",17,29,46,0.630434782608696,0.369565217391304,1
"9641","MFSD14B",9,22,31,0.709677419354839,0.290322580645161,1
"9642","MFSD2A",20,29,49,0.591836734693878,0.408163265306122,1
"9643","MFSD2B",15,27,42,0.642857142857143,0.357142857142857,1
"9644","MFSD3",5,12,17,0.705882352941177,0.294117647058824,1
"9645","MFSD4A",12,21,33,0.636363636363636,0.363636363636364,1
"9646","MFSD4B",2,1,3,0.333333333333333,0.666666666666667,1
"9647","MFSD5",13,19,32,0.59375,0.40625,1
"9648","MFSD6",26,37,63,0.587301587301587,0.412698412698413,1
"9649","MFSD6L",22,30,52,0.576923076923077,0.423076923076923,1
"9650","MFSD8",20,39,59,0.661016949152542,0.338983050847458,1
"9651","MFSD9",26,43,69,0.623188405797101,0.376811594202899,1
"9652","MGA",137,174,311,0.559485530546624,0.440514469453376,1
"9653","MGAM",161,327,488,0.670081967213115,0.329918032786885,1
"9654","MGARP",4,15,19,0.789473684210526,0.210526315789474,0.77
"9655","MGAT1",19,31,50,0.62,0.38,1
"9656","MGAT2",19,15,34,0.441176470588235,0.558823529411765,1
"9657","MGAT3",34,46,80,0.575,0.425,1
"9658","MGAT4A",12,31,43,0.720930232558139,0.27906976744186,1
"9659","MGAT4B",11,23,34,0.676470588235294,0.323529411764706,1
"9660","MGAT4C",56,92,148,0.621621621621622,0.378378378378378,1
"9661","MGAT5",34,47,81,0.580246913580247,0.419753086419753,1
"9662","MGAT5B",43,60,103,0.58252427184466,0.41747572815534,1
"9663","MGLL",11,27,38,0.710526315789474,0.289473684210526,1
"9664","MGME1",11,12,23,0.521739130434783,0.478260869565217,1
"9665","MGMT",10,21,31,0.67741935483871,0.32258064516129,1
"9666","MGP",6,6,12,0.5,0.5,1
"9667","MGRN1",23,33,56,0.589285714285714,0.410714285714286,1
"9668","MGST1",11,17,28,0.607142857142857,0.392857142857143,1
"9669","MGST2",8,5,13,0.384615384615385,0.615384615384615,1
"9670","MGST3",5,6,11,0.545454545454545,0.454545454545455,1
"9671","MIA",8,7,15,0.466666666666667,0.533333333333333,1
"9672","MIA2",71,120,191,0.628272251308901,0.371727748691099,1
"9673","MIA3",71,110,181,0.607734806629834,0.392265193370166,1
"9674","MIB1",34,54,88,0.613636363636364,0.386363636363636,1
"9675","MIB2",22,37,59,0.627118644067797,0.372881355932203,1
"9676","MICA",1,1,2,0.5,0.5,1
"9677","MICAL1",25,49,74,0.662162162162162,0.337837837837838,1
"9678","MICAL2",74,102,176,0.579545454545455,0.420454545454545,1
"9679","MICAL3",63,99,162,0.611111111111111,0.388888888888889,1
"9680","MICALL1",24,43,67,0.641791044776119,0.358208955223881,1
"9681","MICALL2",33,44,77,0.571428571428571,0.428571428571429,1
"9682","MICB",20,16,36,0.444444444444444,0.555555555555556,1
"9683","MICOS10",2,2,4,0.5,0.5,1
"9684","MICOS13",7,8,15,0.533333333333333,0.466666666666667,1
"9685","MICU1",14,17,31,0.548387096774194,0.451612903225806,1
"9686","MICU2",17,26,43,0.604651162790698,0.395348837209302,1
"9687","MICU3",18,36,54,0.666666666666667,0.333333333333333,1
"9688","MID1",33,19,52,0.365384615384615,0.634615384615385,1
"9689","MID1IP1",18,6,24,0.25,0.75,1
"9690","MID2",33,31,64,0.484375,0.515625,1
"9691","MIDEAS",56,65,121,0.537190082644628,0.462809917355372,1
"9692","MIDN",24,22,46,0.478260869565217,0.521739130434783,1
"9693","MIEF1",12,25,37,0.675675675675676,0.324324324324324,1
"9694","MIEF2",14,14,28,0.5,0.5,1
"9695","MIEN1",5,9,14,0.642857142857143,0.357142857142857,1
"9696","MIER1",14,31,45,0.688888888888889,0.311111111111111,1
"9697","MIER2",20,25,45,0.555555555555556,0.444444444444444,1
"9698","MIER3",32,25,57,0.43859649122807,0.56140350877193,1
"9699","MIF",1,1,2,0.5,0.5,1
"9700","MIF4GD",7,9,16,0.5625,0.4375,1
"9701","MIGA1",22,45,67,0.671641791044776,0.328358208955224,1
"9702","MIGA2",14,26,40,0.65,0.35,1
"9703","MIIP",13,20,33,0.606060606060606,0.393939393939394,1
"9704","MILR1",2,6,8,0.75,0.25,1
"9705","MINAR1",75,96,171,0.56140350877193,0.43859649122807,0.77
"9706","MINDY1",16,20,36,0.555555555555556,0.444444444444444,1
"9707","MINDY2",18,17,35,0.485714285714286,0.514285714285714,1
"9708","MINDY3",18,30,48,0.625,0.375,1
"9709","MINDY4",38,49,87,0.563218390804598,0.436781609195402,1
"9710","MINK1",32,43,75,0.573333333333333,0.426666666666667,1
"9711","MINPP1",14,23,37,0.621621621621622,0.378378378378378,1
"9712","MIOS",33,51,84,0.607142857142857,0.392857142857143,1
"9713","MIOX",8,25,33,0.757575757575758,0.242424242424242,1
"9714","MIP",17,31,48,0.645833333333333,0.354166666666667,1
"9715","MIPEP",27,30,57,0.526315789473684,0.473684210526316,1
"9716","MIPOL1",19,27,46,0.58695652173913,0.41304347826087,1
"9717","MIR1-1",3,3,6,0.5,0.5,1
"9718","MIR1-1HG-AS1",21,31,52,0.596153846153846,0.403846153846154,1
"9719","MIR100",2,2,4,0.5,0.5,1
"9720","MIR106A",1,0,1,0,1,1
"9721","MIR1179",3,2,5,0.4,0.6,1
"9722","MIR1185-1",0,4,4,1,0,1
"9723","MIR1185-2",3,4,7,0.571428571428571,0.428571428571429,1
"9724","MIR1197",3,7,10,0.7,0.3,1
"9725","MIR1202",1,1,2,0.5,0.5,1
"9726","MIR1204",0,1,1,1,0,1
"9727","MIR1205",0,3,3,1,0,1
"9728","MIR1206",1,4,5,0.8,0.2,1
"9729","MIR1207",3,1,4,0.25,0.75,1
"9730","MIR1208",6,3,9,0.333333333333333,0.666666666666667,1
"9731","MIR122",1,3,4,0.75,0.25,1
"9732","MIR124-1",3,3,6,0.5,0.5,1
"9733","MIR124-2",9,9,18,0.5,0.5,1
"9734","MIR124-3",2,2,4,0.5,0.5,1
"9735","MIR1244-3",2,4,6,0.666666666666667,0.333333333333333,1
"9736","MIR1246",2,7,9,0.777777777777778,0.222222222222222,1
"9737","MIR1251",4,4,8,0.5,0.5,1
"9738","MIR1253",1,2,3,0.666666666666667,0.333333333333333,1
"9739","MIR1257",1,0,1,0,1,1
"9740","MIR125B1",4,3,7,0.428571428571429,0.571428571428571,1
"9741","MIR125B2",0,8,8,1,0,1
"9742","MIR1261",3,5,8,0.625,0.375,1
"9743","MIR1265",0,2,2,1,0,1
"9744","MIR1269A",4,11,15,0.733333333333333,0.266666666666667,1
"9745","MIR1270",1,1,2,0.5,0.5,1
"9746","MIR1275",1,4,5,0.8,0.2,1
"9747","MIR1283-1",4,6,10,0.6,0.4,1
"9748","MIR1283-2",8,4,12,0.333333333333333,0.666666666666667,1
"9749","MIR129-1",3,3,6,0.5,0.5,1
"9750","MIR129-2",2,2,4,0.5,0.5,1
"9751","MIR1297",5,4,9,0.444444444444444,0.555555555555556,1
"9752","MIR1302-3",1,6,7,0.857142857142857,0.142857142857143,1
"9753","MIR1302-4",0,2,2,1,0,1
"9754","MIR1302-7",4,1,5,0.2,0.8,1
"9755","MIR1303",15,8,23,0.347826086956522,0.652173913043478,1
"9756","MIR130B",1,1,2,0.5,0.5,1
"9757","MIR1323",4,4,8,0.5,0.5,1
"9758","MIR1324",2,5,7,0.714285714285714,0.285714285714286,1
"9759","MIR133A2",3,4,7,0.571428571428571,0.428571428571429,1
"9760","MIR133B",6,2,8,0.25,0.75,1
"9761","MIR134",3,6,9,0.666666666666667,0.333333333333333,1
"9762","MIR135A2",4,8,12,0.666666666666667,0.333333333333333,1
"9763","MIR138-2",2,0,2,0,1,1
"9764","MIR143",2,3,5,0.6,0.4,1
"9765","MIR145",2,2,4,0.5,0.5,1
"9766","MIR146A",2,1,3,0.333333333333333,0.666666666666667,1
"9767","MIR147A",3,6,9,0.666666666666667,0.333333333333333,1
"9768","MIR148A",1,0,1,0,1,1
"9769","MIR154",5,7,12,0.583333333333333,0.416666666666667,1
"9770","MIR155",0,1,1,1,0,1
"9771","MIR15A",1,4,5,0.8,0.2,1
"9772","MIR16-1",3,4,7,0.571428571428571,0.428571428571429,1
"9773","MIR17",1,5,6,0.833333333333333,0.166666666666667,1
"9774","MIR181A1",3,5,8,0.625,0.375,1
"9775","MIR181B1",3,5,8,0.625,0.375,1
"9776","MIR182",2,3,5,0.6,0.4,1
"9777","MIR1827",1,0,1,0,1,1
"9778","MIR183",2,0,2,0,1,1
"9779","MIR184",0,1,1,1,0,1
"9780","MIR187",2,1,3,0.333333333333333,0.666666666666667,1
"9781","MIR18A",1,3,4,0.75,0.25,1
"9782","MIR18B",0,2,2,1,0,1
"9783","MIR193A",0,1,1,1,0,1
"9784","MIR193B",1,4,5,0.8,0.2,1
"9785","MIR196A1",4,0,4,0,1,1
"9786","MIR19B1",2,2,4,0.5,0.5,1
"9787","MIR19B2",0,2,2,1,0,1
"9788","MIR200A",1,4,5,0.8,0.2,1
"9789","MIR200B",1,0,1,0,1,1
"9790","MIR202",1,3,4,0.75,0.25,1
"9791","MIR205",3,10,13,0.769230769230769,0.230769230769231,1
"9792","MIR206",3,7,10,0.7,0.3,1
"9793","MIR20A",2,7,9,0.777777777777778,0.222222222222222,1
"9794","MIR20B",2,0,2,0,1,1
"9795","MIR216A",4,7,11,0.636363636363636,0.363636363636364,1
"9796","MIR216B",1,1,2,0.5,0.5,1
"9797","MIR217",0,2,2,1,0,1
"9798","MIR221",2,2,4,0.5,0.5,1
"9799","MIR222",4,1,5,0.2,0.8,1
"9800","MIR296",5,7,12,0.583333333333333,0.416666666666667,1
"9801","MIR297",0,4,4,1,0,1
"9802","MIR298",1,2,3,0.666666666666667,0.333333333333333,1
"9803","MIR299",3,5,8,0.625,0.375,1
"9804","MIR29A",1,1,2,0.5,0.5,1
"9805","MIR29B1",3,2,5,0.4,0.6,1
"9806","MIR29B2",7,2,9,0.222222222222222,0.777777777777778,1
"9807","MIR29C",2,1,3,0.333333333333333,0.666666666666667,1
"9808","MIR300",1,4,5,0.8,0.2,1
"9809","MIR301B",0,1,1,1,0,1
"9810","MIR302F",0,5,5,1,0,1
"9811","MIR30A",2,5,7,0.714285714285714,0.285714285714286,1
"9812","MIR30B",1,2,3,0.666666666666667,0.333333333333333,1
"9813","MIR30C2",2,4,6,0.666666666666667,0.333333333333333,1
"9814","MIR30D",1,4,5,0.8,0.2,1
"9815","MIR31",2,2,4,0.5,0.5,1
"9816","MIR320D2",1,2,3,0.666666666666667,0.333333333333333,1
"9817","MIR323A",6,10,16,0.625,0.375,1
"9818","MIR323B",4,0,4,0,1,1
"9819","MIR325",7,5,12,0.416666666666667,0.583333333333333,1
"9820","MIR329-1",0,11,11,1,0,1
"9821","MIR329-2",3,10,13,0.769230769230769,0.230769230769231,1
"9822","MIR331",0,1,1,1,0,1
"9823","MIR337",0,4,4,1,0,1
"9824","MIR34A",3,1,4,0.25,0.75,1
"9825","MIR363",1,5,6,0.833333333333333,0.166666666666667,1
"9826","MIR365A",3,1,4,0.25,0.75,1
"9827","MIR365B",2,1,3,0.333333333333333,0.666666666666667,1
"9828","MIR369",5,5,10,0.5,0.5,1
"9829","MIR370",0,1,1,1,0,1
"9830","MIR371A",2,4,6,0.666666666666667,0.333333333333333,1
"9831","MIR372",7,2,9,0.222222222222222,0.777777777777778,1
"9832","MIR373",0,2,2,1,0,1
"9833","MIR374B",0,1,1,1,0,1
"9834","MIR376A1",4,1,5,0.2,0.8,1
"9835","MIR376A2",4,11,15,0.733333333333333,0.266666666666667,1
"9836","MIR376B",2,6,8,0.75,0.25,1
"9837","MIR376C",1,2,3,0.666666666666667,0.333333333333333,1
"9838","MIR377",3,4,7,0.571428571428571,0.428571428571429,1
"9839","MIR379",3,11,14,0.785714285714286,0.214285714285714,1
"9840","MIR380",4,2,6,0.333333333333333,0.666666666666667,1
"9841","MIR381",2,5,7,0.714285714285714,0.285714285714286,1
"9842","MIR382",4,10,14,0.714285714285714,0.285714285714286,1
"9843","MIR384",0,1,1,1,0,1
"9844","MIR409",3,14,17,0.823529411764706,0.176470588235294,1
"9845","MIR410",3,4,7,0.571428571428571,0.428571428571429,1
"9846","MIR411",4,5,9,0.555555555555556,0.444444444444444,1
"9847","MIR412",4,8,12,0.666666666666667,0.333333333333333,1
"9848","MIR421",0,1,1,1,0,1
"9849","MIR422A",3,2,5,0.4,0.6,1
"9850","MIR424",4,0,4,0,1,1
"9851","MIR450A1",2,2,4,0.5,0.5,1
"9852","MIR450A2",2,1,3,0.333333333333333,0.666666666666667,1
"9853","MIR450B",1,0,1,0,1,1
"9854","MIR485",0,8,8,1,0,1
"9855","MIR487A",2,5,7,0.714285714285714,0.285714285714286,1
"9856","MIR487B",8,8,16,0.5,0.5,1
"9857","MIR492",4,1,5,0.2,0.8,1
"9858","MIR493",4,3,7,0.428571428571429,0.571428571428571,1
"9859","MIR494",2,5,7,0.714285714285714,0.285714285714286,1
"9860","MIR495",2,6,8,0.75,0.25,1
"9861","MIR496",3,9,12,0.75,0.25,1
"9862","MIR498",4,10,14,0.714285714285714,0.285714285714286,1
"9863","MIR503",2,0,2,0,1,1
"9864","MIR505",0,1,1,1,0,1
"9865","MIR506",8,4,12,0.333333333333333,0.666666666666667,1
"9866","MIR507",3,0,3,0,1,1
"9867","MIR508",7,4,11,0.363636363636364,0.636363636363636,1
"9868","MIR509-1",4,1,5,0.2,0.8,1
"9869","MIR509-2",8,2,10,0.2,0.8,1
"9870","MIR509-3",8,3,11,0.272727272727273,0.727272727272727,1
"9871","MIR510",2,7,9,0.777777777777778,0.222222222222222,1
"9872","MIR512-1",3,4,7,0.571428571428571,0.428571428571429,1
"9873","MIR512-2",3,3,6,0.5,0.5,1
"9874","MIR513A1",2,6,8,0.75,0.25,1
"9875","MIR513A2",1,5,6,0.833333333333333,0.166666666666667,1
"9876","MIR513B",5,1,6,0.166666666666667,0.833333333333333,1
"9877","MIR513C",2,1,3,0.333333333333333,0.666666666666667,1
"9878","MIR514A1",0,4,4,1,0,1
"9879","MIR514A2",0,4,4,1,0,1
"9880","MIR514A3",2,4,6,0.666666666666667,0.333333333333333,1
"9881","MIR515-1",3,4,7,0.571428571428571,0.428571428571429,1
"9882","MIR515-2",2,3,5,0.6,0.4,1
"9883","MIR516A1",4,1,5,0.2,0.8,1
"9884","MIR516A2",7,1,8,0.125,0.875,1
"9885","MIR516B1",8,3,11,0.272727272727273,0.727272727272727,1
"9886","MIR516B2",2,2,4,0.5,0.5,1
"9887","MIR517A",7,10,17,0.588235294117647,0.411764705882353,1
"9888","MIR517B",2,8,10,0.8,0.2,1
"9889","MIR517C",8,4,12,0.333333333333333,0.666666666666667,1
"9890","MIR518A1",4,4,8,0.5,0.5,1
"9891","MIR518A2",4,5,9,0.555555555555556,0.444444444444444,1
"9892","MIR518B",1,10,11,0.909090909090909,0.0909090909090909,1
"9893","MIR518C",3,8,11,0.727272727272727,0.272727272727273,1
"9894","MIR518D",7,8,15,0.533333333333333,0.466666666666667,1
"9895","MIR518E",3,8,11,0.727272727272727,0.272727272727273,1
"9896","MIR518F",3,5,8,0.625,0.375,1
"9897","MIR519A1",2,15,17,0.882352941176471,0.117647058823529,1
"9898","MIR519A2",3,2,5,0.4,0.6,1
"9899","MIR519B",5,5,10,0.5,0.5,1
"9900","MIR519C",4,5,9,0.555555555555556,0.444444444444444,1
"9901","MIR519D",5,4,9,0.444444444444444,0.555555555555556,1
"9902","MIR519E",3,5,8,0.625,0.375,1
"9903","MIR520A",5,11,16,0.6875,0.3125,1
"9904","MIR520B",5,6,11,0.545454545454545,0.454545454545455,1
"9905","MIR520C",1,4,5,0.8,0.2,1
"9906","MIR520D",2,3,5,0.6,0.4,1
"9907","MIR520E",2,2,4,0.5,0.5,1
"9908","MIR520F",2,3,5,0.6,0.4,1
"9909","MIR520G",3,9,12,0.75,0.25,1
"9910","MIR520H",3,7,10,0.7,0.3,1
"9911","MIR521-1",4,5,9,0.555555555555556,0.444444444444444,1
"9912","MIR521-2",2,6,8,0.75,0.25,1
"9913","MIR522",6,10,16,0.625,0.375,1
"9914","MIR523",3,5,8,0.625,0.375,1
"9915","MIR524",1,12,13,0.923076923076923,0.0769230769230769,1
"9916","MIR525",9,7,16,0.4375,0.5625,1
"9917","MIR526A1",3,3,6,0.5,0.5,1
"9918","MIR526A2",0,3,3,1,0,1
"9919","MIR526B",7,4,11,0.363636363636364,0.636363636363636,1
"9920","MIR527",7,11,18,0.611111111111111,0.388888888888889,1
"9921","MIR539",1,3,4,0.75,0.25,1
"9922","MIR541",3,5,8,0.625,0.375,1
"9923","MIR542",6,1,7,0.142857142857143,0.857142857142857,1
"9924","MIR543",11,13,24,0.541666666666667,0.458333333333333,1
"9925","MIR544A",2,7,9,0.777777777777778,0.222222222222222,1
"9926","MIR545",5,2,7,0.285714285714286,0.714285714285714,1
"9927","MIR548A1",1,4,5,0.8,0.2,1
"9928","MIR548A2",3,0,3,0,1,1
"9929","MIR548H4",0,4,4,1,0,1
"9930","MIR548I1",3,1,4,0.25,0.75,1
"9931","MIR548I2",6,12,18,0.666666666666667,0.333333333333333,1
"9932","MIR548I3",0,1,1,1,0,1
"9933","MIR548I4",1,0,1,0,1,1
"9934","MIR548M",2,1,3,0.333333333333333,0.666666666666667,1
"9935","MIR550A2",1,1,2,0.5,0.5,1
"9936","MIR551B",7,8,15,0.533333333333333,0.466666666666667,1
"9937","MIR552",0,1,1,1,0,1
"9938","MIR557",3,4,7,0.571428571428571,0.428571428571429,1
"9939","MIR563",0,2,2,1,0,1
"9940","MIR570",0,1,1,1,0,1
"9941","MIR573",3,4,7,0.571428571428571,0.428571428571429,1
"9942","MIR583",1,0,1,0,1,1
"9943","MIR587",6,8,14,0.571428571428571,0.428571428571429,1
"9944","MIR588",1,1,2,0.5,0.5,1
"9945","MIR596",1,1,2,0.5,0.5,1
"9946","MIR600",0,1,1,1,0,1
"9947","MIR612",0,1,1,1,0,1
"9948","MIR622",2,1,3,0.333333333333333,0.666666666666667,1
"9949","MIR633",3,1,4,0.25,0.75,1
"9950","MIR646",4,7,11,0.636363636363636,0.363636363636364,1
"9951","MIR654",3,5,8,0.625,0.375,1
"9952","MIR655",2,6,8,0.75,0.25,1
"9953","MIR656",2,6,8,0.75,0.25,1
"9954","MIR663B",1,6,7,0.857142857142857,0.142857142857143,1
"9955","MIR668",2,4,6,0.666666666666667,0.333333333333333,1
"9956","MIR7-2",2,2,4,0.5,0.5,1
"9957","MIR7-3",2,2,4,0.5,0.5,1
"9958","MIR758",10,2,12,0.166666666666667,0.833333333333333,1
"9959","MIR760",3,0,3,0,1,1
"9960","MIR770",0,3,3,1,0,1
"9961","MIR802",4,4,8,0.5,0.5,1
"9962","MIR873",3,1,4,0.25,0.75,1
"9963","MIR876",2,2,4,0.5,0.5,1
"9964","MIR888",11,1,12,0.0833333333333333,0.916666666666667,1
"9965","MIR889",2,1,3,0.333333333333333,0.666666666666667,1
"9966","MIR890",6,5,11,0.454545454545455,0.545454545454545,1
"9967","MIR891A",7,2,9,0.222222222222222,0.777777777777778,1
"9968","MIR891B",4,3,7,0.428571428571429,0.571428571428571,1
"9969","MIR892A",4,5,9,0.555555555555556,0.444444444444444,1
"9970","MIR892B",3,2,5,0.4,0.6,1
"9971","MIR9-1",0,1,1,1,0,1
"9972","MIR9-1HG",12,8,20,0.4,0.6,1
"9973","MIR9-3",2,2,4,0.5,0.5,1
"9974","MIR920",3,8,11,0.727272727272727,0.272727272727273,1
"9975","MIR924",1,3,4,0.75,0.25,1
"9976","MIR92A1",0,8,8,1,0,1
"9977","MIR92A2",1,0,1,0,1,1
"9978","MIR99A",2,5,7,0.714285714285714,0.285714285714286,1
"9979","MIR99AHG",2,6,8,0.75,0.25,1
"9980","MIRLET7A1",1,1,2,0.5,0.5,1
"9981","MIRLET7A2",0,2,2,1,0,1
"9982","MIRLET7A3",0,1,1,1,0,1
"9983","MIRLET7B",0,1,1,1,0,1
"9984","MIRLET7C",4,5,9,0.555555555555556,0.444444444444444,1
"9985","MIRLET7D",2,0,2,0,1,1
"9986","MIRLET7F1",0,1,1,1,0,1
"9987","MIS12",6,11,17,0.647058823529412,0.352941176470588,1
"9988","MIS18A",4,12,16,0.75,0.25,1
"9989","MIS18BP1",56,52,108,0.481481481481481,0.518518518518518,1
"9990","MISP",24,65,89,0.730337078651685,0.269662921348315,1
"9991","MITD1",13,9,22,0.409090909090909,0.590909090909091,1
"9992","MITF",42,31,73,0.424657534246575,0.575342465753425,1
"9993","MIXL1",5,14,19,0.736842105263158,0.263157894736842,1
"9994","MKI67",132,232,364,0.637362637362637,0.362637362637363,1
"9995","MKKS",10,21,31,0.67741935483871,0.32258064516129,1
"9996","MKLN1",21,35,56,0.625,0.375,1
"9997","MKNK1",15,20,35,0.571428571428571,0.428571428571429,1
"9998","MKNK2",12,21,33,0.636363636363636,0.363636363636364,1
"9999","MKRN1",14,22,36,0.611111111111111,0.388888888888889,1
"10000","MKRN2",14,20,34,0.588235294117647,0.411764705882353,1
"10001","MKRN3",66,90,156,0.576923076923077,0.423076923076923,1
"10002","MKS1",21,31,52,0.596153846153846,0.403846153846154,1
"10003","MKX",15,47,62,0.758064516129032,0.241935483870968,1
"10004","MLANA",2,11,13,0.846153846153846,0.153846153846154,1
"10005","MLC1",16,22,38,0.578947368421053,0.421052631578947,1
"10006","MLEC",6,21,27,0.777777777777778,0.222222222222222,1
"10007","MLF1",14,15,29,0.517241379310345,0.482758620689655,1
"10008","MLF2",18,20,38,0.526315789473684,0.473684210526316,1
"10009","MLH1",27,69,96,0.71875,0.28125,1
"10010","MLH3",45,71,116,0.612068965517241,0.387931034482759,1
"10011","MLIP",28,57,85,0.670588235294118,0.329411764705882,1
"10012","MLKL",17,26,43,0.604651162790698,0.395348837209302,1
"10013","MLLT1",21,25,46,0.543478260869565,0.456521739130435,1
"10014","MLLT10",32,66,98,0.673469387755102,0.326530612244898,1
"10015","MLLT11",2,6,8,0.75,0.25,1
"10016","MLLT3",19,31,50,0.62,0.38,1
"10017","MLLT6",36,43,79,0.544303797468354,0.455696202531646,1
"10018","MLN",2,7,9,0.777777777777778,0.222222222222222,1
"10019","MLNR",12,16,28,0.571428571428571,0.428571428571429,1
"10020","MLPH",13,23,36,0.638888888888889,0.361111111111111,1
"10021","MLST8",13,16,29,0.551724137931034,0.448275862068966,1
"10022","MLX",12,17,29,0.586206896551724,0.413793103448276,1
"10023","MLXIP",21,39,60,0.65,0.35,1
"10024","MLXIPL",41,48,89,0.539325842696629,0.460674157303371,1
"10025","MLYCD",7,23,30,0.766666666666667,0.233333333333333,1
"10026","MMAA",21,29,50,0.58,0.42,1
"10027","MMAB",7,13,20,0.65,0.35,1
"10028","MMACHC",6,6,12,0.5,0.5,1
"10029","MMADHC",8,17,25,0.68,0.32,1
"10030","MMD",5,13,18,0.722222222222222,0.277777777777778,1
"10031","MMD2",18,33,51,0.647058823529412,0.352941176470588,1
"10032","MME",60,127,187,0.679144385026738,0.320855614973262,1
"10033","MMEL1",26,55,81,0.679012345679012,0.320987654320988,1
"10034","MMGT1",15,2,17,0.117647058823529,0.882352941176471,1
"10035","MMP1",21,36,57,0.631578947368421,0.368421052631579,1
"10036","MMP10",25,54,79,0.683544303797468,0.316455696202532,1
"10037","MMP11",14,26,40,0.65,0.35,1
"10038","MMP12",24,49,73,0.671232876712329,0.328767123287671,1
"10039","MMP13",29,51,80,0.6375,0.3625,1
"10040","MMP14",17,22,39,0.564102564102564,0.435897435897436,1
"10041","MMP15",31,24,55,0.436363636363636,0.563636363636364,1
"10042","MMP16",73,143,216,0.662037037037037,0.337962962962963,1
"10043","MMP17",24,35,59,0.593220338983051,0.406779661016949,1
"10044","MMP19",19,43,62,0.693548387096774,0.306451612903226,1
"10045","MMP2",50,47,97,0.484536082474227,0.515463917525773,1
"10046","MMP20",25,45,70,0.642857142857143,0.357142857142857,1
"10047","MMP21",24,31,55,0.563636363636364,0.436363636363636,1
"10048","MMP23B",1,1,2,0.5,0.5,1
"10049","MMP24",11,38,49,0.775510204081633,0.224489795918367,1
"10050","MMP25",18,30,48,0.625,0.375,1
"10051","MMP26",16,41,57,0.719298245614035,0.280701754385965,1
"10052","MMP27",28,44,72,0.611111111111111,0.388888888888889,1
"10053","MMP28",25,34,59,0.576271186440678,0.423728813559322,1
"10054","MMP3",37,44,81,0.54320987654321,0.45679012345679,1
"10055","MMP7",18,17,35,0.485714285714286,0.514285714285714,1
"10056","MMP8",19,36,55,0.654545454545455,0.345454545454545,1
"10057","MMP9",38,67,105,0.638095238095238,0.361904761904762,1
"10058","MMRN1",76,130,206,0.631067961165049,0.368932038834951,1
"10059","MMRN2",31,37,68,0.544117647058823,0.455882352941176,1
"10060","MMS19",13,19,32,0.59375,0.40625,1
"10061","MMS22L",45,76,121,0.628099173553719,0.371900826446281,1
"10062","MMUT",35,46,81,0.567901234567901,0.432098765432099,1
"10063","MN1",41,70,111,0.630630630630631,0.369369369369369,1
"10064","MNAT1",11,11,22,0.5,0.5,1
"10065","MND1",1,1,2,0.5,0.5,1
"10066","MNDA",51,98,149,0.657718120805369,0.342281879194631,1
"10067","MNS1",13,21,34,0.617647058823529,0.382352941176471,1
"10068","MNT",12,22,34,0.647058823529412,0.352941176470588,1
"10069","MNX1",9,20,29,0.689655172413793,0.310344827586207,1
"10070","MOAP1",11,15,26,0.576923076923077,0.423076923076923,1
"10071","MOB1A",3,9,12,0.75,0.25,1
"10072","MOB1B",9,12,21,0.571428571428571,0.428571428571429,1
"10073","MOB2",4,12,16,0.75,0.25,1
"10074","MOB3A",6,9,15,0.6,0.4,1
"10075","MOB3B",7,13,20,0.65,0.35,1
"10076","MOB3C",10,13,23,0.565217391304348,0.434782608695652,1
"10077","MOB4",8,7,15,0.466666666666667,0.533333333333333,1
"10078","MOBP",3,4,7,0.571428571428571,0.428571428571429,1
"10079","MOCOS",39,51,90,0.566666666666667,0.433333333333333,1
"10080","MOCS1",25,33,58,0.568965517241379,0.431034482758621,1
"10081","MOCS2",9,12,21,0.571428571428571,0.428571428571429,1
"10082","MOCS3",14,32,46,0.695652173913043,0.304347826086957,1
"10083","MOG",20,38,58,0.655172413793103,0.344827586206897,1
"10084","MOGAT1",15,20,35,0.571428571428571,0.428571428571429,1
"10085","MOGAT2",14,31,45,0.688888888888889,0.311111111111111,1
"10086","MOGAT3",22,27,49,0.551020408163265,0.448979591836735,1
"10087","MOGS",26,55,81,0.679012345679012,0.320987654320988,1
"10088","MOK",11,19,30,0.633333333333333,0.366666666666667,1
"10089","MON1A",14,14,28,0.5,0.5,1
"10090","MON1B",25,38,63,0.603174603174603,0.396825396825397,1
"10091","MON2",59,91,150,0.606666666666667,0.393333333333333,1
"10092","MORC1",111,174,285,0.610526315789474,0.389473684210526,1
"10093","MORC2",26,69,95,0.726315789473684,0.273684210526316,1
"10094","MORC3",30,52,82,0.634146341463415,0.365853658536585,1
"10095","MORC4",59,36,95,0.378947368421053,0.621052631578947,1
"10096","MORF4",18,53,71,0.746478873239437,0.253521126760563,1
"10097","MORF4L1",15,23,38,0.605263157894737,0.394736842105263,1
"10098","MORF4L2",20,10,30,0.333333333333333,0.666666666666667,1
"10099","MORN1",8,27,35,0.771428571428571,0.228571428571429,1
"10100","MORN2",0,1,1,1,0,1
"10101","MORN3",17,16,33,0.484848484848485,0.515151515151515,1
"10102","MORN4",5,6,11,0.545454545454545,0.454545454545455,1
"10103","MORN5",9,17,26,0.653846153846154,0.346153846153846,1
"10104","MOS",22,47,69,0.681159420289855,0.318840579710145,1
"10105","MOSPD1",12,2,14,0.142857142857143,0.857142857142857,1
"10106","MOSPD2",23,23,46,0.5,0.5,1
"10107","MOSPD3",9,16,25,0.64,0.36,1
"10108","MOV10",29,47,76,0.618421052631579,0.381578947368421,1
"10109","MOV10L1",43,73,116,0.629310344827586,0.370689655172414,1
"10110","MOXD1",28,47,75,0.626666666666667,0.373333333333333,1
"10111","MPC1",6,4,10,0.4,0.6,1
"10112","MPC2",3,5,8,0.625,0.375,1
"10113","MPDU1",4,5,9,0.555555555555556,0.444444444444444,1
"10114","MPDZ",80,103,183,0.562841530054645,0.437158469945355,1
"10115","MPEG1",38,65,103,0.631067961165049,0.368932038834951,1
"10116","MPG",9,13,22,0.590909090909091,0.409090909090909,1
"10117","MPHOSPH10",20,47,67,0.701492537313433,0.298507462686567,1
"10118","MPHOSPH6",6,9,15,0.6,0.4,1
"10119","MPHOSPH8",28,45,73,0.616438356164384,0.383561643835616,1
"10120","MPHOSPH9",20,52,72,0.722222222222222,0.277777777777778,1
"10121","MPI",11,16,27,0.592592592592593,0.407407407407407,1
"10122","MPIG6B",8,22,30,0.733333333333333,0.266666666666667,1
"10123","MPL",19,34,53,0.641509433962264,0.358490566037736,1
"10124","MPLKIP",4,10,14,0.714285714285714,0.285714285714286,1
"10125","MPND",3,21,24,0.875,0.125,1
"10126","MPO",48,66,114,0.578947368421053,0.421052631578947,1
"10127","MPP1",26,18,44,0.409090909090909,0.590909090909091,1
"10128","MPP2",30,47,77,0.61038961038961,0.38961038961039,1
"10129","MPP3",24,20,44,0.454545454545455,0.545454545454545,1
"10130","MPP4",29,39,68,0.573529411764706,0.426470588235294,1
"10131","MPP5",18,19,37,0.513513513513513,0.486486486486487,1
"10132","MPP6",41,50,91,0.549450549450549,0.450549450549451,1
"10133","MPP7",20,78,98,0.795918367346939,0.204081632653061,1
"10134","MPPE1",11,9,20,0.45,0.55,1
"10135","MPPED1",25,26,51,0.509803921568627,0.490196078431373,1
"10136","MPPED2",40,31,71,0.436619718309859,0.563380281690141,1
"10137","MPRIP",37,58,95,0.610526315789474,0.389473684210526,1
"10138","MPST",3,10,13,0.769230769230769,0.230769230769231,1
"10139","MPV17",7,6,13,0.461538461538462,0.538461538461538,1
"10140","MPV17L",2,7,9,0.777777777777778,0.222222222222222,1
"10141","MPV17L2",4,11,15,0.733333333333333,0.266666666666667,1
"10142","MPZ",6,14,20,0.7,0.3,1
"10143","MPZL1",11,19,30,0.633333333333333,0.366666666666667,1
"10144","MPZL2",11,11,22,0.5,0.5,1
"10145","MPZL3",11,9,20,0.45,0.55,1
"10146","MR1",19,27,46,0.58695652173913,0.41304347826087,1
"10147","MRAP",9,13,22,0.590909090909091,0.409090909090909,1
"10148","MRAP2",20,31,51,0.607843137254902,0.392156862745098,1
"10149","MRAS",3,10,13,0.769230769230769,0.230769230769231,1
"10150","MRC1",127,215,342,0.628654970760234,0.371345029239766,1
"10151","MRC2",49,88,137,0.642335766423358,0.357664233576642,1
"10152","MRE11",27,43,70,0.614285714285714,0.385714285714286,1
"10153","MREG",6,16,22,0.727272727272727,0.272727272727273,1
"10154","MRFAP1",3,4,7,0.571428571428571,0.428571428571429,1
"10155","MRFAP1L1",3,3,6,0.5,0.5,1
"10156","MRGBP",9,13,22,0.590909090909091,0.409090909090909,1
"10157","MRGPRD",22,18,40,0.45,0.55,1
"10158","MRGPRE",14,9,23,0.391304347826087,0.608695652173913,1
"10159","MRGPRF",8,14,22,0.636363636363636,0.363636363636364,1
"10160","MRGPRG",0,1,1,1,0,1
"10161","MRGPRX1",43,64,107,0.598130841121495,0.401869158878505,1
"10162","MRGPRX2",21,38,59,0.644067796610169,0.355932203389831,1
"10163","MRGPRX3",32,42,74,0.567567567567568,0.432432432432432,1
"10164","MRGPRX4",30,24,54,0.444444444444444,0.555555555555556,1
"10165","MRI1",10,15,25,0.6,0.4,1
"10166","MRM1",15,14,29,0.482758620689655,0.517241379310345,1
"10167","MRM2",7,17,24,0.708333333333333,0.291666666666667,1
"10168","MRM3",11,12,23,0.521739130434783,0.478260869565217,1
"10169","MRNIP",14,17,31,0.548387096774194,0.451612903225806,1
"10170","MRO",14,17,31,0.548387096774194,0.451612903225806,1
"10171","MROH1",41,71,112,0.633928571428571,0.366071428571429,1
"10172","MROH2A",0,8,8,1,0,1
"10173","MROH2B",166,296,462,0.640692640692641,0.359307359307359,1
"10174","MROH5",58,65,123,0.528455284552846,0.471544715447154,1
"10175","MROH6",6,15,21,0.714285714285714,0.285714285714286,1
"10176","MROH7",44,97,141,0.687943262411348,0.312056737588652,1
"10177","MROH8",23,54,77,0.701298701298701,0.298701298701299,1
"10178","MROH9",41,77,118,0.652542372881356,0.347457627118644,1
"10179","MRPL1",12,21,33,0.636363636363636,0.363636363636364,1
"10180","MRPL10",6,9,15,0.6,0.4,1
"10181","MRPL11",4,14,18,0.777777777777778,0.222222222222222,1
"10182","MRPL13",10,14,24,0.583333333333333,0.416666666666667,1
"10183","MRPL14",7,10,17,0.588235294117647,0.411764705882353,1
"10184","MRPL15",14,10,24,0.416666666666667,0.583333333333333,1
"10185","MRPL16",11,8,19,0.421052631578947,0.578947368421053,1
"10186","MRPL17",5,11,16,0.6875,0.3125,1
"10187","MRPL18",8,4,12,0.333333333333333,0.666666666666667,1
"10188","MRPL19",11,11,22,0.5,0.5,1
"10189","MRPL2",17,18,35,0.514285714285714,0.485714285714286,1
"10190","MRPL20",3,8,11,0.727272727272727,0.272727272727273,1
"10191","MRPL21",4,12,16,0.75,0.25,1
"10192","MRPL22",4,11,15,0.733333333333333,0.266666666666667,1
"10193","MRPL23",1,0,1,0,1,1
"10194","MRPL24",8,9,17,0.529411764705882,0.470588235294118,1
"10195","MRPL27",3,4,7,0.571428571428571,0.428571428571429,1
"10196","MRPL28",9,11,20,0.55,0.45,1
"10197","MRPL3",7,19,26,0.730769230769231,0.269230769230769,1
"10198","MRPL30",5,16,21,0.761904761904762,0.238095238095238,1
"10199","MRPL32",6,18,24,0.75,0.25,1
"10200","MRPL33",3,5,8,0.625,0.375,1
"10201","MRPL34",3,3,6,0.5,0.5,1
"10202","MRPL35",4,15,19,0.789473684210526,0.210526315789474,1
"10203","MRPL36",1,3,4,0.75,0.25,1
"10204","MRPL37",5,21,26,0.807692307692308,0.192307692307692,1
"10205","MRPL38",9,11,20,0.55,0.45,1
"10206","MRPL39",15,15,30,0.5,0.5,1
"10207","MRPL4",5,16,21,0.761904761904762,0.238095238095238,1
"10208","MRPL40",4,8,12,0.666666666666667,0.333333333333333,1
"10209","MRPL41",6,2,8,0.25,0.75,1
"10210","MRPL42",8,2,10,0.2,0.8,1
"10211","MRPL43",4,5,9,0.555555555555556,0.444444444444444,1
"10212","MRPL44",10,21,31,0.67741935483871,0.32258064516129,1
"10213","MRPL45",6,17,23,0.739130434782609,0.260869565217391,1
"10214","MRPL46",8,10,18,0.555555555555556,0.444444444444444,1
"10215","MRPL47",14,24,38,0.631578947368421,0.368421052631579,1
"10216","MRPL48",7,3,10,0.3,0.7,1
"10217","MRPL49",7,5,12,0.416666666666667,0.583333333333333,1
"10218","MRPL50",9,9,18,0.5,0.5,1
"10219","MRPL51",5,9,14,0.642857142857143,0.357142857142857,1
"10220","MRPL52",2,0,2,0,1,1
"10221","MRPL53",6,6,12,0.5,0.5,1
"10222","MRPL54",8,14,22,0.636363636363636,0.363636363636364,1
"10223","MRPL55",5,6,11,0.545454545454545,0.454545454545455,1
"10224","MRPL57",5,4,9,0.444444444444444,0.555555555555556,1
"10225","MRPL58",14,16,30,0.533333333333333,0.466666666666667,1
"10226","MRPL9",3,15,18,0.833333333333333,0.166666666666667,1
"10227","MRPS10",3,9,12,0.75,0.25,1
"10228","MRPS11",7,4,11,0.363636363636364,0.636363636363636,1
"10229","MRPS12",2,8,10,0.8,0.2,1
"10230","MRPS14",3,12,15,0.8,0.2,1
"10231","MRPS15",14,21,35,0.6,0.4,1
"10232","MRPS16",1,4,5,0.8,0.2,1
"10233","MRPS17",4,4,8,0.5,0.5,1
"10234","MRPS17P9",8,7,15,0.466666666666667,0.533333333333333,1
"10235","MRPS18A",4,5,9,0.555555555555556,0.444444444444444,1
"10236","MRPS18B",3,11,14,0.785714285714286,0.214285714285714,1
"10237","MRPS18C",2,8,10,0.8,0.2,1
"10238","MRPS2",10,10,20,0.5,0.5,1
"10239","MRPS21",2,9,11,0.818181818181818,0.181818181818182,1
"10240","MRPS22",19,19,38,0.5,0.5,1
"10241","MRPS23",8,6,14,0.428571428571429,0.571428571428571,1
"10242","MRPS24",7,8,15,0.533333333333333,0.466666666666667,1
"10243","MRPS25",3,9,12,0.75,0.25,1
"10244","MRPS26",2,4,6,0.666666666666667,0.333333333333333,1
"10245","MRPS27",14,17,31,0.548387096774194,0.451612903225806,1
"10246","MRPS28",10,9,19,0.473684210526316,0.526315789473684,1
"10247","MRPS30",9,31,40,0.775,0.225,1
"10248","MRPS31",15,20,35,0.571428571428571,0.428571428571429,1
"10249","MRPS33",3,3,6,0.5,0.5,1
"10250","MRPS34",6,2,8,0.25,0.75,1
"10251","MRPS35",12,21,33,0.636363636363636,0.363636363636364,1
"10252","MRPS36",4,6,10,0.6,0.4,1
"10253","MRPS5",23,22,45,0.488888888888889,0.511111111111111,1
"10254","MRPS6",4,10,14,0.714285714285714,0.285714285714286,1
"10255","MRPS7",6,12,18,0.666666666666667,0.333333333333333,1
"10256","MRPS9",14,20,34,0.588235294117647,0.411764705882353,1
"10257","MRRF",2,10,12,0.833333333333333,0.166666666666667,1
"10258","MRRFP1",1,4,5,0.8,0.2,1
"10259","MRS2",10,17,27,0.62962962962963,0.37037037037037,1
"10260","MRTFA",33,69,102,0.676470588235294,0.323529411764706,1
"10261","MRTFB",39,57,96,0.59375,0.40625,1
"10262","MRTO4",5,7,12,0.583333333333333,0.416666666666667,1
"10263","MS4A1",27,40,67,0.597014925373134,0.402985074626866,1
"10264","MS4A10",11,28,39,0.717948717948718,0.282051282051282,1
"10265","MS4A12",15,31,46,0.673913043478261,0.326086956521739,1
"10266","MS4A13",6,20,26,0.769230769230769,0.230769230769231,1
"10267","MS4A14",57,84,141,0.595744680851064,0.404255319148936,1
"10268","MS4A15",10,19,29,0.655172413793103,0.344827586206897,1
"10269","MS4A2",18,34,52,0.653846153846154,0.346153846153846,1
"10270","MS4A3",12,28,40,0.7,0.3,1
"10271","MS4A4A",10,33,43,0.767441860465116,0.232558139534884,1
"10272","MS4A5",21,20,41,0.48780487804878,0.51219512195122,1
"10273","MS4A6A",13,23,36,0.638888888888889,0.361111111111111,1
"10274","MS4A6E",13,18,31,0.580645161290323,0.419354838709677,1
"10275","MS4A7",17,25,42,0.595238095238095,0.404761904761905,1
"10276","MS4A8",17,23,40,0.575,0.425,1
"10277","MSANTD1",3,10,13,0.769230769230769,0.230769230769231,1
"10278","MSANTD2",14,14,28,0.5,0.5,1
"10279","MSANTD3",15,14,29,0.482758620689655,0.517241379310345,1
"10280","MSANTD3-TMEFF1",2,3,5,0.6,0.4,1
"10281","MSANTD4",17,29,46,0.630434782608696,0.369565217391304,1
"10282","MSC",16,25,41,0.609756097560976,0.390243902439024,1
"10283","MSGN1",15,17,32,0.53125,0.46875,1
"10284","MSH2",33,61,94,0.648936170212766,0.351063829787234,1
"10285","MSH3",50,62,112,0.553571428571429,0.446428571428571,1
"10286","MSH4",66,84,150,0.56,0.44,1
"10287","MSH5",29,31,60,0.516666666666667,0.483333333333333,1
"10288","MSH6",64,89,153,0.581699346405229,0.418300653594771,1
"10289","MSI1",17,21,38,0.552631578947368,0.447368421052632,1
"10290","MSI2",15,21,36,0.583333333333333,0.416666666666667,1
"10291","MSL1",11,14,25,0.56,0.44,1
"10292","MSL2",27,37,64,0.578125,0.421875,1
"10293","MSL3",28,34,62,0.548387096774194,0.451612903225806,1
"10294","MSLN",28,43,71,0.605633802816901,0.394366197183099,1
"10295","MSLNL",19,27,46,0.58695652173913,0.41304347826087,1
"10296","MSMB",8,9,17,0.529411764705882,0.470588235294118,1
"10297","MSMO1",7,15,22,0.681818181818182,0.318181818181818,1
"10298","MSMP",2,6,8,0.75,0.25,1
"10299","MSN",44,24,68,0.352941176470588,0.647058823529412,1
"10300","MSR1",45,97,142,0.683098591549296,0.316901408450704,1
"10301","MSRA",15,12,27,0.444444444444444,0.555555555555556,1
"10302","MSRB1",3,9,12,0.75,0.25,1
"10303","MSRB2",14,12,26,0.461538461538462,0.538461538461538,1
"10304","MSRB3",6,30,36,0.833333333333333,0.166666666666667,1
"10305","MSS51",13,19,32,0.59375,0.40625,1
"10306","MST1",13,30,43,0.697674418604651,0.302325581395349,1
"10307","MST1R",45,71,116,0.612068965517241,0.387931034482759,1
"10308","MSTN",18,32,50,0.64,0.36,1
"10309","MSTO1",7,12,19,0.631578947368421,0.368421052631579,1
"10310","MSX1",13,15,28,0.535714285714286,0.464285714285714,1
"10311","MSX2",6,10,16,0.625,0.375,1
"10312","MT1A",1,5,6,0.833333333333333,0.166666666666667,1
"10313","MT1B",4,1,5,0.2,0.8,1
"10314","MT1E",1,1,2,0.5,0.5,1
"10315","MT1F",1,1,2,0.5,0.5,1
"10316","MT1G",3,3,6,0.5,0.5,1
"10317","MT1H",6,10,16,0.625,0.375,1
"10318","MT1M",3,5,8,0.625,0.375,1
"10319","MT1X",1,0,1,0,1,1
"10320","MT2A",3,1,4,0.25,0.75,1
"10321","MT3",3,4,7,0.571428571428571,0.428571428571429,1
"10322","MT4",5,3,8,0.375,0.625,1
"10323","MTA1",31,43,74,0.581081081081081,0.418918918918919,1
"10324","MTA2",25,44,69,0.63768115942029,0.36231884057971,1
"10325","MTA3",12,20,32,0.625,0.375,1
"10326","MTAP",7,9,16,0.5625,0.4375,1
"10327","MTARC1",7,19,26,0.730769230769231,0.269230769230769,0.24
"10328","MTARC2",10,12,22,0.545454545454545,0.454545454545455,0.24
"10329","MTBP",37,49,86,0.569767441860465,0.430232558139535,1
"10330","MTCH1",8,15,23,0.652173913043478,0.347826086956522,1
"10331","MTCH2",17,17,34,0.5,0.5,1
"10332","MTCL1",69,96,165,0.581818181818182,0.418181818181818,1
"10333","MTCP1",9,2,11,0.181818181818182,0.818181818181818,1
"10334","MTDH",21,33,54,0.611111111111111,0.388888888888889,1
"10335","MTERF1",13,23,36,0.638888888888889,0.361111111111111,1
"10336","MTERF2",14,18,32,0.5625,0.4375,1
"10337","MTERF3",27,29,56,0.517857142857143,0.482142857142857,1
"10338","MTERF4",7,23,30,0.766666666666667,0.233333333333333,1
"10339","MTF1",26,42,68,0.617647058823529,0.382352941176471,1
"10340","MTF2",27,35,62,0.564516129032258,0.435483870967742,1
"10341","MTFMT",9,12,21,0.571428571428571,0.428571428571429,1
"10342","MTFP1",1,1,2,0.5,0.5,1
"10343","MTFR1",14,20,34,0.588235294117647,0.411764705882353,1
"10344","MTFR1L",9,12,21,0.571428571428571,0.428571428571429,1
"10345","MTFR2",6,18,24,0.75,0.25,1
"10346","MTG1",15,17,32,0.53125,0.46875,1
"10347","MTG2",12,18,30,0.6,0.4,1
"10348","MTHFD1",20,41,61,0.672131147540984,0.327868852459016,1
"10349","MTHFD1L",34,40,74,0.540540540540541,0.459459459459459,1
"10350","MTHFD2",12,22,34,0.647058823529412,0.352941176470588,1
"10351","MTHFD2L",13,26,39,0.666666666666667,0.333333333333333,1
"10352","MTHFR",24,33,57,0.578947368421053,0.421052631578947,1
"10353","MTHFS",6,6,12,0.5,0.5,1
"10354","MTHFSD",18,12,30,0.4,0.6,1
"10355","MTIF2",27,47,74,0.635135135135135,0.364864864864865,1
"10356","MTIF3",3,18,21,0.857142857142857,0.142857142857143,1
"10357","MTM1",53,19,72,0.263888888888889,0.736111111111111,1
"10358","MTMR1",46,35,81,0.432098765432099,0.567901234567901,1
"10359","MTMR10",24,28,52,0.538461538461538,0.461538461538462,1
"10360","MTMR11",27,48,75,0.64,0.36,1
"10361","MTMR12",24,55,79,0.69620253164557,0.30379746835443,1
"10362","MTMR14",20,31,51,0.607843137254902,0.392156862745098,1
"10363","MTMR2",18,27,45,0.6,0.4,1
"10364","MTMR3",30,59,89,0.662921348314607,0.337078651685393,1
"10365","MTMR4",40,60,100,0.6,0.4,1
"10366","MTMR6",21,35,56,0.625,0.375,1
"10367","MTMR7",24,47,71,0.661971830985915,0.338028169014085,1
"10368","MTMR8",41,38,79,0.481012658227848,0.518987341772152,1
"10369","MTMR9",13,23,36,0.638888888888889,0.361111111111111,1
"10370","MTNR1A",20,34,54,0.62962962962963,0.37037037037037,1
"10371","MTNR1B",25,59,84,0.702380952380952,0.297619047619048,1
"10372","MTO1",19,25,44,0.568181818181818,0.431818181818182,1
"10373","MTOR",114,141,255,0.552941176470588,0.447058823529412,1
"10374","MTPAP",17,31,48,0.645833333333333,0.354166666666667,1
"10375","MTPN",9,3,12,0.25,0.75,1
"10376","MTR",58,68,126,0.53968253968254,0.46031746031746,1
"10377","MTRES1",9,14,23,0.608695652173913,0.391304347826087,1
"10378","MTREX",46,39,85,0.458823529411765,0.541176470588235,1
"10379","MTRF1",11,26,37,0.702702702702703,0.297297297297297,1
"10380","MTRF1L",8,16,24,0.666666666666667,0.333333333333333,1
"10381","MTRR",25,60,85,0.705882352941177,0.294117647058824,1
"10382","MTSS1",24,45,69,0.652173913043478,0.347826086956522,1
"10383","MTSS2",18,24,42,0.571428571428571,0.428571428571429,1
"10384","MTTP",48,89,137,0.64963503649635,0.35036496350365,1
"10385","MTURN",5,6,11,0.545454545454545,0.454545454545455,1
"10386","MTUS1",41,64,105,0.60952380952381,0.39047619047619,1
"10387","MTUS2",101,156,257,0.607003891050584,0.392996108949416,1
"10388","MTX1",8,14,22,0.636363636363636,0.363636363636364,1
"10389","MTX2",4,14,18,0.777777777777778,0.222222222222222,1
"10390","MTX3",7,14,21,0.666666666666667,0.333333333333333,1
"10391","MUC1",7,10,17,0.588235294117647,0.411764705882353,1
"10392","MUC13",15,41,56,0.732142857142857,0.267857142857143,1
"10393","MUC15",15,41,56,0.732142857142857,0.267857142857143,1
"10394","MUC16",1145,2334,3479,0.670882437482035,0.329117562517965,1
"10395","MUC17",308,567,875,0.648,0.352,1
"10396","MUC19",3,8,11,0.727272727272727,0.272727272727273,1
"10397","MUC2",101,132,233,0.566523605150215,0.433476394849785,1
"10398","MUC20",16,28,44,0.636363636363636,0.363636363636364,1
"10399","MUC21",22,45,67,0.671641791044776,0.328358208955224,1
"10400","MUC3A",58,97,155,0.625806451612903,0.374193548387097,1
"10401","MUC4",104,164,268,0.611940298507463,0.388059701492537,1
"10402","MUC5AC",54,114,168,0.678571428571429,0.321428571428571,1
"10403","MUC5B",221,338,559,0.604651162790698,0.395348837209302,1
"10404","MUC6",88,120,208,0.576923076923077,0.423076923076923,1
"10405","MUC7",31,62,93,0.666666666666667,0.333333333333333,1
"10406","MUCL1",2,11,13,0.846153846153846,0.153846153846154,1
"10407","MUCL3",6,18,24,0.75,0.25,1
"10408","MUL1",8,19,27,0.703703703703704,0.296296296296296,1
"10409","MUS81",22,25,47,0.531914893617021,0.468085106382979,1
"10410","MUSK",51,101,152,0.664473684210526,0.335526315789474,1
"10411","MUTYH",14,44,58,0.758620689655172,0.241379310344828,1
"10412","MVB12A",10,11,21,0.523809523809524,0.476190476190476,1
"10413","MVB12B",11,19,30,0.633333333333333,0.366666666666667,1
"10414","MVD",15,16,31,0.516129032258065,0.483870967741935,1
"10415","MVK",32,31,63,0.492063492063492,0.507936507936508,1
"10416","MVP",38,43,81,0.530864197530864,0.469135802469136,1
"10417","MX1",22,38,60,0.633333333333333,0.366666666666667,1
"10418","MX2",18,51,69,0.739130434782609,0.260869565217391,1
"10419","MXD1",9,13,22,0.590909090909091,0.409090909090909,1
"10420","MXD3",7,8,15,0.533333333333333,0.466666666666667,1
"10421","MXD4",3,11,14,0.785714285714286,0.214285714285714,1
"10422","MXI1",7,8,15,0.533333333333333,0.466666666666667,1
"10423","MXRA5",255,292,547,0.53382084095064,0.46617915904936,1
"10424","MXRA7",2,6,8,0.75,0.25,1
"10425","MXRA8",30,26,56,0.464285714285714,0.535714285714286,1
"10426","MYADM",12,18,30,0.6,0.4,1
"10427","MYADML2",0,1,1,1,0,1
"10428","MYB",16,43,59,0.728813559322034,0.271186440677966,1
"10429","MYBBP1A",35,41,76,0.539473684210526,0.460526315789474,1
"10430","MYBL1",34,48,82,0.585365853658537,0.414634146341463,1
"10431","MYBL2",22,53,75,0.706666666666667,0.293333333333333,1
"10432","MYBPC1",64,97,161,0.602484472049689,0.397515527950311,1
"10433","MYBPC2",31,78,109,0.715596330275229,0.284403669724771,1
"10434","MYBPC3",32,76,108,0.703703703703704,0.296296296296296,1
"10435","MYBPH",23,36,59,0.610169491525424,0.389830508474576,1
"10436","MYBPHL",5,13,18,0.722222222222222,0.277777777777778,1
"10437","MYC",15,33,48,0.6875,0.3125,1
"10438","MYCBP",2,4,6,0.666666666666667,0.333333333333333,1
"10439","MYCBP2",154,249,403,0.617866004962779,0.382133995037221,1
"10440","MYCBPAP",41,60,101,0.594059405940594,0.405940594059406,1
"10441","MYCL",13,20,33,0.606060606060606,0.393939393939394,1
"10442","MYCLP1",0,3,3,1,0,1
"10443","MYCN",23,41,64,0.640625,0.359375,1
"10444","MYCT1",30,47,77,0.61038961038961,0.38961038961039,1
"10445","MYD88",10,15,25,0.6,0.4,1
"10446","MYDGF",3,7,10,0.7,0.3,1
"10447","MYEF2",38,42,80,0.525,0.475,1
"10448","MYEOV",7,25,32,0.78125,0.21875,1
"10449","MYF5",34,60,94,0.638297872340426,0.361702127659574,1
"10450","MYF6",31,34,65,0.523076923076923,0.476923076923077,1
"10451","MYG1",8,12,20,0.6,0.4,1
"10452","MYH1",161,304,465,0.653763440860215,0.346236559139785,1
"10453","MYH10",70,98,168,0.583333333333333,0.416666666666667,1
"10454","MYH11",89,165,254,0.649606299212598,0.350393700787402,1
"10455","MYH13",112,239,351,0.680911680911681,0.319088319088319,1
"10456","MYH14",66,107,173,0.61849710982659,0.38150289017341,1
"10457","MYH15",103,206,309,0.666666666666667,0.333333333333333,1
"10458","MYH2",166,347,513,0.676413255360624,0.323586744639376,1
"10459","MYH3",89,159,248,0.641129032258065,0.358870967741935,1
"10460","MYH4",142,247,389,0.634961439588689,0.365038560411311,1
"10461","MYH6",114,185,299,0.618729096989967,0.381270903010033,1
"10462","MYH7",120,251,371,0.676549865229111,0.323450134770889,1
"10463","MYH7B",77,122,199,0.613065326633166,0.386934673366834,1
"10464","MYH8",171,261,432,0.604166666666667,0.395833333333333,1
"10465","MYH9",84,153,237,0.645569620253165,0.354430379746835,1
"10466","MYL1",15,24,39,0.615384615384615,0.384615384615385,1
"10467","MYL10",10,13,23,0.565217391304348,0.434782608695652,1
"10468","MYL12A",1,7,8,0.875,0.125,1
"10469","MYL12B",6,11,17,0.647058823529412,0.352941176470588,1
"10470","MYL2",18,26,44,0.590909090909091,0.409090909090909,1
"10471","MYL3",4,8,12,0.666666666666667,0.333333333333333,1
"10472","MYL4",9,10,19,0.526315789473684,0.473684210526316,1
"10473","MYL5",6,9,15,0.6,0.4,1
"10474","MYL6",2,5,7,0.714285714285714,0.285714285714286,1
"10475","MYL6B",10,2,12,0.166666666666667,0.833333333333333,1
"10476","MYL7",3,15,18,0.833333333333333,0.166666666666667,1
"10477","MYL9",4,16,20,0.8,0.2,1
"10478","MYLIP",14,24,38,0.631578947368421,0.368421052631579,1
"10479","MYLK",91,159,250,0.636,0.364,1
"10480","MYLK2",28,52,80,0.65,0.35,1
"10481","MYLK3",27,71,98,0.724489795918367,0.275510204081633,1
"10482","MYLK4",13,32,45,0.711111111111111,0.288888888888889,1
"10483","MYLPF",6,16,22,0.727272727272727,0.272727272727273,1
"10484","MYMK",15,12,27,0.444444444444444,0.555555555555556,1
"10485","MYNN",19,36,55,0.654545454545455,0.345454545454545,1
"10486","MYO10",81,109,190,0.573684210526316,0.426315789473684,1
"10487","MYO15A",147,196,343,0.571428571428571,0.428571428571429,1
"10488","MYO16",120,207,327,0.63302752293578,0.36697247706422,1
"10489","MYO18A",79,76,155,0.490322580645161,0.509677419354839,1
"10490","MYO18B",138,256,394,0.649746192893401,0.350253807106599,1
"10491","MYO19",26,45,71,0.633802816901408,0.366197183098592,1
"10492","MYO1A",57,69,126,0.547619047619048,0.452380952380952,1
"10493","MYO1B",40,76,116,0.655172413793103,0.344827586206897,1
"10494","MYO1C",39,36,75,0.48,0.52,1
"10495","MYO1D",29,59,88,0.670454545454545,0.329545454545455,1
"10496","MYO1E",37,56,93,0.602150537634409,0.397849462365591,1
"10497","MYO1F",50,120,170,0.705882352941177,0.294117647058824,1
"10498","MYO1G",25,67,92,0.728260869565217,0.271739130434783,1
"10499","MYO1H",32,60,92,0.652173913043478,0.347826086956522,1
"10500","MYO3A",118,230,348,0.660919540229885,0.339080459770115,1
"10501","MYO3B",74,125,199,0.628140703517588,0.371859296482412,1
"10502","MYO5A",59,99,158,0.626582278481013,0.373417721518987,1
"10503","MYO5B",59,128,187,0.684491978609626,0.315508021390374,1
"10504","MYO5C",58,101,159,0.635220125786163,0.364779874213836,1
"10505","MYO6",54,90,144,0.625,0.375,1
"10506","MYO7A",64,124,188,0.659574468085106,0.340425531914894,1
"10507","MYO7B",86,133,219,0.607305936073059,0.392694063926941,1
"10508","MYO9A",108,135,243,0.555555555555556,0.444444444444444,1
"10509","MYO9B",63,86,149,0.577181208053691,0.422818791946309,1
"10510","MYOC",29,42,71,0.591549295774648,0.408450704225352,1
"10511","MYOCD",91,162,253,0.640316205533597,0.359683794466403,1
"10512","MYOD1",16,14,30,0.466666666666667,0.533333333333333,1
"10513","MYOF",89,102,191,0.534031413612565,0.465968586387435,1
"10514","MYOG",9,17,26,0.653846153846154,0.346153846153846,1
"10515","MYOM1",58,113,171,0.660818713450292,0.339181286549708,1
"10516","MYOM2",111,156,267,0.584269662921348,0.415730337078652,1
"10517","MYOM3",61,106,167,0.634730538922156,0.365269461077844,1
"10518","MYORG",26,32,58,0.551724137931034,0.448275862068966,1
"10519","MYOT",15,41,56,0.732142857142857,0.267857142857143,1
"10520","MYOZ1",15,24,39,0.615384615384615,0.384615384615385,1
"10521","MYOZ2",13,29,42,0.69047619047619,0.30952380952381,1
"10522","MYOZ3",14,19,33,0.575757575757576,0.424242424242424,1
"10523","MYPN",65,125,190,0.657894736842105,0.342105263157895,1
"10524","MYPOP",9,20,29,0.689655172413793,0.310344827586207,1
"10525","MYRF",40,57,97,0.587628865979381,0.412371134020619,1
"10526","MYRIP",30,60,90,0.666666666666667,0.333333333333333,1
"10527","MYSM1",13,47,60,0.783333333333333,0.216666666666667,1
"10528","MYT1",69,104,173,0.601156069364162,0.398843930635838,1
"10529","MYT1L",101,201,302,0.665562913907285,0.334437086092715,1
"10530","MYZAP",2,8,10,0.8,0.2,1
"10531","MZB1",3,5,8,0.625,0.375,1
"10532","MZF1",21,29,50,0.58,0.42,1
"10533","MZT1",4,2,6,0.333333333333333,0.666666666666667,1
"10534","MZT2A",4,11,15,0.733333333333333,0.266666666666667,1
"10535","MZT2B",6,3,9,0.333333333333333,0.666666666666667,1
"10536","N4BP1",20,58,78,0.743589743589744,0.256410256410256,1
"10537","N4BP2",58,94,152,0.618421052631579,0.381578947368421,1
"10538","N4BP2L1",9,9,18,0.5,0.5,1
"10539","N4BP2L2",36,43,79,0.544303797468354,0.455696202531646,1
"10540","N4BP3",15,19,34,0.558823529411765,0.441176470588235,1
"10541","N6AMT1",8,16,24,0.666666666666667,0.333333333333333,1
"10542","NAA10",10,8,18,0.444444444444444,0.555555555555556,1
"10543","NAA11",14,34,48,0.708333333333333,0.291666666666667,1
"10544","NAA15",36,50,86,0.581395348837209,0.418604651162791,1
"10545","NAA16",34,50,84,0.595238095238095,0.404761904761905,1
"10546","NAA20",3,7,10,0.7,0.3,1
"10547","NAA25",58,56,114,0.491228070175439,0.508771929824561,1
"10548","NAA30",8,13,21,0.619047619047619,0.380952380952381,1
"10549","NAA35",23,31,54,0.574074074074074,0.425925925925926,1
"10550","NAA38",2,2,4,0.5,0.5,1
"10551","NAA40",7,8,15,0.533333333333333,0.466666666666667,1
"10552","NAA50",3,5,8,0.625,0.375,1
"10553","NAA60",7,12,19,0.631578947368421,0.368421052631579,1
"10554","NAA80",7,11,18,0.611111111111111,0.388888888888889,1
"10555","NAAA",15,12,27,0.444444444444444,0.555555555555556,1
"10556","NAALAD2",56,82,138,0.594202898550725,0.405797101449275,0.4
"10557","NAALADL1",36,43,79,0.544303797468354,0.455696202531646,0.4
"10558","NAALADL2",46,71,117,0.606837606837607,0.393162393162393,0.4
"10559","NAB1",15,23,38,0.605263157894737,0.394736842105263,1
"10560","NAB2",17,23,40,0.575,0.425,1
"10561","NABP1",3,12,15,0.8,0.2,1
"10562","NABP2",8,12,20,0.6,0.4,1
"10563","NACA",6,14,20,0.7,0.3,1
"10564","NACA2",8,27,35,0.771428571428571,0.228571428571429,1
"10565","NACAD",0,7,7,1,0,1
"10566","NACC1",12,25,37,0.675675675675676,0.324324324324324,1
"10567","NACC2",16,18,34,0.529411764705882,0.470588235294118,1
"10568","NADK",17,28,45,0.622222222222222,0.377777777777778,1
"10569","NADK2",11,16,27,0.592592592592593,0.407407407407407,1
"10570","NADSYN1",20,41,61,0.672131147540984,0.327868852459016,1
"10571","NAE1",13,20,33,0.606060606060606,0.393939393939394,1
"10572","NAF1",19,29,48,0.604166666666667,0.395833333333333,1
"10573","NAGA",16,13,29,0.448275862068966,0.551724137931034,0.9
"10574","NAGK",8,20,28,0.714285714285714,0.285714285714286,0.23
"10575","NAGLU",16,32,48,0.666666666666667,0.333333333333333,0.62
"10576","NAGPA",13,21,34,0.617647058823529,0.382352941176471,1
"10577","NAGS",7,11,18,0.611111111111111,0.388888888888889,1
"10578","NAIF1",12,21,33,0.636363636363636,0.363636363636364,1
"10579","NAIP",10,21,31,0.67741935483871,0.32258064516129,1
"10580","NAIPP4",0,2,2,1,0,1
"10581","NALCN",171,235,406,0.578817733990148,0.421182266009852,1
"10582","NAMPT",14,26,40,0.65,0.35,1
"10583","NAMPTP1",1,3,4,0.75,0.25,1
"10584","NANOG",16,22,38,0.578947368421053,0.421052631578947,1
"10585","NANOS1",1,2,3,0.666666666666667,0.333333333333333,0.48
"10586","NANOS2",8,10,18,0.555555555555556,0.444444444444444,1
"10587","NANOS3",11,10,21,0.476190476190476,0.523809523809524,1
"10588","NANP",6,8,14,0.571428571428571,0.428571428571429,1
"10589","NANS",5,16,21,0.761904761904762,0.238095238095238,1
"10590","NAP1L1",16,28,44,0.636363636363636,0.363636363636364,1
"10591","NAP1L2",47,59,106,0.556603773584906,0.443396226415094,1
"10592","NAP1L3",51,43,94,0.457446808510638,0.542553191489362,1
"10593","NAP1L4",7,16,23,0.695652173913043,0.304347826086957,1
"10594","NAP1L5",5,9,14,0.642857142857143,0.357142857142857,1
"10595","NAPA",10,16,26,0.615384615384615,0.384615384615385,1
"10596","NAPB",11,13,24,0.541666666666667,0.458333333333333,1
"10597","NAPEPLD",17,35,52,0.673076923076923,0.326923076923077,1
"10598","NAPG",11,9,20,0.45,0.55,1
"10599","NAPRT",13,13,26,0.5,0.5,0.69
"10600","NAPSA",16,27,43,0.627906976744186,0.372093023255814,1
"10601","NARF",7,27,34,0.794117647058823,0.205882352941176,0.77
"10602","NARS1",10,25,35,0.714285714285714,0.285714285714286,0.77
"10603","NARS2",20,35,55,0.636363636363636,0.363636363636364,0.77
"10604","NASP",21,34,55,0.618181818181818,0.381818181818182,1
"10605","NAT1",8,14,22,0.636363636363636,0.363636363636364,1
"10606","NAT10",20,50,70,0.714285714285714,0.285714285714286,1
"10607","NAT14",1,3,4,0.75,0.25,1
"10608","NAT16",7,15,22,0.681818181818182,0.318181818181818,1
"10609","NAT2",11,25,36,0.694444444444444,0.305555555555556,1
"10610","NAT8",5,22,27,0.814814814814815,0.185185185185185,1
"10611","NAT8L",7,6,13,0.461538461538462,0.538461538461538,1
"10612","NAT9",2,10,12,0.833333333333333,0.166666666666667,1
"10613","NATD1",2,3,5,0.6,0.4,1
"10614","NAV1",58,88,146,0.602739726027397,0.397260273972603,1
"10615","NAV2",98,145,243,0.596707818930041,0.403292181069959,1
"10616","NAV3",247,376,623,0.603531300160514,0.396468699839486,1
"10617","NAXD",7,24,31,0.774193548387097,0.225806451612903,1
"10618","NAXE",5,8,13,0.615384615384615,0.384615384615385,1
"10619","NBAS",104,186,290,0.641379310344828,0.358620689655172,1
"10620","NBEA",142,302,444,0.68018018018018,0.31981981981982,1
"10621","NBEAL1",49,99,148,0.668918918918919,0.331081081081081,1
"10622","NBEAL2",59,104,163,0.638036809815951,0.361963190184049,1
"10623","NBEAP2",1,1,2,0.5,0.5,1
"10624","NBL1",4,8,12,0.666666666666667,0.333333333333333,1
"10625","NBN",27,46,73,0.63013698630137,0.36986301369863,1
"10626","NBPF1",22,36,58,0.620689655172414,0.379310344827586,1
"10627","NBPF10",6,5,11,0.454545454545455,0.545454545454545,1
"10628","NBPF11",24,34,58,0.586206896551724,0.413793103448276,1
"10629","NBPF14",0,1,1,1,0,1
"10630","NBPF15",13,18,31,0.580645161290323,0.419354838709677,1
"10631","NBPF20",3,7,10,0.7,0.3,1
"10632","NBPF25P",15,37,52,0.711538461538462,0.288461538461538,1
"10633","NBPF26",13,21,34,0.617647058823529,0.382352941176471,1
"10634","NBPF3",24,20,44,0.454545454545455,0.545454545454545,1
"10635","NBPF4",0,1,1,1,0,1
"10636","NBPF6",0,1,1,1,0,1
"10637","NBPF7",28,40,68,0.588235294117647,0.411764705882353,1
"10638","NBPF9",9,13,22,0.590909090909091,0.409090909090909,1
"10639","NBR1",30,43,73,0.589041095890411,0.410958904109589,1
"10640","NBR2",3,4,7,0.571428571428571,0.428571428571429,1
"10641","NCALD",10,15,25,0.6,0.4,1
"10642","NCAM1",58,98,156,0.628205128205128,0.371794871794872,1
"10643","NCAM2",77,151,228,0.662280701754386,0.337719298245614,1
"10644","NCAN",76,127,203,0.625615763546798,0.374384236453202,1
"10645","NCAPD2",42,61,103,0.592233009708738,0.407766990291262,1
"10646","NCAPD3",59,75,134,0.559701492537313,0.440298507462687,1
"10647","NCAPG",28,43,71,0.605633802816901,0.394366197183099,1
"10648","NCAPG2",35,61,96,0.635416666666667,0.364583333333333,1
"10649","NCAPH",22,43,65,0.661538461538462,0.338461538461538,1
"10650","NCAPH2",8,34,42,0.80952380952381,0.19047619047619,1
"10651","NCBP1",23,31,54,0.574074074074074,0.425925925925926,1
"10652","NCBP2",10,9,19,0.473684210526316,0.526315789473684,1
"10653","NCBP2L",13,10,23,0.434782608695652,0.565217391304348,1
"10654","NCBP3",8,16,24,0.666666666666667,0.333333333333333,1
"10655","NCCRP1",11,19,30,0.633333333333333,0.366666666666667,1
"10656","NCDN",25,36,61,0.590163934426229,0.409836065573771,1
"10657","NCEH1",15,28,43,0.651162790697674,0.348837209302326,1
"10658","NCF1",12,9,21,0.428571428571429,0.571428571428571,1
"10659","NCF1C",0,5,5,1,0,1
"10660","NCF2",28,48,76,0.631578947368421,0.368421052631579,1
"10661","NCF4",14,22,36,0.611111111111111,0.388888888888889,1
"10662","NCK1",15,17,32,0.53125,0.46875,1
"10663","NCK2",21,33,54,0.611111111111111,0.388888888888889,1
"10664","NCKAP1",41,59,100,0.59,0.41,1
"10665","NCKAP1L",74,135,209,0.645933014354067,0.354066985645933,1
"10666","NCKAP5",115,228,343,0.664723032069971,0.335276967930029,1
"10667","NCKAP5L",41,75,116,0.646551724137931,0.353448275862069,1
"10668","NCKIPSD",21,25,46,0.543478260869565,0.456521739130435,1
"10669","NCL",17,27,44,0.613636363636364,0.386363636363636,1
"10670","NCLN",9,21,30,0.7,0.3,1
"10671","NCMAP",4,6,10,0.6,0.4,1
"10672","NCOA1",56,82,138,0.594202898550725,0.405797101449275,1
"10673","NCOA2",52,105,157,0.668789808917197,0.331210191082803,1
"10674","NCOA3",52,95,147,0.646258503401361,0.353741496598639,1
"10675","NCOA4",30,28,58,0.482758620689655,0.517241379310345,1
"10676","NCOA5",24,48,72,0.666666666666667,0.333333333333333,1
"10677","NCOA6",65,130,195,0.666666666666667,0.333333333333333,1
"10678","NCOA7",34,49,83,0.590361445783133,0.409638554216867,1
"10679","NCOR1",97,166,263,0.631178707224335,0.368821292775665,1
"10680","NCOR2",91,135,226,0.597345132743363,0.402654867256637,1
"10681","NCR1",22,48,70,0.685714285714286,0.314285714285714,1
"10682","NCR2",12,24,36,0.666666666666667,0.333333333333333,1
"10683","NCR3",7,11,18,0.611111111111111,0.388888888888889,1
"10684","NCS1",7,10,17,0.588235294117647,0.411764705882353,1
"10685","NCSTN",32,47,79,0.594936708860759,0.40506329113924,1
"10686","NDC1",23,26,49,0.530612244897959,0.469387755102041,1
"10687","NDC80",20,34,54,0.62962962962963,0.37037037037037,1
"10688","NDE1",19,28,47,0.595744680851064,0.404255319148936,1
"10689","NDEL1",9,13,22,0.590909090909091,0.409090909090909,1
"10690","NDFIP1",10,12,22,0.545454545454545,0.454545454545455,1
"10691","NDFIP2",5,8,13,0.615384615384615,0.384615384615385,1
"10692","NDN",34,70,104,0.673076923076923,0.326923076923077,1
"10693","NDNF",34,60,94,0.638297872340426,0.361702127659574,1
"10694","NDOR1",21,22,43,0.511627906976744,0.488372093023256,1
"10695","NDP",5,2,7,0.285714285714286,0.714285714285714,1
"10696","NDRG1",11,19,30,0.633333333333333,0.366666666666667,1
"10697","NDRG2",10,24,34,0.705882352941177,0.294117647058824,1
"10698","NDRG3",8,20,28,0.714285714285714,0.285714285714286,1
"10699","NDRG4",20,21,41,0.51219512195122,0.48780487804878,1
"10700","NDST1",29,34,63,0.53968253968254,0.46031746031746,1
"10701","NDST2",24,37,61,0.60655737704918,0.39344262295082,1
"10702","NDST3",58,87,145,0.6,0.4,1
"10703","NDST4",76,187,263,0.711026615969582,0.288973384030418,1
"10704","NDUFA1",4,2,6,0.333333333333333,0.666666666666667,1
"10705","NDUFA10",21,26,47,0.553191489361702,0.446808510638298,1
"10706","NDUFA11",3,0,3,0,1,1
"10707","NDUFA12",5,9,14,0.642857142857143,0.357142857142857,1
"10708","NDUFA13",5,6,11,0.545454545454545,0.454545454545455,1
"10709","NDUFA2",0,3,3,1,0,1
"10710","NDUFA3",4,5,9,0.555555555555556,0.444444444444444,1
"10711","NDUFA4",6,6,12,0.5,0.5,1
"10712","NDUFA4L2",2,3,5,0.6,0.4,1
"10713","NDUFA5",3,6,9,0.666666666666667,0.333333333333333,1
"10714","NDUFA6",2,2,4,0.5,0.5,1
"10715","NDUFA7",6,4,10,0.4,0.6,1
"10716","NDUFA8",3,13,16,0.8125,0.1875,1
"10717","NDUFA9",12,23,35,0.657142857142857,0.342857142857143,1
"10718","NDUFAB1",3,7,10,0.7,0.3,1
"10719","NDUFAF1",7,22,29,0.758620689655172,0.241379310344828,1
"10720","NDUFAF2",4,16,20,0.8,0.2,1
"10721","NDUFAF3",9,9,18,0.5,0.5,1
"10722","NDUFAF4",7,10,17,0.588235294117647,0.411764705882353,1
"10723","NDUFAF5",15,20,35,0.571428571428571,0.428571428571429,1
"10724","NDUFAF6",13,17,30,0.566666666666667,0.433333333333333,1
"10725","NDUFAF7",15,22,37,0.594594594594595,0.405405405405405,1
"10726","NDUFB1",0,2,2,1,0,1
"10727","NDUFB10",2,11,13,0.846153846153846,0.153846153846154,1
"10728","NDUFB11",11,2,13,0.153846153846154,0.846153846153846,1
"10729","NDUFB2",5,6,11,0.545454545454545,0.454545454545455,1
"10730","NDUFB3",10,6,16,0.375,0.625,1
"10731","NDUFB4",4,9,13,0.692307692307692,0.307692307692308,1
"10732","NDUFB5",11,15,26,0.576923076923077,0.423076923076923,1
"10733","NDUFB6",3,9,12,0.75,0.25,1
"10734","NDUFB7",4,3,7,0.428571428571429,0.571428571428571,1
"10735","NDUFB8",4,10,14,0.714285714285714,0.285714285714286,1
"10736","NDUFB9",6,10,16,0.625,0.375,1
"10737","NDUFC1",0,5,5,1,0,1
"10738","NDUFC2",7,8,15,0.533333333333333,0.466666666666667,1
"10739","NDUFS1",33,35,68,0.514705882352941,0.485294117647059,1
"10740","NDUFS2",11,25,36,0.694444444444444,0.305555555555556,1
"10741","NDUFS3",11,8,19,0.421052631578947,0.578947368421053,1
"10742","NDUFS4",8,10,18,0.555555555555556,0.444444444444444,1
"10743","NDUFS5",6,8,14,0.571428571428571,0.428571428571429,1
"10744","NDUFS6",7,10,17,0.588235294117647,0.411764705882353,1
"10745","NDUFS7",7,13,20,0.65,0.35,1
"10746","NDUFS8",12,7,19,0.368421052631579,0.631578947368421,1
"10747","NDUFV1",13,21,34,0.617647058823529,0.382352941176471,1
"10748","NDUFV2",4,15,19,0.789473684210526,0.210526315789474,1
"10749","NDUFV3",2,3,5,0.6,0.4,1
"10750","NEB",291,495,786,0.629770992366412,0.370229007633588,1
"10751","NEBL",67,130,197,0.65989847715736,0.34010152284264,1
"10752","NECAB1",13,22,35,0.628571428571429,0.371428571428571,1
"10753","NECAB2",8,16,24,0.666666666666667,0.333333333333333,1
"10754","NECAB3",7,16,23,0.695652173913043,0.304347826086957,1
"10755","NECAP1",12,15,27,0.555555555555556,0.444444444444444,1
"10756","NECAP2",5,11,16,0.6875,0.3125,1
"10757","NECTIN1",17,39,56,0.696428571428571,0.303571428571429,1
"10758","NECTIN2",13,28,41,0.682926829268293,0.317073170731707,1
"10759","NECTIN3",23,32,55,0.581818181818182,0.418181818181818,1
"10760","NECTIN4",24,49,73,0.671232876712329,0.328767123287671,1
"10761","NEDD1",18,45,63,0.714285714285714,0.285714285714286,1
"10762","NEDD4",52,61,113,0.539823008849557,0.460176991150442,1
"10763","NEDD4L",39,48,87,0.551724137931034,0.448275862068966,1
"10764","NEDD8",4,5,9,0.555555555555556,0.444444444444444,1
"10765","NEDD9",33,44,77,0.571428571428571,0.428571428571429,1
"10766","NEFH",26,57,83,0.686746987951807,0.313253012048193,1
"10767","NEFL",25,45,70,0.642857142857143,0.357142857142857,1
"10768","NEFM",42,78,120,0.65,0.35,1
"10769","NEGR1",26,47,73,0.643835616438356,0.356164383561644,1
"10770","NEIL1",14,23,37,0.621621621621622,0.378378378378378,1
"10771","NEIL2",12,15,27,0.555555555555556,0.444444444444444,1
"10772","NEIL3",28,28,56,0.5,0.5,1
"10773","NEK1",41,46,87,0.528735632183908,0.471264367816092,1
"10774","NEK10",44,94,138,0.681159420289855,0.318840579710145,1
"10775","NEK11",34,47,81,0.580246913580247,0.419753086419753,1
"10776","NEK2",19,20,39,0.512820512820513,0.487179487179487,1
"10777","NEK3",11,17,28,0.607142857142857,0.392857142857143,1
"10778","NEK4",21,35,56,0.625,0.375,1
"10779","NEK5",40,63,103,0.611650485436893,0.388349514563107,1
"10780","NEK6",14,12,26,0.461538461538462,0.538461538461538,1
"10781","NEK7",8,17,25,0.68,0.32,1
"10782","NEK8",33,35,68,0.514705882352941,0.485294117647059,1
"10783","NEK9",19,33,52,0.634615384615385,0.365384615384615,1
"10784","NELFA",21,22,43,0.511627906976744,0.488372093023256,1
"10785","NELFB",17,31,48,0.645833333333333,0.354166666666667,1
"10786","NELFCD",16,22,38,0.578947368421053,0.421052631578947,1
"10787","NELFE",26,30,56,0.535714285714286,0.464285714285714,1
"10788","NELL1",76,132,208,0.634615384615385,0.365384615384615,1
"10789","NELL2",71,101,172,0.587209302325581,0.412790697674419,1
"10790","NEMF",41,49,90,0.544444444444444,0.455555555555556,1
"10791","NEMP1",11,18,29,0.620689655172414,0.379310344827586,1
"10792","NEMP2",0,3,3,1,0,1
"10793","NENF",5,7,12,0.583333333333333,0.416666666666667,1
"10794","NEO1",52,84,136,0.617647058823529,0.382352941176471,1
"10795","NEPRO",14,33,47,0.702127659574468,0.297872340425532,1
"10796","NES",85,119,204,0.583333333333333,0.416666666666667,1
"10797","NET1",18,23,41,0.560975609756098,0.439024390243902,1
"10798","NETO1",69,104,173,0.601156069364162,0.398843930635838,1
"10799","NETO2",23,40,63,0.634920634920635,0.365079365079365,1
"10800","NEU1",18,21,39,0.538461538461538,0.461538461538462,1
"10801","NEU2",19,54,73,0.73972602739726,0.26027397260274,1
"10802","NEU3",17,16,33,0.484848484848485,0.515151515151515,1
"10803","NEU4",18,39,57,0.684210526315789,0.315789473684211,1
"10804","NEURL1",13,34,47,0.723404255319149,0.276595744680851,1
"10805","NEURL1B",0,1,1,1,0,1
"10806","NEURL2",6,18,24,0.75,0.25,1
"10807","NEURL3",5,6,11,0.545454545454545,0.454545454545455,1
"10808","NEURL4",67,55,122,0.450819672131148,0.549180327868853,1
"10809","NEUROD1",29,58,87,0.666666666666667,0.333333333333333,1
"10810","NEUROD2",12,14,26,0.538461538461538,0.461538461538462,1
"10811","NEUROD4",31,70,101,0.693069306930693,0.306930693069307,1
"10812","NEUROD6",30,54,84,0.642857142857143,0.357142857142857,1
"10813","NEUROG1",12,11,23,0.478260869565217,0.521739130434783,1
"10814","NEUROG2",12,14,26,0.538461538461538,0.461538461538462,1
"10815","NEUROG3",8,18,26,0.692307692307692,0.307692307692308,1
"10816","NEXMIF",144,187,331,0.564954682779456,0.435045317220544,1
"10817","NEXN",29,51,80,0.6375,0.3625,1
"10818","NF1",207,341,548,0.622262773722628,0.377737226277372,1
"10819","NF2",33,66,99,0.666666666666667,0.333333333333333,1
"10820","NFAM1",5,14,19,0.736842105263158,0.263157894736842,1
"10821","NFASC",92,139,231,0.601731601731602,0.398268398268398,1
"10822","NFAT5",46,69,115,0.6,0.4,1
"10823","NFATC1",44,63,107,0.588785046728972,0.411214953271028,1
"10824","NFATC2",60,82,142,0.577464788732394,0.422535211267606,1
"10825","NFATC2IP",12,20,32,0.625,0.375,1
"10826","NFATC3",37,50,87,0.574712643678161,0.425287356321839,1
"10827","NFATC4",54,63,117,0.538461538461538,0.461538461538462,1
"10828","NFE2",22,40,62,0.645161290322581,0.354838709677419,1
"10829","NFE2L1",32,30,62,0.483870967741935,0.516129032258065,1
"10830","NFE2L2",60,131,191,0.68586387434555,0.31413612565445,1
"10831","NFE2L3",26,45,71,0.633802816901408,0.366197183098592,1
"10832","NFIA",26,41,67,0.611940298507463,0.388059701492537,1
"10833","NFIB",21,40,61,0.655737704918033,0.344262295081967,1
"10834","NFIC",19,30,49,0.612244897959184,0.387755102040816,1
"10835","NFIL3",13,21,34,0.617647058823529,0.382352941176471,1
"10836","NFIX",11,25,36,0.694444444444444,0.305555555555556,1
"10837","NFKB1",28,34,62,0.548387096774194,0.451612903225806,1
"10838","NFKB2",26,27,53,0.509433962264151,0.490566037735849,1
"10839","NFKBIA",10,24,34,0.705882352941177,0.294117647058824,1
"10840","NFKBIB",9,17,26,0.653846153846154,0.346153846153846,1
"10841","NFKBID",12,17,29,0.586206896551724,0.413793103448276,1
"10842","NFKBIE",8,18,26,0.692307692307692,0.307692307692308,1
"10843","NFKBIL1",11,14,25,0.56,0.44,1
"10844","NFKBIZ",29,41,70,0.585714285714286,0.414285714285714,1
"10845","NFRKB",34,49,83,0.590361445783133,0.409638554216867,1
"10846","NFS1",14,18,32,0.5625,0.4375,1
"10847","NFU1",8,12,20,0.6,0.4,1
"10848","NFX1",21,50,71,0.704225352112676,0.295774647887324,1
"10849","NFXL1",23,65,88,0.738636363636364,0.261363636363636,1
"10850","NFYA",9,14,23,0.608695652173913,0.391304347826087,1
"10851","NFYB",7,12,19,0.631578947368421,0.368421052631579,1
"10852","NFYC",12,20,32,0.625,0.375,1
"10853","NGB",5,10,15,0.666666666666667,0.333333333333333,1
"10854","NGDN",11,22,33,0.666666666666667,0.333333333333333,1
"10855","NGEF",21,49,70,0.7,0.3,1
"10856","NGF",25,30,55,0.545454545454545,0.454545454545455,1
"10857","NGFR",14,34,48,0.708333333333333,0.291666666666667,1
"10858","NGLY1",20,39,59,0.661016949152542,0.338983050847458,1
"10859","NGRN",8,12,20,0.6,0.4,1
"10860","NHEJ1",8,13,21,0.619047619047619,0.380952380952381,1
"10861","NHLH1",6,10,16,0.625,0.375,1
"10862","NHLH2",6,8,14,0.571428571428571,0.428571428571429,1
"10863","NHLRC1",11,28,39,0.717948717948718,0.282051282051282,1
"10864","NHLRC2",27,30,57,0.526315789473684,0.473684210526316,1
"10865","NHLRC3",18,15,33,0.454545454545455,0.545454545454545,1
"10866","NHLRC4",2,11,13,0.846153846153846,0.153846153846154,1
"10867","NHP2",3,10,13,0.769230769230769,0.230769230769231,1
"10868","NHS",94,70,164,0.426829268292683,0.573170731707317,1
"10869","NHSL1",0,3,3,1,0,1
"10870","NHSL2",27,34,61,0.557377049180328,0.442622950819672,1
"10871","NIBAN1",41,80,121,0.661157024793388,0.338842975206612,1
"10872","NIBAN2",35,36,71,0.507042253521127,0.492957746478873,1
"10873","NIBAN3",22,41,63,0.650793650793651,0.349206349206349,1
"10874","NICN1",4,10,14,0.714285714285714,0.285714285714286,1
"10875","NID1",73,108,181,0.596685082872928,0.403314917127072,1
"10876","NID2",66,137,203,0.67487684729064,0.32512315270936,1
"10877","NIF3L1",8,16,24,0.666666666666667,0.333333333333333,1
"10878","NIFK",9,21,30,0.7,0.3,1
"10879","NIM1K",23,40,63,0.634920634920635,0.365079365079365,1
"10880","NIN",72,97,169,0.57396449704142,0.42603550295858,1
"10881","NINJ1",8,7,15,0.466666666666667,0.533333333333333,1
"10882","NINJ2",2,8,10,0.8,0.2,1
"10883","NINL",62,99,161,0.614906832298137,0.385093167701863,1
"10884","NIP7",7,5,12,0.416666666666667,0.583333333333333,1
"10885","NIPA1",15,12,27,0.444444444444444,0.555555555555556,1
"10886","NIPA2",20,26,46,0.565217391304348,0.434782608695652,1
"10887","NIPAL1",6,24,30,0.8,0.2,1
"10888","NIPAL2",7,15,22,0.681818181818182,0.318181818181818,1
"10889","NIPAL3",15,25,40,0.625,0.375,1
"10890","NIPAL4",24,32,56,0.571428571428571,0.428571428571429,1
"10891","NIPBL",134,189,323,0.585139318885449,0.414860681114551,1
"10892","NIPSNAP1",4,20,24,0.833333333333333,0.166666666666667,1
"10893","NIPSNAP2",13,17,30,0.566666666666667,0.433333333333333,1
"10894","NIPSNAP3A",6,9,15,0.6,0.4,1
"10895","NIPSNAP3B",5,11,16,0.6875,0.3125,1
"10896","NISCH",41,73,114,0.640350877192982,0.359649122807018,1
"10897","NIT1",12,18,30,0.6,0.4,1
"10898","NIT2",13,19,32,0.59375,0.40625,1
"10899","NKAIN1",2,9,11,0.818181818181818,0.181818181818182,1
"10900","NKAIN2",11,34,45,0.755555555555556,0.244444444444444,1
"10901","NKAIN3",11,31,42,0.738095238095238,0.261904761904762,1
"10902","NKAIN4",4,10,14,0.714285714285714,0.285714285714286,1
"10903","NKAP",26,20,46,0.434782608695652,0.565217391304348,1
"10904","NKAPD1",24,19,43,0.441860465116279,0.558139534883721,1
"10905","NKAPL",34,45,79,0.569620253164557,0.430379746835443,1
"10906","NKD1",24,41,65,0.630769230769231,0.369230769230769,1
"10907","NKD2",19,28,47,0.595744680851064,0.404255319148936,1
"10908","NKG7",10,20,30,0.666666666666667,0.333333333333333,1
"10909","NKIRAS1",6,10,16,0.625,0.375,1
"10910","NKIRAS2",6,13,19,0.684210526315789,0.315789473684211,1
"10911","NKPD1",14,15,29,0.517241379310345,0.482758620689655,1
"10912","NKRF",29,13,42,0.30952380952381,0.69047619047619,1
"10913","NKTR",55,73,128,0.5703125,0.4296875,1
"10914","NKX2-1",12,24,36,0.666666666666667,0.333333333333333,1
"10915","NKX2-2",23,51,74,0.689189189189189,0.310810810810811,1
"10916","NKX2-3",8,13,21,0.619047619047619,0.380952380952381,1
"10917","NKX2-4",1,10,11,0.909090909090909,0.0909090909090909,1
"10918","NKX2-5",14,27,41,0.658536585365854,0.341463414634146,1
"10919","NKX2-8",2,6,8,0.75,0.25,1
"10920","NKX3-1",9,17,26,0.653846153846154,0.346153846153846,1
"10921","NKX3-2",8,14,22,0.636363636363636,0.363636363636364,1
"10922","NKX6-1",24,18,42,0.428571428571429,0.571428571428571,1
"10923","NKX6-2",9,8,17,0.470588235294118,0.529411764705882,1
"10924","NKX6-3",2,2,4,0.5,0.5,1
"10925","NLE1",12,21,33,0.636363636363636,0.363636363636364,1
"10926","NLGN1",83,106,189,0.560846560846561,0.439153439153439,1
"10927","NLGN2",23,33,56,0.589285714285714,0.410714285714286,1
"10928","NLGN3",66,22,88,0.25,0.75,1
"10929","NLGN4X",127,97,224,0.433035714285714,0.566964285714286,1
"10930","NLGN4Y",3,72,75,0.96,0.04,1
"10931","NLK",21,28,49,0.571428571428571,0.428571428571429,1
"10932","NLN",18,42,60,0.7,0.3,1
"10933","NLRC3",38,68,106,0.641509433962264,0.358490566037736,1
"10934","NLRC4",76,75,151,0.496688741721854,0.503311258278146,1
"10935","NLRC5",110,109,219,0.497716894977169,0.502283105022831,1
"10936","NLRP1",68,97,165,0.587878787878788,0.412121212121212,1
"10937","NLRP10",51,103,154,0.668831168831169,0.331168831168831,1
"10938","NLRP11",82,125,207,0.603864734299517,0.396135265700483,1
"10939","NLRP12",99,155,254,0.610236220472441,0.389763779527559,1
"10940","NLRP13",97,171,268,0.638059701492537,0.361940298507463,1
"10941","NLRP14",64,156,220,0.709090909090909,0.290909090909091,1
"10942","NLRP2",75,131,206,0.635922330097087,0.364077669902913,1
"10943","NLRP3",112,185,297,0.622895622895623,0.377104377104377,1
"10944","NLRP4",102,175,277,0.631768953068592,0.368231046931408,1
"10945","NLRP5",110,176,286,0.615384615384615,0.384615384615385,1
"10946","NLRP6",27,36,63,0.571428571428571,0.428571428571429,1
"10947","NLRP7",89,163,252,0.646825396825397,0.353174603174603,1
"10948","NLRP8",105,171,276,0.619565217391304,0.380434782608696,1
"10949","NLRP9",70,139,209,0.665071770334928,0.334928229665072,1
"10950","NLRX1",44,53,97,0.54639175257732,0.45360824742268,1
"10951","NMB",1,2,3,0.666666666666667,0.333333333333333,1
"10952","NMBR",13,45,58,0.775862068965517,0.224137931034483,1
"10953","NMD3",20,42,62,0.67741935483871,0.32258064516129,1
"10954","NME1",3,4,7,0.571428571428571,0.428571428571429,1
"10955","NME1-NME2",3,6,9,0.666666666666667,0.333333333333333,1
"10956","NME3",5,4,9,0.444444444444444,0.555555555555556,1
"10957","NME4",5,3,8,0.375,0.625,1
"10958","NME5",9,9,18,0.5,0.5,1
"10959","NME6",6,10,16,0.625,0.375,1
"10960","NME7",17,34,51,0.666666666666667,0.333333333333333,1
"10961","NME8",56,91,147,0.619047619047619,0.380952380952381,1
"10962","NME9",14,20,34,0.588235294117647,0.411764705882353,1
"10963","NMI",10,17,27,0.62962962962963,0.37037037037037,1
"10964","NMNAT1",11,14,25,0.56,0.44,1
"10965","NMNAT2",16,18,34,0.529411764705882,0.470588235294118,1
"10966","NMNAT3",10,19,29,0.655172413793103,0.344827586206897,1
"10967","NMRAL1",11,9,20,0.45,0.55,1
"10968","NMRK1",8,10,18,0.555555555555556,0.444444444444444,1
"10969","NMRK2",12,19,31,0.612903225806452,0.387096774193548,1
"10970","NMS",19,22,41,0.536585365853659,0.463414634146341,1
"10971","NMT1",18,29,47,0.617021276595745,0.382978723404255,1
"10972","NMT2",14,35,49,0.714285714285714,0.285714285714286,1
"10973","NMU",5,10,15,0.666666666666667,0.333333333333333,1
"10974","NMUR1",15,38,53,0.716981132075472,0.283018867924528,1
"10975","NMUR2",37,74,111,0.666666666666667,0.333333333333333,1
"10976","NNAT",3,5,8,0.625,0.375,1
"10977","NNMT",9,40,49,0.816326530612245,0.183673469387755,1
"10978","NNT",35,53,88,0.602272727272727,0.397727272727273,1
"10979","NOA1",16,30,46,0.652173913043478,0.347826086956522,1
"10980","NOB1",16,13,29,0.448275862068966,0.551724137931034,1
"10981","NOBOX",30,80,110,0.727272727272727,0.272727272727273,1
"10982","NOC2L",21,26,47,0.553191489361702,0.446808510638298,1
"10983","NOC3L",30,37,67,0.552238805970149,0.447761194029851,1
"10984","NOC4L",20,32,52,0.615384615384615,0.384615384615385,1
"10985","NOCT",7,17,24,0.708333333333333,0.291666666666667,1
"10986","NOD1",30,47,77,0.61038961038961,0.38961038961039,1
"10987","NOD2",53,83,136,0.610294117647059,0.389705882352941,1
"10988","NODAL",10,14,24,0.583333333333333,0.416666666666667,1
"10989","NOG",7,9,16,0.5625,0.4375,1
"10990","NOL10",12,17,29,0.586206896551724,0.413793103448276,1
"10991","NOL11",21,30,51,0.588235294117647,0.411764705882353,1
"10992","NOL12",6,15,21,0.714285714285714,0.285714285714286,1
"10993","NOL3",3,7,10,0.7,0.3,1
"10994","NOL4",54,102,156,0.653846153846154,0.346153846153846,1
"10995","NOL4L",11,27,38,0.710526315789474,0.289473684210526,1
"10996","NOL6",52,65,117,0.555555555555556,0.444444444444444,1
"10997","NOL7",5,6,11,0.545454545454545,0.454545454545455,1
"10998","NOL8",37,49,86,0.569767441860465,0.430232558139535,1
"10999","NOL9",14,31,45,0.688888888888889,0.311111111111111,1
"11000","NOLC1",18,43,61,0.704918032786885,0.295081967213115,1
"11001","NOM1",29,49,78,0.628205128205128,0.371794871794872,1
"11002","NOMO1",43,58,101,0.574257425742574,0.425742574257426,1
"11003","NOMO2",12,19,31,0.612903225806452,0.387096774193548,1
"11004","NOMO3",11,15,26,0.576923076923077,0.423076923076923,1
"11005","NONO",42,25,67,0.373134328358209,0.626865671641791,1
"11006","NOP10",2,8,10,0.8,0.2,1
"11007","NOP14",24,40,64,0.625,0.375,1
"11008","NOP16",3,9,12,0.75,0.25,1
"11009","NOP2",30,43,73,0.589041095890411,0.410958904109589,1
"11010","NOP53",10,21,31,0.67741935483871,0.32258064516129,1
"11011","NOP56",18,50,68,0.735294117647059,0.264705882352941,1
"11012","NOP58",15,29,44,0.659090909090909,0.340909090909091,1
"11013","NOP9",15,22,37,0.594594594594595,0.405405405405405,1
"11014","NOS1",134,208,342,0.608187134502924,0.391812865497076,1
"11015","NOS1AP",38,51,89,0.573033707865168,0.426966292134831,1
"11016","NOS2",53,79,132,0.598484848484849,0.401515151515151,1
"11017","NOS3",58,89,147,0.605442176870748,0.394557823129252,1
"11018","NOSIP",13,16,29,0.551724137931034,0.448275862068966,1
"11019","NOSTRIN",14,37,51,0.725490196078431,0.274509803921569,1
"11020","NOTCH1",128,195,323,0.603715170278638,0.396284829721362,1
"11021","NOTCH2",79,140,219,0.639269406392694,0.360730593607306,1
"11022","NOTCH2NLA",0,1,1,1,0,1
"11023","NOTCH3",86,129,215,0.6,0.4,1
"11024","NOTCH4",106,172,278,0.618705035971223,0.381294964028777,1
"11025","NOTUM",11,23,34,0.676470588235294,0.323529411764706,1
"11026","NOVA1",52,84,136,0.617647058823529,0.382352941176471,1
"11027","NOVA2",14,17,31,0.548387096774194,0.451612903225806,1
"11028","NOX1",39,22,61,0.360655737704918,0.639344262295082,1
"11029","NOX3",32,64,96,0.666666666666667,0.333333333333333,1
"11030","NOX4",33,75,108,0.694444444444444,0.305555555555556,1
"11031","NOX5",38,55,93,0.591397849462366,0.408602150537634,1
"11032","NOXA1",11,10,21,0.476190476190476,0.523809523809524,1
"11033","NOXO1",5,10,15,0.666666666666667,0.333333333333333,1
"11034","NOXRED1",14,19,33,0.575757575757576,0.424242424242424,1
"11035","NPAP1",159,316,475,0.665263157894737,0.334736842105263,1
"11036","NPAS1",14,17,31,0.548387096774194,0.451612903225806,1
"11037","NPAS2",23,60,83,0.72289156626506,0.27710843373494,1
"11038","NPAS3",56,77,133,0.578947368421053,0.421052631578947,1
"11039","NPAS4",45,124,169,0.733727810650888,0.266272189349112,1
"11040","NPAT",61,71,132,0.537878787878788,0.462121212121212,1
"11041","NPB",0,3,3,1,0,1
"11042","NPBWR1",23,27,50,0.54,0.46,1
"11043","NPBWR2",24,33,57,0.578947368421053,0.421052631578947,1
"11044","NPC1",45,76,121,0.628099173553719,0.371900826446281,1
"11045","NPC1L1",51,102,153,0.666666666666667,0.333333333333333,1
"11046","NPC2",2,5,7,0.714285714285714,0.285714285714286,1
"11047","NPDC1",5,7,12,0.583333333333333,0.416666666666667,1
"11048","NPEPL1",17,23,40,0.575,0.425,1
"11049","NPEPPS",15,28,43,0.651162790697674,0.348837209302326,1
"11050","NPFF",2,7,9,0.777777777777778,0.222222222222222,1
"11051","NPFFR1",7,17,24,0.708333333333333,0.291666666666667,1
"11052","NPFFR2",47,69,116,0.594827586206897,0.405172413793103,1
"11053","NPHP1",26,52,78,0.666666666666667,0.333333333333333,1
"11054","NPHP3",37,69,106,0.650943396226415,0.349056603773585,1
"11055","NPHP4",41,52,93,0.559139784946237,0.440860215053763,1
"11056","NPHS1",64,111,175,0.634285714285714,0.365714285714286,1
"11057","NPHS2",19,45,64,0.703125,0.296875,1
"11058","NPIPA1",6,2,8,0.25,0.75,1
"11059","NPIPB15",8,23,31,0.741935483870968,0.258064516129032,1
"11060","NPIPB3",0,4,4,1,0,1
"11061","NPIPB7",0,2,2,1,0,1
"11062","NPL",6,17,23,0.739130434782609,0.260869565217391,1
"11063","NPLOC4",16,39,55,0.709090909090909,0.290909090909091,1
"11064","NPM1",16,17,33,0.515151515151515,0.484848484848485,1
"11065","NPM2",10,12,22,0.545454545454545,0.454545454545455,1
"11066","NPM3",11,7,18,0.388888888888889,0.611111111111111,1
"11067","NPNT",26,46,72,0.638888888888889,0.361111111111111,1
"11068","NPPA",9,18,27,0.666666666666667,0.333333333333333,1
"11069","NPPB",11,13,24,0.541666666666667,0.458333333333333,1
"11070","NPPC",2,4,6,0.666666666666667,0.333333333333333,1
"11071","NPR1",34,67,101,0.663366336633663,0.336633663366337,1
"11072","NPR2",51,53,104,0.509615384615385,0.490384615384615,1
"11073","NPR3",39,51,90,0.566666666666667,0.433333333333333,1
"11074","NPRL2",9,14,23,0.608695652173913,0.391304347826087,1
"11075","NPRL3",14,20,34,0.588235294117647,0.411764705882353,1
"11076","NPS",3,24,27,0.888888888888889,0.111111111111111,1
"11077","NPSR1",42,62,104,0.596153846153846,0.403846153846154,1
"11078","NPTN",9,21,30,0.7,0.3,1
"11079","NPTX1",18,27,45,0.6,0.4,1
"11080","NPTX2",24,45,69,0.652173913043478,0.347826086956522,1
"11081","NPTXR",17,27,44,0.613636363636364,0.386363636363636,1
"11082","NPVF",10,17,27,0.62962962962963,0.37037037037037,1
"11083","NPW",0,3,3,1,0,1
"11084","NPY",12,15,27,0.555555555555556,0.444444444444444,1
"11085","NPY1R",32,59,91,0.648351648351648,0.351648351648352,1
"11086","NPY2R",38,70,108,0.648148148148148,0.351851851851852,1
"11087","NPY4R",13,12,25,0.48,0.52,1
"11088","NPY5R",31,80,111,0.720720720720721,0.279279279279279,1
"11089","NQO1",2,8,10,0.8,0.2,1
"11090","NQO2",9,11,20,0.55,0.45,1
"11091","NR0B1",47,24,71,0.338028169014085,0.661971830985915,1
"11092","NR0B2",6,19,25,0.76,0.24,1
"11093","NR1D1",18,25,43,0.581395348837209,0.418604651162791,1
"11094","NR1D2",18,38,56,0.678571428571429,0.321428571428571,1
"11095","NR1H2",17,26,43,0.604651162790698,0.395348837209302,1
"11096","NR1H3",24,24,48,0.5,0.5,1
"11097","NR1H4",43,61,104,0.586538461538462,0.413461538461538,1
"11098","NR1I2",15,27,42,0.642857142857143,0.357142857142857,1
"11099","NR1I3",17,27,44,0.613636363636364,0.386363636363636,1
"11100","NR2C1",21,25,46,0.543478260869565,0.456521739130435,1
"11101","NR2C2",20,33,53,0.622641509433962,0.377358490566038,1
"11102","NR2C2AP",5,10,15,0.666666666666667,0.333333333333333,1
"11103","NR2E1",26,22,48,0.458333333333333,0.541666666666667,1
"11104","NR2E3",10,18,28,0.642857142857143,0.357142857142857,1
"11105","NR2F1",14,36,50,0.72,0.28,1
"11106","NR2F2",17,33,50,0.66,0.34,1
"11107","NR2F6",14,4,18,0.222222222222222,0.777777777777778,1
"11108","NR3C1",24,42,66,0.636363636363636,0.363636363636364,1
"11109","NR3C2",41,86,127,0.677165354330709,0.322834645669291,1
"11110","NR4A1",19,30,49,0.612244897959184,0.387755102040816,1
"11111","NR4A2",41,50,91,0.549450549450549,0.450549450549451,1
"11112","NR4A3",17,37,54,0.685185185185185,0.314814814814815,1
"11113","NR5A1",15,29,44,0.659090909090909,0.340909090909091,1
"11114","NR5A2",35,66,101,0.653465346534653,0.346534653465347,1
"11115","NR6A1",16,20,36,0.555555555555556,0.444444444444444,1
"11116","NRAP",95,142,237,0.59915611814346,0.40084388185654,1
"11117","NRARP",3,6,9,0.666666666666667,0.333333333333333,0.77
"11118","NRAS",103,153,256,0.59765625,0.40234375,1
"11119","NRBF2",5,11,16,0.6875,0.3125,1
"11120","NRBP1",24,25,49,0.510204081632653,0.489795918367347,1
"11121","NRBP2",5,7,12,0.583333333333333,0.416666666666667,1
"11122","NRCAM",76,87,163,0.533742331288344,0.466257668711656,1
"11123","NRDC",49,71,120,0.591666666666667,0.408333333333333,1
"11124","NRDE2",42,64,106,0.60377358490566,0.39622641509434,1
"11125","NREP",6,10,16,0.625,0.375,1
"11126","NRF1",20,32,52,0.615384615384615,0.384615384615385,1
"11127","NRG1",59,74,133,0.556390977443609,0.443609022556391,1
"11128","NRG2",20,37,57,0.649122807017544,0.350877192982456,1
"11129","NRG3",51,130,181,0.718232044198895,0.281767955801105,1
"11130","NRG4",2,12,14,0.857142857142857,0.142857142857143,1
"11131","NRGN",1,3,4,0.75,0.25,1
"11132","NRIP1",58,75,133,0.56390977443609,0.43609022556391,1
"11133","NRIP2",14,11,25,0.44,0.56,1
"11134","NRIP3",16,11,27,0.407407407407407,0.592592592592593,1
"11135","NRK",133,115,248,0.463709677419355,0.536290322580645,1
"11136","NRL",3,7,10,0.7,0.3,1
"11137","NRM",5,11,16,0.6875,0.3125,1
"11138","NRN1",8,16,24,0.666666666666667,0.333333333333333,1
"11139","NRN1L",5,5,10,0.5,0.5,1
"11140","NRP1",37,73,110,0.663636363636364,0.336363636363636,1
"11141","NRP2",47,66,113,0.584070796460177,0.415929203539823,1
"11142","NRROS",35,51,86,0.593023255813954,0.406976744186047,1
"11143","NRSN1",15,34,49,0.693877551020408,0.306122448979592,1
"11144","NRSN2",9,11,20,0.55,0.45,1
"11145","NRTN",2,3,5,0.6,0.4,1
"11146","NRXN1",179,289,468,0.617521367521368,0.382478632478632,1
"11147","NRXN2",84,139,223,0.623318385650224,0.376681614349776,1
"11148","NRXN3",103,202,305,0.662295081967213,0.337704918032787,1
"11149","NSA2",9,6,15,0.4,0.6,1
"11150","NSD1",102,189,291,0.649484536082474,0.350515463917526,1
"11151","NSD2",42,75,117,0.641025641025641,0.358974358974359,1
"11152","NSD3",52,70,122,0.573770491803279,0.426229508196721,1
"11153","NSDHL",19,16,35,0.457142857142857,0.542857142857143,1
"11154","NSF",21,21,42,0.5,0.5,1
"11155","NSFL1C",14,21,35,0.6,0.4,1
"11156","NSG1",8,13,21,0.619047619047619,0.380952380952381,1
"11157","NSG2",22,20,42,0.476190476190476,0.523809523809524,1
"11158","NSL1",6,16,22,0.727272727272727,0.272727272727273,1
"11159","NSMAF",27,56,83,0.674698795180723,0.325301204819277,1
"11160","NSMCE1",7,13,20,0.65,0.35,1
"11161","NSMCE2",5,10,15,0.666666666666667,0.333333333333333,1
"11162","NSMCE3",6,13,19,0.684210526315789,0.315789473684211,1
"11163","NSMCE4A",5,6,11,0.545454545454545,0.454545454545455,1
"11164","NSMF",9,16,25,0.64,0.36,1
"11165","NSRP1",24,25,49,0.510204081632653,0.489795918367347,1
"11166","NSUN2",28,56,84,0.666666666666667,0.333333333333333,1
"11167","NSUN3",12,19,31,0.612903225806452,0.387096774193548,1
"11168","NSUN4",12,13,25,0.52,0.48,1
"11169","NSUN5",13,20,33,0.606060606060606,0.393939393939394,1
"11170","NSUN6",20,34,54,0.62962962962963,0.37037037037037,1
"11171","NSUN7",16,41,57,0.719298245614035,0.280701754385965,1
"11172","NT5C",4,5,9,0.555555555555556,0.444444444444444,1
"11173","NT5C1A",21,37,58,0.637931034482759,0.362068965517241,1
"11174","NT5C1B",35,57,92,0.619565217391304,0.380434782608696,1
"11175","NT5C2",13,33,46,0.717391304347826,0.282608695652174,1
"11176","NT5C3A",8,20,28,0.714285714285714,0.285714285714286,1
"11177","NT5C3B",4,17,21,0.80952380952381,0.19047619047619,1
"11178","NT5DC1",16,21,37,0.567567567567568,0.432432432432432,1
"11179","NT5DC2",13,24,37,0.648648648648649,0.351351351351351,1
"11180","NT5DC3",16,34,50,0.68,0.32,1
"11181","NT5DC4",0,2,2,1,0,1
"11182","NT5E",11,29,40,0.725,0.275,1
"11183","NT5M",14,10,24,0.416666666666667,0.583333333333333,1
"11184","NTAN1",9,21,30,0.7,0.3,1
"11185","NTAQ1",9,20,29,0.689655172413793,0.310344827586207,1
"11186","NTF3",21,24,45,0.533333333333333,0.466666666666667,1
"11187","NTF4",4,9,13,0.692307692307692,0.307692307692308,1
"11188","NTHL1",15,16,31,0.516129032258065,0.483870967741935,1
"11189","NTM",49,59,108,0.546296296296296,0.453703703703704,1
"11190","NTMT1",11,8,19,0.421052631578947,0.578947368421053,1
"11191","NTN1",12,30,42,0.714285714285714,0.285714285714286,1
"11192","NTN3",7,14,21,0.666666666666667,0.333333333333333,1
"11193","NTN4",31,52,83,0.626506024096386,0.373493975903614,1
"11194","NTN5",10,14,24,0.583333333333333,0.416666666666667,1
"11195","NTNG1",46,78,124,0.629032258064516,0.370967741935484,1
"11196","NTNG2",36,45,81,0.555555555555556,0.444444444444444,1
"11197","NTPCR",8,9,17,0.529411764705882,0.470588235294118,1
"11198","NTRK1",38,64,102,0.627450980392157,0.372549019607843,1
"11199","NTRK2",47,66,113,0.584070796460177,0.415929203539823,1
"11200","NTRK3",102,113,215,0.525581395348837,0.474418604651163,1
"11201","NTS",4,21,25,0.84,0.16,1
"11202","NTSR1",31,32,63,0.507936507936508,0.492063492063492,1
"11203","NTSR2",13,22,35,0.628571428571429,0.371428571428571,1
"11204","NUAK1",46,66,112,0.589285714285714,0.410714285714286,1
"11205","NUAK2",16,44,60,0.733333333333333,0.266666666666667,1
"11206","NUB1",19,22,41,0.536585365853659,0.463414634146341,1
"11207","NUBP1",10,15,25,0.6,0.4,1
"11208","NUBP2",14,15,29,0.517241379310345,0.482758620689655,1
"11209","NUBPL",10,10,20,0.5,0.5,1
"11210","NUCB1",15,23,38,0.605263157894737,0.394736842105263,1
"11211","NUCB2",17,19,36,0.527777777777778,0.472222222222222,1
"11212","NUCKS1",13,13,26,0.5,0.5,1
"11213","NUDC",13,10,23,0.434782608695652,0.565217391304348,1
"11214","NUDCD1",20,37,57,0.649122807017544,0.350877192982456,1
"11215","NUDCD2",3,10,13,0.769230769230769,0.230769230769231,1
"11216","NUDCD3",10,8,18,0.444444444444444,0.555555555555556,1
"11217","NUDT1",8,11,19,0.578947368421053,0.421052631578947,1
"11218","NUDT10",9,10,19,0.526315789473684,0.473684210526316,1
"11219","NUDT11",14,9,23,0.391304347826087,0.608695652173913,1
"11220","NUDT12",30,20,50,0.4,0.6,1
"11221","NUDT13",16,12,28,0.428571428571429,0.571428571428571,1
"11222","NUDT14",7,13,20,0.65,0.35,1
"11223","NUDT15",5,9,14,0.642857142857143,0.357142857142857,1
"11224","NUDT16",10,10,20,0.5,0.5,1
"11225","NUDT16L1",6,8,14,0.571428571428571,0.428571428571429,1
"11226","NUDT17",3,14,17,0.823529411764706,0.176470588235294,1
"11227","NUDT18",5,9,14,0.642857142857143,0.357142857142857,1
"11228","NUDT19",8,15,23,0.652173913043478,0.347826086956522,1
"11229","NUDT2",7,7,14,0.5,0.5,1
"11230","NUDT21",10,10,20,0.5,0.5,1
"11231","NUDT22",6,13,19,0.684210526315789,0.315789473684211,1
"11232","NUDT3",8,7,15,0.466666666666667,0.533333333333333,1
"11233","NUDT4",2,1,3,0.333333333333333,0.666666666666667,1
"11234","NUDT5",7,9,16,0.5625,0.4375,1
"11235","NUDT6",6,23,29,0.793103448275862,0.206896551724138,1
"11236","NUDT7",14,28,42,0.666666666666667,0.333333333333333,1
"11237","NUDT8",3,8,11,0.727272727272727,0.272727272727273,1
"11238","NUDT9",9,13,22,0.590909090909091,0.409090909090909,1
"11239","NUF2",32,48,80,0.6,0.4,1
"11240","NUFIP1",22,35,57,0.614035087719298,0.385964912280702,1
"11241","NUFIP2",15,30,45,0.666666666666667,0.333333333333333,1
"11242","NUGGC",35,79,114,0.692982456140351,0.307017543859649,1
"11243","NUMA1",66,99,165,0.6,0.4,1
"11244","NUMB",19,25,44,0.568181818181818,0.431818181818182,1
"11245","NUMBL",11,19,30,0.633333333333333,0.366666666666667,1
"11246","NUP107",36,54,90,0.6,0.4,1
"11247","NUP133",51,74,125,0.592,0.408,1
"11248","NUP153",45,73,118,0.61864406779661,0.38135593220339,1
"11249","NUP155",32,87,119,0.73109243697479,0.26890756302521,1
"11250","NUP160",38,52,90,0.577777777777778,0.422222222222222,1
"11251","NUP188",57,69,126,0.547619047619048,0.452380952380952,1
"11252","NUP205",96,136,232,0.586206896551724,0.413793103448276,1
"11253","NUP210",67,115,182,0.631868131868132,0.368131868131868,1
"11254","NUP210L",87,152,239,0.635983263598326,0.364016736401674,1
"11255","NUP214",63,121,184,0.657608695652174,0.342391304347826,1
"11256","NUP35",15,11,26,0.423076923076923,0.576923076923077,1
"11257","NUP37",9,19,28,0.678571428571429,0.321428571428571,1
"11258","NUP42",20,28,48,0.583333333333333,0.416666666666667,1
"11259","NUP43",22,15,37,0.405405405405405,0.594594594594595,1
"11260","NUP50",15,14,29,0.482758620689655,0.517241379310345,1
"11261","NUP54",11,22,33,0.666666666666667,0.333333333333333,1
"11262","NUP58",18,26,44,0.590909090909091,0.409090909090909,1
"11263","NUP62",13,31,44,0.704545454545455,0.295454545454545,1
"11264","NUP62CL",9,5,14,0.357142857142857,0.642857142857143,1
"11265","NUP85",24,24,48,0.5,0.5,1
"11266","NUP88",25,29,54,0.537037037037037,0.462962962962963,1
"11267","NUP93",34,34,68,0.5,0.5,1
"11268","NUP98",74,97,171,0.567251461988304,0.432748538011696,1
"11269","NUPR1",1,5,6,0.833333333333333,0.166666666666667,1
"11270","NUPR2",0,1,1,1,0,1
"11271","NUS1",5,11,16,0.6875,0.3125,1
"11272","NUSAP1",6,18,24,0.75,0.25,1
"11273","NUTF2",4,5,9,0.555555555555556,0.444444444444444,1
"11274","NUTM1",62,102,164,0.621951219512195,0.378048780487805,1
"11275","NUTM2A",11,14,25,0.56,0.44,1
"11276","NUTM2D",13,6,19,0.315789473684211,0.684210526315789,1
"11277","NUTM2F",14,35,49,0.714285714285714,0.285714285714286,1
"11278","NUTM2G",18,27,45,0.6,0.4,1
"11279","NVL",22,46,68,0.676470588235294,0.323529411764706,1
"11280","NWD1",85,127,212,0.599056603773585,0.400943396226415,1
"11281","NWD2",0,7,7,1,0,1
"11282","NXF1",28,49,77,0.636363636363636,0.363636363636364,1
"11283","NXF3",28,61,89,0.685393258426966,0.314606741573034,1
"11284","NXF5",55,58,113,0.513274336283186,0.486725663716814,1
"11285","NXN",11,27,38,0.710526315789474,0.289473684210526,1
"11286","NXNL1",8,7,15,0.466666666666667,0.533333333333333,1
"11287","NXNL2",6,7,13,0.538461538461538,0.461538461538462,1
"11288","NXPE1",20,38,58,0.655172413793103,0.344827586206897,1
"11289","NXPE2",1,2,3,0.666666666666667,0.333333333333333,1
"11290","NXPE3",25,40,65,0.615384615384615,0.384615384615385,1
"11291","NXPE4",32,52,84,0.619047619047619,0.380952380952381,1
"11292","NXPH1",21,43,64,0.671875,0.328125,1
"11293","NXPH2",23,41,64,0.640625,0.359375,1
"11294","NXPH3",12,21,33,0.636363636363636,0.363636363636364,1
"11295","NXPH4",5,15,20,0.75,0.25,1
"11296","NXT1",3,9,12,0.75,0.25,1
"11297","NXT2",5,6,11,0.545454545454545,0.454545454545455,1
"11298","NYAP1",38,67,105,0.638095238095238,0.361904761904762,1
"11299","NYAP2",68,121,189,0.64021164021164,0.35978835978836,1
"11300","NYNRIN",75,118,193,0.61139896373057,0.38860103626943,1
"11301","NYX",22,10,32,0.3125,0.6875,1
"11302","OAF",12,14,26,0.538461538461538,0.461538461538462,1
"11303","OARD1",2,10,12,0.833333333333333,0.166666666666667,0.77
"11304","OAS1",16,34,50,0.68,0.32,1
"11305","OAS2",40,60,100,0.6,0.4,1
"11306","OAS3",25,53,78,0.67948717948718,0.320512820512821,1
"11307","OASL",19,33,52,0.634615384615385,0.365384615384615,1
"11308","OAT",9,23,32,0.71875,0.28125,1
"11309","OAZ1",7,12,19,0.631578947368421,0.368421052631579,1
"11310","OAZ2",2,5,7,0.714285714285714,0.285714285714286,1
"11311","OAZ3",11,15,26,0.576923076923077,0.423076923076923,1
"11312","OBI1",18,58,76,0.763157894736842,0.236842105263158,1
"11313","OBP2A",5,12,17,0.705882352941177,0.294117647058824,1
"11314","OBP2B",2,14,16,0.875,0.125,1
"11315","OBSCN",292,516,808,0.638613861386139,0.361386138613861,1
"11316","OBSL1",49,74,123,0.601626016260163,0.398373983739837,1
"11317","OCA2",60,121,181,0.668508287292818,0.331491712707182,1
"11318","OCEL1",12,11,23,0.478260869565217,0.521739130434783,1
"11319","OCIAD1",20,23,43,0.534883720930233,0.465116279069767,1
"11320","OCIAD2",10,17,27,0.62962962962963,0.37037037037037,1
"11321","OCLN",15,22,37,0.594594594594595,0.405405405405405,1
"11322","OCLNP1",6,3,9,0.333333333333333,0.666666666666667,1
"11323","OCM",7,10,17,0.588235294117647,0.411764705882353,1
"11324","OCM2",4,13,17,0.764705882352941,0.235294117647059,1
"11325","OCRL",54,30,84,0.357142857142857,0.642857142857143,1
"11326","ODAM",15,26,41,0.634146341463415,0.365853658536585,1
"11327","ODAPH",10,16,26,0.615384615384615,0.384615384615385,1
"11328","ODC1",11,24,35,0.685714285714286,0.314285714285714,1
"11329","ODF1",18,24,42,0.571428571428571,0.428571428571429,1
"11330","ODF2",21,48,69,0.695652173913043,0.304347826086957,1
"11331","ODF2L",22,30,52,0.576923076923077,0.423076923076923,1
"11332","ODF3",5,11,16,0.6875,0.3125,1
"11333","ODF3B",4,2,6,0.333333333333333,0.666666666666667,1
"11334","ODF3L1",8,14,22,0.636363636363636,0.363636363636364,1
"11335","ODF3L2",10,14,24,0.583333333333333,0.416666666666667,1
"11336","ODF4",7,16,23,0.695652173913043,0.304347826086957,1
"11337","ODR4",10,16,26,0.615384615384615,0.384615384615385,1
"11338","OFCC1",14,14,28,0.5,0.5,1
"11339","OFD1",47,49,96,0.510416666666667,0.489583333333333,1
"11340","OGA",23,41,64,0.640625,0.359375,1
"11341","OGDH",44,65,109,0.596330275229358,0.403669724770642,1
"11342","OGDHL",58,135,193,0.699481865284974,0.300518134715026,1
"11343","OGFOD1",9,15,24,0.625,0.375,1
"11344","OGFOD2",9,9,18,0.5,0.5,1
"11345","OGFOD3",10,13,23,0.565217391304348,0.434782608695652,1
"11346","OGFR",13,18,31,0.580645161290323,0.419354838709677,1
"11347","OGFRL1",25,28,53,0.528301886792453,0.471698113207547,1
"11348","OGG1",18,25,43,0.581395348837209,0.418604651162791,1
"11349","OGN",10,22,32,0.6875,0.3125,1
"11350","OGT",70,30,100,0.3,0.7,1
"11351","OIP5",3,10,13,0.769230769230769,0.230769230769231,1
"11352","OIT3",23,46,69,0.666666666666667,0.333333333333333,1
"11353","OLA1",9,15,24,0.625,0.375,1
"11354","OLAH",16,33,49,0.673469387755102,0.326530612244898,1
"11355","OLFM1",34,32,66,0.484848484848485,0.515151515151515,1
"11356","OLFM2",19,28,47,0.595744680851064,0.404255319148936,1
"11357","OLFM3",40,87,127,0.68503937007874,0.31496062992126,1
"11358","OLFM4",33,61,94,0.648936170212766,0.351063829787234,1
"11359","OLFML1",13,26,39,0.666666666666667,0.333333333333333,1
"11360","OLFML2A",29,41,70,0.585714285714286,0.414285714285714,1
"11361","OLFML2B",51,79,130,0.607692307692308,0.392307692307692,1
"11362","OLFML3",15,24,39,0.615384615384615,0.384615384615385,1
"11363","OLIG1",4,0,4,0,1,1
"11364","OLIG2",9,6,15,0.4,0.6,1
"11365","OLIG3",14,26,40,0.65,0.35,1
"11366","OLR1",17,23,40,0.575,0.425,1
"11367","OMA1",13,18,31,0.580645161290323,0.419354838709677,1
"11368","OMD",22,26,48,0.541666666666667,0.458333333333333,1
"11369","OMG",10,13,23,0.565217391304348,0.434782608695652,1
"11370","OMP",5,20,25,0.8,0.2,1
"11371","ONECUT1",24,22,46,0.478260869565217,0.521739130434783,1
"11372","ONECUT2",17,25,42,0.595238095238095,0.404761904761905,1
"11373","ONECUT3",5,4,9,0.444444444444444,0.555555555555556,1
"11374","OOEP",25,18,43,0.418604651162791,0.581395348837209,1
"11375","OOSP2",11,17,28,0.607142857142857,0.392857142857143,1
"11376","OPA1",21,54,75,0.72,0.28,1
"11377","OPA3",8,15,23,0.652173913043478,0.347826086956522,1
"11378","OPALIN",10,15,25,0.6,0.4,1
"11379","OPCML",39,65,104,0.625,0.375,1
"11380","OPHN1",68,21,89,0.235955056179775,0.764044943820225,1
"11381","OPLAH",44,90,134,0.671641791044776,0.328358208955224,1
"11382","OPN1LW",20,17,37,0.459459459459459,0.540540540540541,1
"11383","OPN1MW",8,5,13,0.384615384615385,0.615384615384615,1
"11384","OPN1SW",21,24,45,0.533333333333333,0.466666666666667,1
"11385","OPN3",9,19,28,0.678571428571429,0.321428571428571,1
"11386","OPN4",19,28,47,0.595744680851064,0.404255319148936,1
"11387","OPN5",26,37,63,0.587301587301587,0.412698412698413,1
"11388","OPRD1",20,28,48,0.583333333333333,0.416666666666667,1
"11389","OPRK1",27,74,101,0.732673267326733,0.267326732673267,1
"11390","OPRL1",31,43,74,0.581081081081081,0.418918918918919,1
"11391","OPRM1",27,48,75,0.64,0.36,1
"11392","OPRPN",21,53,74,0.716216216216216,0.283783783783784,1
"11393","OPTC",9,21,30,0.7,0.3,1
"11394","OPTN",25,41,66,0.621212121212121,0.378787878787879,1
"11395","OR10A2",21,32,53,0.60377358490566,0.39622641509434,1
"11396","OR10A3",25,41,66,0.621212121212121,0.378787878787879,1
"11397","OR10A4",21,42,63,0.666666666666667,0.333333333333333,1
"11398","OR10A5",18,31,49,0.63265306122449,0.36734693877551,1
"11399","OR10A6",22,57,79,0.721518987341772,0.278481012658228,1
"11400","OR10A7",20,37,57,0.649122807017544,0.350877192982456,1
"11401","OR10AD1",11,15,26,0.576923076923077,0.423076923076923,1
"11402","OR10AG1",57,62,119,0.521008403361345,0.478991596638655,1
"11403","OR10C1",34,45,79,0.569620253164557,0.430379746835443,1
"11404","OR10G2",21,33,54,0.611111111111111,0.388888888888889,1
"11405","OR10G3",11,23,34,0.676470588235294,0.323529411764706,1
"11406","OR10G4",20,55,75,0.733333333333333,0.266666666666667,1
"11407","OR10G7",34,64,98,0.653061224489796,0.346938775510204,1
"11408","OR10G8",39,68,107,0.635514018691589,0.364485981308411,1
"11409","OR10G9",30,45,75,0.6,0.4,1
"11410","OR10H1",20,48,68,0.705882352941177,0.294117647058824,1
"11411","OR10H2",19,42,61,0.688524590163934,0.311475409836066,1
"11412","OR10H3",8,28,36,0.777777777777778,0.222222222222222,1
"11413","OR10H4",17,32,49,0.653061224489796,0.346938775510204,1
"11414","OR10H5",25,32,57,0.56140350877193,0.43859649122807,1
"11415","OR10J1",41,46,87,0.528735632183908,0.471264367816092,1
"11416","OR10J3",46,72,118,0.610169491525424,0.389830508474576,1
"11417","OR10J5",14,50,64,0.78125,0.21875,1
"11418","OR10K1",37,66,103,0.640776699029126,0.359223300970874,1
"11419","OR10K2",38,76,114,0.666666666666667,0.333333333333333,1
"11420","OR10P1",20,25,45,0.555555555555556,0.444444444444444,1
"11421","OR10Q1",34,62,96,0.645833333333333,0.354166666666667,1
"11422","OR10R2",46,49,95,0.515789473684211,0.484210526315789,1
"11423","OR10S1",45,51,96,0.53125,0.46875,1
"11424","OR10T2",34,50,84,0.595238095238095,0.404761904761905,1
"11425","OR10V1",13,27,40,0.675,0.325,1
"11426","OR10W1",28,29,57,0.508771929824561,0.491228070175439,1
"11427","OR10X1",36,62,98,0.63265306122449,0.36734693877551,1
"11428","OR10Z1",38,78,116,0.672413793103448,0.327586206896552,1
"11429","OR11A1",11,43,54,0.796296296296296,0.203703703703704,1
"11430","OR11G2",35,39,74,0.527027027027027,0.472972972972973,1
"11431","OR11H1",43,74,117,0.632478632478632,0.367521367521368,1
"11432","OR11H12",28,78,106,0.735849056603774,0.264150943396226,1
"11433","OR11H4",13,40,53,0.754716981132076,0.245283018867925,1
"11434","OR11H6",28,47,75,0.626666666666667,0.373333333333333,1
"11435","OR11L1",44,70,114,0.614035087719298,0.385964912280702,1
"11436","OR12D2",30,43,73,0.589041095890411,0.410958904109589,1
"11437","OR12D3",12,37,49,0.755102040816326,0.244897959183673,1
"11438","OR13A1",17,44,61,0.721311475409836,0.278688524590164,1
"11439","OR13C2",20,44,64,0.6875,0.3125,1
"11440","OR13C3",25,54,79,0.683544303797468,0.316455696202532,1
"11441","OR13C4",31,42,73,0.575342465753425,0.424657534246575,1
"11442","OR13C5",24,41,65,0.630769230769231,0.369230769230769,1
"11443","OR13C8",35,50,85,0.588235294117647,0.411764705882353,1
"11444","OR13C9",22,42,64,0.65625,0.34375,1
"11445","OR13D1",15,44,59,0.745762711864407,0.254237288135593,1
"11446","OR13F1",27,54,81,0.666666666666667,0.333333333333333,1
"11447","OR13G1",43,60,103,0.58252427184466,0.41747572815534,1
"11448","OR13H1",17,30,47,0.638297872340426,0.361702127659574,1
"11449","OR13J1",9,15,24,0.625,0.375,1
"11450","OR14A16",44,78,122,0.639344262295082,0.360655737704918,1
"11451","OR14A2",0,2,2,1,0,1
"11452","OR14C36",41,67,108,0.62037037037037,0.37962962962963,1
"11453","OR14I1",27,51,78,0.653846153846154,0.346153846153846,1
"11454","OR14J1",22,49,71,0.690140845070423,0.309859154929577,1
"11455","OR14K1",39,63,102,0.617647058823529,0.382352941176471,1
"11456","OR1A1",21,41,62,0.661290322580645,0.338709677419355,1
"11457","OR1A2",17,31,48,0.645833333333333,0.354166666666667,1
"11458","OR1B1",19,34,53,0.641509433962264,0.358490566037736,1
"11459","OR1C1",41,79,120,0.658333333333333,0.341666666666667,1
"11460","OR1D2",18,36,54,0.666666666666667,0.333333333333333,1
"11461","OR1D5",16,23,39,0.58974358974359,0.41025641025641,1
"11462","OR1E1",18,12,30,0.4,0.6,1
"11463","OR1E2",14,17,31,0.548387096774194,0.451612903225806,1
"11464","OR1F1",17,24,41,0.585365853658537,0.414634146341463,1
"11465","OR1G1",16,39,55,0.709090909090909,0.290909090909091,1
"11466","OR1I1",11,25,36,0.694444444444444,0.305555555555556,1
"11467","OR1J1",10,28,38,0.736842105263158,0.263157894736842,1
"11468","OR1J2",18,39,57,0.684210526315789,0.315789473684211,1
"11469","OR1J4",15,42,57,0.736842105263158,0.263157894736842,1
"11470","OR1K1",15,19,34,0.558823529411765,0.441176470588235,1
"11471","OR1L1",18,49,67,0.73134328358209,0.26865671641791,1
"11472","OR1L3",20,38,58,0.655172413793103,0.344827586206897,1
"11473","OR1L4",14,37,51,0.725490196078431,0.274509803921569,1
"11474","OR1L6",9,29,38,0.763157894736842,0.236842105263158,1
"11475","OR1L8",29,41,70,0.585714285714286,0.414285714285714,1
"11476","OR1M1",19,42,61,0.688524590163934,0.311475409836066,1
"11477","OR1N1",19,33,52,0.634615384615385,0.365384615384615,1
"11478","OR1N2",21,53,74,0.716216216216216,0.283783783783784,1
"11479","OR1Q1",13,40,53,0.754716981132076,0.245283018867925,1
"11480","OR1S1",33,40,73,0.547945205479452,0.452054794520548,1
"11481","OR1S2",25,43,68,0.632352941176471,0.367647058823529,1
"11482","OR2A1",8,15,23,0.652173913043478,0.347826086956522,1
"11483","OR2A12",34,44,78,0.564102564102564,0.435897435897436,1
"11484","OR2A14",21,50,71,0.704225352112676,0.295774647887324,1
"11485","OR2A2",38,52,90,0.577777777777778,0.422222222222222,1
"11486","OR2A25",36,60,96,0.625,0.375,1
"11487","OR2A4",8,23,31,0.741935483870968,0.258064516129032,1
"11488","OR2A42",4,11,15,0.733333333333333,0.266666666666667,1
"11489","OR2A5",41,74,115,0.643478260869565,0.356521739130435,1
"11490","OR2A7",14,25,39,0.641025641025641,0.358974358974359,1
"11491","OR2AE1",8,16,24,0.666666666666667,0.333333333333333,1
"11492","OR2AG1",15,27,42,0.642857142857143,0.357142857142857,1
"11493","OR2AG2",16,34,50,0.68,0.32,1
"11494","OR2AJ1",1,2,3,0.666666666666667,0.333333333333333,1
"11495","OR2AK2",35,65,100,0.65,0.35,1
"11496","OR2AT4",20,26,46,0.565217391304348,0.434782608695652,1
"11497","OR2B11",28,59,87,0.67816091954023,0.32183908045977,1
"11498","OR2B2",24,46,70,0.657142857142857,0.342857142857143,1
"11499","OR2B3",23,51,74,0.689189189189189,0.310810810810811,1
"11500","OR2B6",26,40,66,0.606060606060606,0.393939393939394,1
"11501","OR2C1",13,25,38,0.657894736842105,0.342105263157895,1
"11502","OR2C3",27,52,79,0.658227848101266,0.341772151898734,1
"11503","OR2D2",21,48,69,0.695652173913043,0.304347826086957,1
"11504","OR2D3",24,35,59,0.593220338983051,0.406779661016949,1
"11505","OR2F1",35,58,93,0.623655913978495,0.376344086021505,1
"11506","OR2F2",32,60,92,0.652173913043478,0.347826086956522,1
"11507","OR2G2",49,89,138,0.644927536231884,0.355072463768116,1
"11508","OR2G3",37,79,116,0.681034482758621,0.318965517241379,1
"11509","OR2G6",52,83,135,0.614814814814815,0.385185185185185,1
"11510","OR2H1",24,40,64,0.625,0.375,1
"11511","OR2H2",15,25,40,0.625,0.375,1
"11512","OR2J1",0,3,3,1,0,1
"11513","OR2J2",32,59,91,0.648351648351648,0.351648351648352,1
"11514","OR2J3",29,64,93,0.688172043010753,0.311827956989247,1
"11515","OR2K2",19,28,47,0.595744680851064,0.404255319148936,1
"11516","OR2L13",43,99,142,0.697183098591549,0.302816901408451,1
"11517","OR2L2",42,83,125,0.664,0.336,1
"11518","OR2L3",37,96,133,0.721804511278195,0.278195488721804,1
"11519","OR2L5",0,7,7,1,0,1
"11520","OR2L8",60,80,140,0.571428571428571,0.428571428571429,1
"11521","OR2M2",62,91,153,0.594771241830065,0.405228758169935,1
"11522","OR2M3",49,106,155,0.683870967741935,0.316129032258064,1
"11523","OR2M4",56,69,125,0.552,0.448,1
"11524","OR2M5",47,99,146,0.678082191780822,0.321917808219178,1
"11525","OR2M7",34,72,106,0.679245283018868,0.320754716981132,1
"11526","OR2S2",6,21,27,0.777777777777778,0.222222222222222,1
"11527","OR2T1",39,64,103,0.621359223300971,0.378640776699029,1
"11528","OR2T10",31,59,90,0.655555555555556,0.344444444444444,1
"11529","OR2T11",26,61,87,0.701149425287356,0.298850574712644,1
"11530","OR2T12",58,92,150,0.613333333333333,0.386666666666667,1
"11531","OR2T2",38,71,109,0.651376146788991,0.348623853211009,1
"11532","OR2T27",29,59,88,0.670454545454545,0.329545454545455,1
"11533","OR2T29",9,4,13,0.307692307692308,0.692307692307692,1
"11534","OR2T3",41,72,113,0.63716814159292,0.36283185840708,1
"11535","OR2T33",60,78,138,0.565217391304348,0.434782608695652,1
"11536","OR2T34",37,69,106,0.650943396226415,0.349056603773585,1
"11537","OR2T35",11,26,37,0.702702702702703,0.297297297297297,1
"11538","OR2T4",58,80,138,0.579710144927536,0.420289855072464,1
"11539","OR2T5",11,13,24,0.541666666666667,0.458333333333333,1
"11540","OR2T6",52,68,120,0.566666666666667,0.433333333333333,1
"11541","OR2T8",28,57,85,0.670588235294118,0.329411764705882,1
"11542","OR2U1P",28,75,103,0.728155339805825,0.271844660194175,1
"11543","OR2V2",21,33,54,0.611111111111111,0.388888888888889,1
"11544","OR2W1",35,52,87,0.597701149425287,0.402298850574713,1
"11545","OR2W3",49,71,120,0.591666666666667,0.408333333333333,1
"11546","OR2W5",64,96,160,0.6,0.4,1
"11547","OR2Y1",22,30,52,0.576923076923077,0.423076923076923,1
"11548","OR2Z1",20,54,74,0.72972972972973,0.27027027027027,1
"11549","OR3A1",18,27,45,0.6,0.4,1
"11550","OR3A2",17,26,43,0.604651162790698,0.395348837209302,1
"11551","OR3A3",11,20,31,0.645161290322581,0.354838709677419,1
"11552","OR3A4P",32,54,86,0.627906976744186,0.372093023255814,1
"11553","OR4A15",50,138,188,0.734042553191489,0.265957446808511,1
"11554","OR4A16",40,94,134,0.701492537313433,0.298507462686567,1
"11555","OR4A47",34,64,98,0.653061224489796,0.346938775510204,1
"11556","OR4A5",57,74,131,0.564885496183206,0.435114503816794,1
"11557","OR4B1",20,48,68,0.705882352941177,0.294117647058824,1
"11558","OR4C11",30,58,88,0.659090909090909,0.340909090909091,1
"11559","OR4C12",35,70,105,0.666666666666667,0.333333333333333,1
"11560","OR4C13",46,70,116,0.603448275862069,0.396551724137931,1
"11561","OR4C15",65,111,176,0.630681818181818,0.369318181818182,1
"11562","OR4C16",58,70,128,0.546875,0.453125,1
"11563","OR4C3",23,38,61,0.622950819672131,0.377049180327869,1
"11564","OR4C46",55,75,130,0.576923076923077,0.423076923076923,1
"11565","OR4C4P",0,3,3,1,0,1
"11566","OR4C6",59,103,162,0.635802469135803,0.364197530864198,1
"11567","OR4D1",11,23,34,0.676470588235294,0.323529411764706,1
"11568","OR4D10",23,45,68,0.661764705882353,0.338235294117647,1
"11569","OR4D11",22,44,66,0.666666666666667,0.333333333333333,1
"11570","OR4D2",20,43,63,0.682539682539683,0.317460317460317,1
"11571","OR4D5",37,83,120,0.691666666666667,0.308333333333333,1
"11572","OR4D6",30,42,72,0.583333333333333,0.416666666666667,1
"11573","OR4D9",19,42,61,0.688524590163934,0.311475409836066,1
"11574","OR4E2",24,54,78,0.692307692307692,0.307692307692308,1
"11575","OR4F15",10,31,41,0.75609756097561,0.24390243902439,1
"11576","OR4F17",7,8,15,0.533333333333333,0.466666666666667,1
"11577","OR4F21",3,6,9,0.666666666666667,0.333333333333333,1
"11578","OR4F4",2,13,15,0.866666666666667,0.133333333333333,1
"11579","OR4F5",3,6,9,0.666666666666667,0.333333333333333,1
"11580","OR4F6",21,35,56,0.625,0.375,1
"11581","OR4K1",35,88,123,0.715447154471545,0.284552845528455,1
"11582","OR4K13",35,59,94,0.627659574468085,0.372340425531915,1
"11583","OR4K14",21,44,65,0.676923076923077,0.323076923076923,1
"11584","OR4K15",27,63,90,0.7,0.3,1
"11585","OR4K17",29,47,76,0.618421052631579,0.381578947368421,1
"11586","OR4K2",41,87,128,0.6796875,0.3203125,1
"11587","OR4K5",51,83,134,0.619402985074627,0.380597014925373,1
"11588","OR4L1",32,44,76,0.578947368421053,0.421052631578947,1
"11589","OR4M1",52,111,163,0.680981595092024,0.319018404907975,1
"11590","OR4M2",2,2,4,0.5,0.5,1
"11591","OR4N2",49,113,162,0.697530864197531,0.302469135802469,1
"11592","OR4N3P",0,1,1,1,0,1
"11593","OR4N5",31,47,78,0.602564102564103,0.397435897435897,1
"11594","OR4P4",33,93,126,0.738095238095238,0.261904761904762,1
"11595","OR4Q3",52,87,139,0.62589928057554,0.37410071942446,1
"11596","OR4S1",25,41,66,0.621212121212121,0.378787878787879,1
"11597","OR4S2",37,71,108,0.657407407407407,0.342592592592593,1
"11598","OR4X1",25,49,74,0.662162162162162,0.337837837837838,1
"11599","OR4X2",25,50,75,0.666666666666667,0.333333333333333,1
"11600","OR51A2",19,40,59,0.677966101694915,0.322033898305085,1
"11601","OR51A4",25,57,82,0.695121951219512,0.304878048780488,1
"11602","OR51A7",32,65,97,0.670103092783505,0.329896907216495,1
"11603","OR51B2",20,64,84,0.761904761904762,0.238095238095238,1
"11604","OR51B4",24,39,63,0.619047619047619,0.380952380952381,1
"11605","OR51B5",27,57,84,0.678571428571429,0.321428571428571,1
"11606","OR51B6",23,48,71,0.676056338028169,0.323943661971831,1
"11607","OR51D1",25,48,73,0.657534246575342,0.342465753424658,1
"11608","OR51E1",25,46,71,0.647887323943662,0.352112676056338,1
"11609","OR51E2",35,77,112,0.6875,0.3125,1
"11610","OR51F1",26,51,77,0.662337662337662,0.337662337662338,1
"11611","OR51F2",30,49,79,0.620253164556962,0.379746835443038,1
"11612","OR51G1",36,50,86,0.581395348837209,0.418604651162791,1
"11613","OR51G2",33,63,96,0.65625,0.34375,1
"11614","OR51I1",28,37,65,0.569230769230769,0.430769230769231,1
"11615","OR51I2",24,52,76,0.684210526315789,0.315789473684211,1
"11616","OR51L1",20,56,76,0.736842105263158,0.263157894736842,1
"11617","OR51M1",32,63,95,0.663157894736842,0.336842105263158,1
"11618","OR51Q1",24,54,78,0.692307692307692,0.307692307692308,1
"11619","OR51S1",32,77,109,0.706422018348624,0.293577981651376,1
"11620","OR51T1",23,52,75,0.693333333333333,0.306666666666667,1
"11621","OR51V1",37,62,99,0.626262626262626,0.373737373737374,1
"11622","OR52A1",23,44,67,0.656716417910448,0.343283582089552,1
"11623","OR52A4P",20,34,54,0.62962962962963,0.37037037037037,1
"11624","OR52A5",39,67,106,0.632075471698113,0.367924528301887,1
"11625","OR52B2",17,36,53,0.679245283018868,0.320754716981132,1
"11626","OR52B4",24,59,83,0.710843373493976,0.289156626506024,1
"11627","OR52B6",18,29,47,0.617021276595745,0.382978723404255,1
"11628","OR52D1",19,44,63,0.698412698412698,0.301587301587302,1
"11629","OR52E2",30,56,86,0.651162790697674,0.348837209302326,1
"11630","OR52E4",33,61,94,0.648936170212766,0.351063829787234,1
"11631","OR52E6",29,45,74,0.608108108108108,0.391891891891892,1
"11632","OR52E8",30,50,80,0.625,0.375,1
"11633","OR52H1",14,46,60,0.766666666666667,0.233333333333333,1
"11634","OR52I1",6,27,33,0.818181818181818,0.181818181818182,1
"11635","OR52I2",18,43,61,0.704918032786885,0.295081967213115,1
"11636","OR52J3",30,55,85,0.647058823529412,0.352941176470588,1
"11637","OR52K1",24,48,72,0.666666666666667,0.333333333333333,1
"11638","OR52K2",17,36,53,0.679245283018868,0.320754716981132,1
"11639","OR52L1",38,38,76,0.5,0.5,1
"11640","OR52M1",34,40,74,0.540540540540541,0.459459459459459,1
"11641","OR52N1",23,43,66,0.651515151515151,0.348484848484849,1
"11642","OR52N2",14,34,48,0.708333333333333,0.291666666666667,1
"11643","OR52N4",21,52,73,0.712328767123288,0.287671232876712,1
"11644","OR52N5",29,36,65,0.553846153846154,0.446153846153846,1
"11645","OR52R1",33,57,90,0.633333333333333,0.366666666666667,1
"11646","OR52W1",15,12,27,0.444444444444444,0.555555555555556,1
"11647","OR56A1",26,50,76,0.657894736842105,0.342105263157895,1
"11648","OR56A3",34,48,82,0.585365853658537,0.414634146341463,1
"11649","OR56A4",33,48,81,0.592592592592593,0.407407407407407,1
"11650","OR56A5",0,1,1,1,0,1
"11651","OR56B1",23,46,69,0.666666666666667,0.333333333333333,1
"11652","OR56B4",15,31,46,0.673913043478261,0.326086956521739,1
"11653","OR5A1",31,45,76,0.592105263157895,0.407894736842105,1
"11654","OR5A2",20,42,62,0.67741935483871,0.32258064516129,1
"11655","OR5AC2",34,46,80,0.575,0.425,1
"11656","OR5AK2",24,40,64,0.625,0.375,1
"11657","OR5AN1",14,33,47,0.702127659574468,0.297872340425532,1
"11658","OR5AP2",25,42,67,0.626865671641791,0.373134328358209,1
"11659","OR5AR1",25,54,79,0.683544303797468,0.316455696202532,0.77
"11660","OR5AS1",35,70,105,0.666666666666667,0.333333333333333,1
"11661","OR5AU1",9,21,30,0.7,0.3,1
"11662","OR5B12",38,60,98,0.612244897959184,0.387755102040816,1
"11663","OR5B17",25,43,68,0.632352941176471,0.367647058823529,1
"11664","OR5B2",21,42,63,0.666666666666667,0.333333333333333,1
"11665","OR5B21",22,31,53,0.584905660377358,0.415094339622642,1
"11666","OR5B3",31,57,88,0.647727272727273,0.352272727272727,1
"11667","OR5C1",10,22,32,0.6875,0.3125,1
"11668","OR5D13",53,92,145,0.63448275862069,0.36551724137931,1
"11669","OR5D14",47,78,125,0.624,0.376,1
"11670","OR5D16",35,75,110,0.681818181818182,0.318181818181818,1
"11671","OR5D18",54,87,141,0.617021276595745,0.382978723404255,1
"11672","OR5F1",44,89,133,0.669172932330827,0.330827067669173,1
"11673","OR5H1",36,54,90,0.6,0.4,1
"11674","OR5H14",38,69,107,0.644859813084112,0.355140186915888,1
"11675","OR5H15",22,64,86,0.744186046511628,0.255813953488372,1
"11676","OR5H2",23,63,86,0.732558139534884,0.267441860465116,1
"11677","OR5H6",34,66,100,0.66,0.34,1
"11678","OR5I1",40,70,110,0.636363636363636,0.363636363636364,1
"11679","OR5J2",32,77,109,0.706422018348624,0.293577981651376,1
"11680","OR5K1",20,51,71,0.71830985915493,0.28169014084507,1
"11681","OR5K2",8,44,52,0.846153846153846,0.153846153846154,1
"11682","OR5K3",29,56,85,0.658823529411765,0.341176470588235,1
"11683","OR5K4",27,50,77,0.649350649350649,0.350649350649351,1
"11684","OR5L1",44,94,138,0.681159420289855,0.318840579710145,1
"11685","OR5L2",50,75,125,0.6,0.4,1
"11686","OR5M1",31,51,82,0.621951219512195,0.378048780487805,1
"11687","OR5M10",36,60,96,0.625,0.375,1
"11688","OR5M11",25,43,68,0.632352941176471,0.367647058823529,1
"11689","OR5M3",31,47,78,0.602564102564103,0.397435897435897,1
"11690","OR5M8",28,63,91,0.692307692307692,0.307692307692308,1
"11691","OR5P2",17,51,68,0.75,0.25,1
"11692","OR5P3",17,34,51,0.666666666666667,0.333333333333333,1
"11693","OR5R1",43,51,94,0.542553191489362,0.457446808510638,1
"11694","OR5T1",31,71,102,0.696078431372549,0.303921568627451,1
"11695","OR5T2",50,78,128,0.609375,0.390625,1
"11696","OR5T3",42,69,111,0.621621621621622,0.378378378378378,1
"11697","OR5V1",26,46,72,0.638888888888889,0.361111111111111,1
"11698","OR5W2",46,72,118,0.610169491525424,0.389830508474576,1
"11699","OR6A2",17,38,55,0.690909090909091,0.309090909090909,1
"11700","OR6B1",27,50,77,0.649350649350649,0.350649350649351,1
"11701","OR6B2",17,23,40,0.575,0.425,1
"11702","OR6B3",11,29,40,0.725,0.275,1
"11703","OR6C1",17,48,65,0.738461538461539,0.261538461538462,1
"11704","OR6C2",19,38,57,0.666666666666667,0.333333333333333,1
"11705","OR6C3",20,23,43,0.534883720930233,0.465116279069767,1
"11706","OR6C4",19,38,57,0.666666666666667,0.333333333333333,1
"11707","OR6C6",19,33,52,0.634615384615385,0.365384615384615,1
"11708","OR6C65",22,44,66,0.666666666666667,0.333333333333333,1
"11709","OR6C68",16,30,46,0.652173913043478,0.347826086956522,1
"11710","OR6C70",25,30,55,0.545454545454545,0.454545454545455,1
"11711","OR6C74",25,41,66,0.621212121212121,0.378787878787879,1
"11712","OR6C75",23,53,76,0.697368421052632,0.302631578947368,1
"11713","OR6C76",18,27,45,0.6,0.4,1
"11714","OR6F1",56,93,149,0.624161073825503,0.375838926174497,1
"11715","OR6K2",52,81,133,0.609022556390977,0.390977443609023,1
"11716","OR6K3",42,58,100,0.58,0.42,1
"11717","OR6K6",38,71,109,0.651376146788991,0.348623853211009,1
"11718","OR6M1",27,43,70,0.614285714285714,0.385714285714286,1
"11719","OR6N1",41,65,106,0.613207547169811,0.386792452830189,1
"11720","OR6N2",33,64,97,0.65979381443299,0.34020618556701,1
"11721","OR6P1",0,5,5,1,0,1
"11722","OR6Q1",17,37,54,0.685185185185185,0.314814814814815,1
"11723","OR6S1",16,40,56,0.714285714285714,0.285714285714286,1
"11724","OR6T1",38,61,99,0.616161616161616,0.383838383838384,1
"11725","OR6V1",18,37,55,0.672727272727273,0.327272727272727,1
"11726","OR6X1",24,34,58,0.586206896551724,0.413793103448276,1
"11727","OR6Y1",35,54,89,0.606741573033708,0.393258426966292,1
"11728","OR7A10",21,20,41,0.48780487804878,0.51219512195122,1
"11729","OR7A17",18,23,41,0.560975609756098,0.439024390243902,1
"11730","OR7A5",17,27,44,0.613636363636364,0.386363636363636,1
"11731","OR7C1",16,23,39,0.58974358974359,0.41025641025641,1
"11732","OR7C2",19,36,55,0.654545454545455,0.345454545454545,1
"11733","OR7D2",26,38,64,0.59375,0.40625,1
"11734","OR7D4",27,57,84,0.678571428571429,0.321428571428571,1
"11735","OR7E24",26,56,82,0.682926829268293,0.317073170731707,1
"11736","OR7E85P",0,2,2,1,0,1
"11737","OR7G1",17,29,46,0.630434782608696,0.369565217391304,1
"11738","OR7G2",14,36,50,0.72,0.28,1
"11739","OR7G3",18,23,41,0.560975609756098,0.439024390243902,1
"11740","OR8A1",25,44,69,0.63768115942029,0.36231884057971,1
"11741","OR8B12",23,35,58,0.603448275862069,0.396551724137931,1
"11742","OR8B2",23,45,68,0.661764705882353,0.338235294117647,1
"11743","OR8B3",11,44,55,0.8,0.2,1
"11744","OR8B4",23,57,80,0.7125,0.2875,1
"11745","OR8B8",17,51,68,0.75,0.25,1
"11746","OR8D1",29,57,86,0.662790697674419,0.337209302325581,1
"11747","OR8D2",21,49,70,0.7,0.3,1
"11748","OR8D4",20,54,74,0.72972972972973,0.27027027027027,1
"11749","OR8G1",18,51,69,0.739130434782609,0.260869565217391,1
"11750","OR8G2P",23,48,71,0.676056338028169,0.323943661971831,1
"11751","OR8G5",24,56,80,0.7,0.3,1
"11752","OR8H1",44,73,117,0.623931623931624,0.376068376068376,1
"11753","OR8H2",47,104,151,0.688741721854305,0.311258278145695,1
"11754","OR8H3",60,69,129,0.534883720930233,0.465116279069767,1
"11755","OR8I2",42,76,118,0.644067796610169,0.355932203389831,1
"11756","OR8J1",33,67,100,0.67,0.33,1
"11757","OR8J3",29,88,117,0.752136752136752,0.247863247863248,1
"11758","OR8K1",39,51,90,0.566666666666667,0.433333333333333,1
"11759","OR8K3",39,75,114,0.657894736842105,0.342105263157895,1
"11760","OR8K5",23,71,94,0.75531914893617,0.24468085106383,1
"11761","OR8S1",20,39,59,0.661016949152542,0.338983050847458,1
"11762","OR8U1",42,55,97,0.56701030927835,0.43298969072165,1
"11763","OR9A2",25,42,67,0.626865671641791,0.373134328358209,1
"11764","OR9A4",31,50,81,0.617283950617284,0.382716049382716,1
"11765","OR9G1",26,50,76,0.657894736842105,0.342105263157895,1
"11766","OR9G4",31,49,80,0.6125,0.3875,1
"11767","OR9I1",15,28,43,0.651162790697674,0.348837209302326,1
"11768","OR9K2",26,46,72,0.638888888888889,0.361111111111111,1
"11769","OR9Q1",26,30,56,0.535714285714286,0.464285714285714,1
"11770","OR9Q2",30,37,67,0.552238805970149,0.447761194029851,1
"11771","ORAI1",10,10,20,0.5,0.5,1
"11772","ORAI2",14,8,22,0.363636363636364,0.636363636363636,1
"11773","ORAI3",7,12,19,0.631578947368421,0.368421052631579,1
"11774","ORC1",36,46,82,0.560975609756098,0.439024390243902,1
"11775","ORC2",23,27,50,0.54,0.46,1
"11776","ORC3",21,36,57,0.631578947368421,0.368421052631579,1
"11777","ORC4",10,17,27,0.62962962962963,0.37037037037037,1
"11778","ORC5",14,30,44,0.681818181818182,0.318181818181818,1
"11779","ORC6",8,6,14,0.428571428571429,0.571428571428571,1
"11780","ORM1",5,21,26,0.807692307692308,0.192307692307692,1
"11781","ORM2",8,14,22,0.636363636363636,0.363636363636364,1
"11782","ORMDL1",1,4,5,0.8,0.2,1
"11783","ORMDL2",1,6,7,0.857142857142857,0.142857142857143,1
"11784","ORMDL3",7,6,13,0.461538461538462,0.538461538461538,1
"11785","OS9",14,26,40,0.65,0.35,1
"11786","OSBP",19,45,64,0.703125,0.296875,1
"11787","OSBP2",29,43,72,0.597222222222222,0.402777777777778,1
"11788","OSBPL10",21,56,77,0.727272727272727,0.272727272727273,1
"11789","OSBPL11",23,35,58,0.603448275862069,0.396551724137931,1
"11790","OSBPL1A",49,47,96,0.489583333333333,0.510416666666667,1
"11791","OSBPL2",16,35,51,0.686274509803922,0.313725490196078,1
"11792","OSBPL3",40,55,95,0.578947368421053,0.421052631578947,1
"11793","OSBPL5",20,40,60,0.666666666666667,0.333333333333333,1
"11794","OSBPL6",53,89,142,0.626760563380282,0.373239436619718,1
"11795","OSBPL7",29,40,69,0.579710144927536,0.420289855072464,1
"11796","OSBPL8",36,49,85,0.576470588235294,0.423529411764706,1
"11797","OSBPL9",17,27,44,0.613636363636364,0.386363636363636,1
"11798","OSCAR",9,11,20,0.55,0.45,0.77
"11799","OSCP1",19,21,40,0.525,0.475,1
"11800","OSER1",8,16,24,0.666666666666667,0.333333333333333,1
"11801","OSGEP",11,22,33,0.666666666666667,0.333333333333333,1
"11802","OSGEPL1",13,17,30,0.566666666666667,0.433333333333333,1
"11803","OSGIN1",24,46,70,0.657142857142857,0.342857142857143,1
"11804","OSGIN2",19,35,54,0.648148148148148,0.351851851851852,1
"11805","OSM",16,19,35,0.542857142857143,0.457142857142857,1
"11806","OSMR",65,101,166,0.608433734939759,0.391566265060241,1
"11807","OSR1",11,22,33,0.666666666666667,0.333333333333333,1
"11808","OSR2",13,25,38,0.657894736842105,0.342105263157895,1
"11809","OST4",0,1,1,1,0,1
"11810","OSTC",4,6,10,0.6,0.4,1
"11811","OSTCP1",9,8,17,0.470588235294118,0.529411764705882,1
"11812","OSTF1",11,4,15,0.266666666666667,0.733333333333333,1
"11813","OSTM1",12,11,23,0.478260869565217,0.521739130434783,1
"11814","OSTN",7,18,25,0.72,0.28,1
"11815","OTC",25,29,54,0.537037037037037,0.462962962962963,1
"11816","OTOA",49,77,126,0.611111111111111,0.388888888888889,1
"11817","OTOF",97,161,258,0.624031007751938,0.375968992248062,1
"11818","OTOG",0,8,8,1,0,1
"11819","OTOGL",131,208,339,0.613569321533923,0.386430678466077,1
"11820","OTOL1",38,63,101,0.623762376237624,0.376237623762376,1
"11821","OTOP1",33,38,71,0.535211267605634,0.464788732394366,1
"11822","OTOP2",29,28,57,0.491228070175439,0.508771929824561,1
"11823","OTOP3",33,30,63,0.476190476190476,0.523809523809524,1
"11824","OTOR",10,16,26,0.615384615384615,0.384615384615385,1
"11825","OTOS",9,16,25,0.64,0.36,1
"11826","OTP",11,19,30,0.633333333333333,0.366666666666667,1
"11827","OTUB1",5,13,18,0.722222222222222,0.277777777777778,1
"11828","OTUB2",10,11,21,0.523809523809524,0.476190476190476,1
"11829","OTUD1",0,1,1,1,0,1
"11830","OTUD3",15,10,25,0.4,0.6,1
"11831","OTUD4",37,59,96,0.614583333333333,0.385416666666667,1
"11832","OTUD5",12,15,27,0.555555555555556,0.444444444444444,1
"11833","OTUD6A",28,28,56,0.5,0.5,1
"11834","OTUD6B",13,10,23,0.434782608695652,0.565217391304348,1
"11835","OTUD7A",26,63,89,0.707865168539326,0.292134831460674,1
"11836","OTUD7B",44,56,100,0.56,0.44,1
"11837","OTULIN",18,24,42,0.571428571428571,0.428571428571429,1
"11838","OTULINL",12,24,36,0.666666666666667,0.333333333333333,1
"11839","OTX1",20,21,41,0.51219512195122,0.48780487804878,1
"11840","OTX2",30,52,82,0.634146341463415,0.365853658536585,1
"11841","OVCA2",2,1,3,0.333333333333333,0.666666666666667,1
"11842","OVCH1",81,109,190,0.573684210526316,0.426315789473684,1
"11843","OVCH2",13,36,49,0.73469387755102,0.26530612244898,1
"11844","OVGP1",22,52,74,0.702702702702703,0.297297297297297,1
"11845","OVOL1",9,14,23,0.608695652173913,0.391304347826087,1
"11846","OVOL2",9,16,25,0.64,0.36,1
"11847","OXA1L",16,30,46,0.652173913043478,0.347826086956522,1
"11848","OXCT1",15,34,49,0.693877551020408,0.306122448979592,1
"11849","OXCT2",17,21,38,0.552631578947368,0.447368421052632,1
"11850","OXER1",16,19,35,0.542857142857143,0.457142857142857,1
"11851","OXGR1",12,32,44,0.727272727272727,0.272727272727273,1
"11852","OXLD1",8,5,13,0.384615384615385,0.615384615384615,1
"11853","OXNAD1",10,16,26,0.615384615384615,0.384615384615385,1
"11854","OXR1",38,44,82,0.536585365853659,0.463414634146341,1
"11855","OXSM",18,35,53,0.660377358490566,0.339622641509434,1
"11856","OXSR1",25,31,56,0.553571428571429,0.446428571428571,1
"11857","OXT",11,2,13,0.153846153846154,0.846153846153846,1
"11858","OXTR",14,14,28,0.5,0.5,1
"11859","P2RX1",24,13,37,0.351351351351351,0.648648648648649,1
"11860","P2RX2",27,26,53,0.490566037735849,0.509433962264151,1
"11861","P2RX3",13,33,46,0.717391304347826,0.282608695652174,1
"11862","P2RX4",13,17,30,0.566666666666667,0.433333333333333,1
"11863","P2RX5",17,26,43,0.604651162790698,0.395348837209302,1
"11864","P2RX6",3,17,20,0.85,0.15,1
"11865","P2RX7",12,22,34,0.647058823529412,0.352941176470588,1
"11866","P2RY1",12,30,42,0.714285714285714,0.285714285714286,1
"11867","P2RY10",43,45,88,0.511363636363636,0.488636363636364,1
"11868","P2RY12",12,28,40,0.7,0.3,1
"11869","P2RY13",15,30,45,0.666666666666667,0.333333333333333,1
"11870","P2RY14",16,32,48,0.666666666666667,0.333333333333333,1
"11871","P2RY2",17,31,48,0.645833333333333,0.354166666666667,1
"11872","P2RY4",25,20,45,0.444444444444444,0.555555555555556,1
"11873","P2RY6",12,20,32,0.625,0.375,1
"11874","P2RY8",36,52,88,0.590909090909091,0.409090909090909,1
"11875","P3H1",26,32,58,0.551724137931034,0.448275862068966,1
"11876","P3H2",33,68,101,0.673267326732673,0.326732673267327,1
"11877","P3H3",32,31,63,0.492063492063492,0.507936507936508,1
"11878","P3H4",6,22,28,0.785714285714286,0.214285714285714,1
"11879","P4HA1",15,36,51,0.705882352941177,0.294117647058824,1
"11880","P4HA2",27,18,45,0.4,0.6,1
"11881","P4HA3",17,33,50,0.66,0.34,1
"11882","P4HB",21,33,54,0.611111111111111,0.388888888888889,1
"11883","P4HTM",16,22,38,0.578947368421053,0.421052631578947,1
"11884","PA2G4",12,22,34,0.647058823529412,0.352941176470588,1
"11885","PAAF1",11,25,36,0.694444444444444,0.305555555555556,1
"11886","PABPC1",18,31,49,0.63265306122449,0.36734693877551,1
"11887","PABPC1L",20,30,50,0.6,0.4,1
"11888","PABPC1L2A",1,0,1,0,1,1
"11889","PABPC3",37,61,98,0.622448979591837,0.377551020408163,1
"11890","PABPC4",33,45,78,0.576923076923077,0.423076923076923,1
"11891","PABPC4L",0,8,8,1,0,1
"11892","PABPC5",48,52,100,0.52,0.48,1
"11893","PABPN1",10,10,20,0.5,0.5,1
"11894","PABPN1L",2,8,10,0.8,0.2,1
"11895","PACC1",17,25,42,0.595238095238095,0.404761904761905,1
"11896","PACRG",22,39,61,0.639344262295082,0.360655737704918,0.37
"11897","PACRGL",27,13,40,0.325,0.675,0.37
"11898","PACS1",24,42,66,0.636363636363636,0.363636363636364,1
"11899","PACS2",29,53,82,0.646341463414634,0.353658536585366,1
"11900","PACSIN1",19,32,51,0.627450980392157,0.372549019607843,1
"11901","PACSIN2",15,23,38,0.605263157894737,0.394736842105263,1
"11902","PACSIN3",11,28,39,0.717948717948718,0.282051282051282,1
"11903","PADI1",28,48,76,0.631578947368421,0.368421052631579,1
"11904","PADI2",25,48,73,0.657534246575342,0.342465753424658,1
"11905","PADI3",37,64,101,0.633663366336634,0.366336633663366,1
"11906","PADI4",19,56,75,0.746666666666667,0.253333333333333,1
"11907","PADI6",25,36,61,0.590163934426229,0.409836065573771,1
"11908","PAEP",5,7,12,0.583333333333333,0.416666666666667,1
"11909","PAF1",20,27,47,0.574468085106383,0.425531914893617,1
"11910","PAFAH1B1",15,29,44,0.659090909090909,0.340909090909091,1
"11911","PAFAH1B2",5,8,13,0.615384615384615,0.384615384615385,1
"11912","PAFAH1B3",4,6,10,0.6,0.4,1
"11913","PAFAH2",17,20,37,0.540540540540541,0.459459459459459,1
"11914","PAG1",13,19,32,0.59375,0.40625,1
"11915","PAGE1",15,6,21,0.285714285714286,0.714285714285714,1
"11916","PAGE2",9,8,17,0.470588235294118,0.529411764705882,1
"11917","PAGE2B",4,4,8,0.5,0.5,1
"11918","PAGE3",13,10,23,0.434782608695652,0.565217391304348,1
"11919","PAGE4",4,9,13,0.692307692307692,0.307692307692308,1
"11920","PAGE5",13,9,22,0.409090909090909,0.590909090909091,1
"11921","PAGR1",8,9,17,0.529411764705882,0.470588235294118,1
"11922","PAH",38,61,99,0.616161616161616,0.383838383838384,1
"11923","PAICS",3,9,12,0.75,0.25,1
"11924","PAIP1",14,41,55,0.745454545454545,0.254545454545455,1
"11925","PAIP2",3,11,14,0.785714285714286,0.214285714285714,1
"11926","PAIP2B",0,8,8,1,0,1
"11927","PAK1",24,18,42,0.428571428571429,0.571428571428571,1
"11928","PAK1IP1",17,10,27,0.37037037037037,0.62962962962963,1
"11929","PAK2",22,35,57,0.614035087719298,0.385964912280702,1
"11930","PAK3",31,60,91,0.659340659340659,0.340659340659341,0.54
"11931","PAK4",21,27,48,0.5625,0.4375,1
"11932","PAK5",74,146,220,0.663636363636364,0.336363636363636,0.95
"11933","PAK6",12,32,44,0.727272727272727,0.272727272727273,1
"11934","PALB2",38,74,112,0.660714285714286,0.339285714285714,0.86
"11935","PALD1",29,76,105,0.723809523809524,0.276190476190476,1
"11936","PALLD",38,74,112,0.660714285714286,0.339285714285714,1
"11937","PALM",17,16,33,0.484848484848485,0.515151515151515,1
"11938","PALM2AKAP2",52,79,131,0.603053435114504,0.396946564885496,1
"11939","PALM3",1,4,5,0.8,0.2,1
"11940","PALMD",19,43,62,0.693548387096774,0.306451612903226,1
"11941","PAM",46,68,114,0.596491228070175,0.403508771929825,1
"11942","PAMR1",39,68,107,0.635514018691589,0.364485981308411,1
"11943","PAN2",42,60,102,0.588235294117647,0.411764705882353,1
"11944","PAN3",27,57,84,0.678571428571429,0.321428571428571,1
"11945","PANK1",12,29,41,0.707317073170732,0.292682926829268,0.44
"11946","PANK2",18,18,36,0.5,0.5,0.21
"11947","PANK3",11,23,34,0.676470588235294,0.323529411764706,0.14
"11948","PANK4",20,32,52,0.615384615384615,0.384615384615385,1
"11949","PANX1",17,16,33,0.484848484848485,0.515151515151515,1
"11950","PANX2",15,30,45,0.666666666666667,0.333333333333333,1
"11951","PANX3",17,38,55,0.690909090909091,0.309090909090909,1
"11952","PAOX",13,20,33,0.606060606060606,0.393939393939394,1
"11953","PAPLN",39,66,105,0.628571428571429,0.371428571428571,1
"11954","PAPOLA",37,37,74,0.5,0.5,1
"11955","PAPOLB",29,54,83,0.650602409638554,0.349397590361446,1
"11956","PAPOLG",26,46,72,0.638888888888889,0.361111111111111,1
"11957","PAPPA",107,192,299,0.642140468227425,0.357859531772575,1
"11958","PAPPA2",233,427,660,0.646969696969697,0.353030303030303,1
"11959","PAPSS1",17,32,49,0.653061224489796,0.346938775510204,1
"11960","PAPSS2",18,36,54,0.666666666666667,0.333333333333333,1
"11961","PAQR3",15,17,32,0.53125,0.46875,0.8
"11962","PAQR4",6,9,15,0.6,0.4,0.8
"11963","PAQR5",9,18,27,0.666666666666667,0.333333333333333,0.8
"11964","PAQR6",8,17,25,0.68,0.32,0.8
"11965","PAQR7",9,10,19,0.526315789473684,0.473684210526316,0.8
"11966","PAQR8",20,17,37,0.459459459459459,0.540540540540541,0.8
"11967","PAQR9",24,50,74,0.675675675675676,0.324324324324324,0.8
"11968","PARD3",48,120,168,0.714285714285714,0.285714285714286,0.77
"11969","PARD3B",76,112,188,0.595744680851064,0.404255319148936,0.77
"11970","PARD6A",11,7,18,0.388888888888889,0.611111111111111,0.77
"11971","PARD6B",11,28,39,0.717948717948718,0.282051282051282,0.77
"11972","PARD6G",8,18,26,0.692307692307692,0.307692307692308,0.77
"11973","PARG",0,6,6,1,0,0.77
"11974","PARGP1",25,30,55,0.545454545454545,0.454545454545455,0.77
"11975","PARK7",6,6,12,0.5,0.5,0.77
"11976","PARL",1,2,3,0.666666666666667,0.333333333333333,0.77
"11977","PARM1",22,34,56,0.607142857142857,0.392857142857143,0.77
"11978","PARN",23,30,53,0.566037735849057,0.433962264150943,0.77
"11979","PARP1",29,62,91,0.681318681318681,0.318681318681319,0.77
"11980","PARP10",28,36,64,0.5625,0.4375,0.77
"11981","PARP11",15,22,37,0.594594594594595,0.405405405405405,0.77
"11982","PARP12",26,44,70,0.628571428571429,0.371428571428571,0.77
"11983","PARP14",56,100,156,0.641025641025641,0.358974358974359,0.77
"11984","PARP15",24,34,58,0.586206896551724,0.413793103448276,0.77
"11985","PARP16",11,18,29,0.620689655172414,0.379310344827586,0.77
"11986","PARP2",12,31,43,0.720930232558139,0.27906976744186,0.77
"11987","PARP3",15,21,36,0.583333333333333,0.416666666666667,0.77
"11988","PARP4",57,78,135,0.577777777777778,0.422222222222222,0.77
"11989","PARP6",20,41,61,0.672131147540984,0.327868852459016,0.77
"11990","PARP8",43,89,132,0.674242424242424,0.325757575757576,0.77
"11991","PARP9",37,46,83,0.55421686746988,0.44578313253012,0.77
"11992","PARPBP",20,30,50,0.6,0.4,0.77
"11993","PARS2",12,15,27,0.555555555555556,0.444444444444444,0.77
"11994","PARVA",7,13,20,0.65,0.35,0.77
"11995","PARVB",17,20,37,0.540540540540541,0.459459459459459,0.77
"11996","PARVG",20,20,40,0.5,0.5,0.77
"11997","PASD1",71,87,158,0.550632911392405,0.449367088607595,1
"11998","PASK",56,75,131,0.572519083969466,0.427480916030534,1
"11999","PATE1",11,16,27,0.592592592592593,0.407407407407407,1
"12000","PATE2",6,8,14,0.571428571428571,0.428571428571429,1
"12001","PATE4",0,1,1,1,0,1
"12002","PATJ",72,128,200,0.64,0.36,1
"12003","PATL1",12,30,42,0.714285714285714,0.285714285714286,1
"12004","PATL2",0,1,1,1,0,1
"12005","PATZ1",27,33,60,0.55,0.45,1
"12006","PAWR",13,11,24,0.458333333333333,0.541666666666667,1
"12007","PAX1",35,59,94,0.627659574468085,0.372340425531915,1
"12008","PAX2",27,46,73,0.63013698630137,0.36986301369863,1
"12009","PAX3",30,52,82,0.634146341463415,0.365853658536585,1
"12010","PAX4",27,45,72,0.625,0.375,1
"12011","PAX5",30,40,70,0.571428571428571,0.428571428571429,1
"12012","PAX6",38,53,91,0.582417582417582,0.417582417582418,1
"12013","PAX7",28,46,74,0.621621621621622,0.378378378378378,1
"12014","PAX8",20,40,60,0.666666666666667,0.333333333333333,1
"12015","PAX9",19,23,42,0.547619047619048,0.452380952380952,1
"12016","PAXBP1",33,46,79,0.582278481012658,0.417721518987342,1
"12017","PAXIP1",27,43,70,0.614285714285714,0.385714285714286,1
"12018","PAXIP1-AS2",0,1,1,1,0,1
"12019","PAXX",4,8,12,0.666666666666667,0.333333333333333,1
"12020","PBDC1",14,9,23,0.391304347826087,0.608695652173913,1
"12021","PBK",5,9,14,0.642857142857143,0.357142857142857,1
"12022","PBLD",9,20,29,0.689655172413793,0.310344827586207,1
"12023","PBOV1",4,5,9,0.555555555555556,0.444444444444444,1
"12024","PBRM1",122,231,353,0.654390934844193,0.345609065155807,1
"12025","PBX1",24,45,69,0.652173913043478,0.347826086956522,1
"12026","PBX2",22,26,48,0.541666666666667,0.458333333333333,1
"12027","PBX3",16,27,43,0.627906976744186,0.372093023255814,1
"12028","PBX4",14,13,27,0.481481481481481,0.518518518518518,1
"12029","PBXIP1",30,39,69,0.565217391304348,0.434782608695652,1
"12030","PC",52,68,120,0.566666666666667,0.433333333333333,1
"12031","PCARE",64,107,171,0.625730994152047,0.374269005847953,0.77
"12032","PCBD1",3,1,4,0.25,0.75,1
"12033","PCBD2",4,4,8,0.5,0.5,1
"12034","PCBP1",24,38,62,0.612903225806452,0.387096774193548,1
"12035","PCBP2",17,20,37,0.540540540540541,0.459459459459459,1
"12036","PCBP3",15,33,48,0.6875,0.3125,1
"12037","PCBP4",9,14,23,0.608695652173913,0.391304347826087,1
"12038","PCCA",41,47,88,0.534090909090909,0.465909090909091,1
"12039","PCCB",13,21,34,0.617647058823529,0.382352941176471,1
"12040","PCDH1",52,81,133,0.609022556390977,0.390977443609023,1
"12041","PCDH10",145,208,353,0.589235127478754,0.410764872521246,1
"12042","PCDH11X",244,213,457,0.466083150984683,0.533916849015317,1
"12043","PCDH11Y",0,151,151,1,0,1
"12044","PCDH12",42,75,117,0.641025641025641,0.358974358974359,1
"12045","PCDH15",268,532,800,0.665,0.335,1
"12046","PCDH17",138,204,342,0.596491228070175,0.403508771929825,1
"12047","PCDH18",93,200,293,0.68259385665529,0.31740614334471,1
"12048","PCDH19",109,89,198,0.44949494949495,0.55050505050505,1
"12049","PCDH7",76,111,187,0.593582887700535,0.406417112299465,1
"12050","PCDH8",53,83,136,0.610294117647059,0.389705882352941,1
"12051","PCDH9",106,150,256,0.5859375,0.4140625,1
"12052","PCDHA1",96,137,233,0.587982832618026,0.412017167381974,1
"12053","PCDHA10",44,79,123,0.642276422764228,0.357723577235772,1
"12054","PCDHA11",82,114,196,0.581632653061224,0.418367346938776,1
"12055","PCDHA12",89,136,225,0.604444444444444,0.395555555555556,1
"12056","PCDHA13",69,130,199,0.653266331658292,0.346733668341709,1
"12057","PCDHA2",102,140,242,0.578512396694215,0.421487603305785,1
"12058","PCDHA3",95,138,233,0.592274678111588,0.407725321888412,1
"12059","PCDHA4",75,142,217,0.654377880184332,0.345622119815668,1
"12060","PCDHA5",86,120,206,0.58252427184466,0.41747572815534,1
"12061","PCDHA6",79,143,222,0.644144144144144,0.355855855855856,1
"12062","PCDHA7",81,138,219,0.63013698630137,0.36986301369863,1
"12063","PCDHA8",81,162,243,0.666666666666667,0.333333333333333,1
"12064","PCDHA9",69,120,189,0.634920634920635,0.365079365079365,1
"12065","PCDHAC1",74,115,189,0.608465608465608,0.391534391534392,1
"12066","PCDHAC2",45,89,134,0.664179104477612,0.335820895522388,1
"12067","PCDHB1",61,104,165,0.63030303030303,0.36969696969697,1
"12068","PCDHB10",53,114,167,0.682634730538922,0.317365269461078,1
"12069","PCDHB11",62,111,173,0.641618497109827,0.358381502890173,1
"12070","PCDHB12",77,121,198,0.611111111111111,0.388888888888889,1
"12071","PCDHB13",63,102,165,0.618181818181818,0.381818181818182,1
"12072","PCDHB14",79,99,178,0.556179775280899,0.443820224719101,1
"12073","PCDHB15",52,94,146,0.643835616438356,0.356164383561644,1
"12074","PCDHB16",62,94,156,0.602564102564103,0.397435897435897,1
"12075","PCDHB2",70,137,207,0.661835748792271,0.338164251207729,1
"12076","PCDHB3",109,130,239,0.543933054393305,0.456066945606695,1
"12077","PCDHB4",78,126,204,0.617647058823529,0.382352941176471,1
"12078","PCDHB5",101,134,235,0.570212765957447,0.429787234042553,1
"12079","PCDHB6",75,144,219,0.657534246575342,0.342465753424658,1
"12080","PCDHB7",93,183,276,0.66304347826087,0.33695652173913,1
"12081","PCDHB8",117,190,307,0.618892508143323,0.381107491856678,1
"12082","PCDHB9",73,122,195,0.625641025641026,0.374358974358974,1
"12083","PCDHGA1",74,123,197,0.624365482233503,0.375634517766497,1
"12084","PCDHGA10",38,62,100,0.62,0.38,1
"12085","PCDHGA11",46,70,116,0.603448275862069,0.396551724137931,1
"12086","PCDHGA12",61,81,142,0.570422535211268,0.429577464788732,1
"12087","PCDHGA2",80,129,209,0.617224880382775,0.382775119617225,1
"12088","PCDHGA3",70,109,179,0.608938547486033,0.391061452513966,1
"12089","PCDHGA4",51,112,163,0.687116564417178,0.312883435582822,1
"12090","PCDHGA5",67,99,166,0.596385542168675,0.403614457831325,1
"12091","PCDHGA6",60,104,164,0.634146341463415,0.365853658536585,1
"12092","PCDHGA7",55,84,139,0.60431654676259,0.39568345323741,1
"12093","PCDHGA8",71,103,174,0.591954022988506,0.408045977011494,1
"12094","PCDHGA9",51,70,121,0.578512396694215,0.421487603305785,1
"12095","PCDHGB1",71,81,152,0.532894736842105,0.467105263157895,1
"12096","PCDHGB2",55,102,157,0.64968152866242,0.35031847133758,1
"12097","PCDHGB3",64,93,157,0.592356687898089,0.407643312101911,1
"12098","PCDHGB4",54,96,150,0.64,0.36,1
"12099","PCDHGB5",43,75,118,0.635593220338983,0.364406779661017,1
"12100","PCDHGB6",55,67,122,0.549180327868853,0.450819672131148,1
"12101","PCDHGB7",49,68,117,0.581196581196581,0.418803418803419,1
"12102","PCDHGC3",40,42,82,0.51219512195122,0.48780487804878,1
"12103","PCDHGC4",23,65,88,0.738636363636364,0.261363636363636,1
"12104","PCDHGC5",30,43,73,0.589041095890411,0.410958904109589,1
"12105","PCED1A",16,24,40,0.6,0.4,1
"12106","PCED1B",22,63,85,0.741176470588235,0.258823529411765,1
"12107","PCF11",67,114,181,0.629834254143646,0.370165745856354,1
"12108","PCGF1",8,18,26,0.692307692307692,0.307692307692308,1
"12109","PCGF2",19,18,37,0.486486486486487,0.513513513513513,1
"12110","PCGF3",11,20,31,0.645161290322581,0.354838709677419,1
"12111","PCGF5",12,22,34,0.647058823529412,0.352941176470588,1
"12112","PCGF6",5,7,12,0.583333333333333,0.416666666666667,1
"12113","PCID2",15,26,41,0.634146341463415,0.365853658536585,1
"12114","PCIF1",23,31,54,0.574074074074074,0.425925925925926,1
"12115","PCK1",47,72,119,0.605042016806723,0.394957983193277,1
"12116","PCK2",19,26,45,0.577777777777778,0.422222222222222,1
"12117","PCLAF",6,7,13,0.538461538461538,0.461538461538462,1
"12118","PCLO",439,894,1333,0.670667666916729,0.329332333083271,1
"12119","PCM1",47,56,103,0.543689320388349,0.456310679611651,1
"12120","PCMT1",6,10,16,0.625,0.375,1
"12121","PCMTD1",11,30,41,0.731707317073171,0.268292682926829,1
"12122","PCMTD2",22,22,44,0.5,0.5,1
"12123","PCNA",10,19,29,0.655172413793103,0.344827586206897,1
"12124","PCNP",4,6,10,0.6,0.4,1
"12125","PCNT",96,159,255,0.623529411764706,0.376470588235294,1
"12126","PCNX1",74,134,208,0.644230769230769,0.355769230769231,1
"12127","PCNX2",94,171,265,0.645283018867924,0.354716981132075,1
"12128","PCNX3",56,66,122,0.540983606557377,0.459016393442623,1
"12129","PCNX4",30,46,76,0.605263157894737,0.394736842105263,1
"12130","PCOLCE",10,27,37,0.72972972972973,0.27027027027027,1
"12131","PCOLCE2",34,49,83,0.590361445783133,0.409638554216867,1
"12132","PCP2",4,3,7,0.428571428571429,0.571428571428571,1
"12133","PCP4",5,7,12,0.583333333333333,0.416666666666667,1
"12134","PCP4L1",2,7,9,0.777777777777778,0.222222222222222,1
"12135","PCSK1",50,69,119,0.579831932773109,0.420168067226891,1
"12136","PCSK1N",2,0,2,0,1,1
"12137","PCSK2",29,72,101,0.712871287128713,0.287128712871287,1
"12138","PCSK4",26,29,55,0.527272727272727,0.472727272727273,1
"12139","PCSK5",95,152,247,0.615384615384615,0.384615384615385,1
"12140","PCSK6",37,50,87,0.574712643678161,0.425287356321839,1
"12141","PCSK7",31,44,75,0.586666666666667,0.413333333333333,1
"12142","PCSK9",12,40,52,0.769230769230769,0.230769230769231,1
"12143","PCTP",9,11,20,0.55,0.45,1
"12144","PCYOX1",10,21,31,0.67741935483871,0.32258064516129,1
"12145","PCYOX1L",18,20,38,0.526315789473684,0.473684210526316,1
"12146","PCYT1A",21,18,39,0.461538461538462,0.538461538461538,1
"12147","PCYT1B",26,24,50,0.48,0.52,1
"12148","PCYT2",6,24,30,0.8,0.2,1
"12149","PDAP1",6,11,17,0.647058823529412,0.352941176470588,1
"12150","PDC",9,12,21,0.571428571428571,0.428571428571429,1
"12151","PDCD1",15,17,32,0.53125,0.46875,1
"12152","PDCD10",9,17,26,0.653846153846154,0.346153846153846,1
"12153","PDCD11",52,77,129,0.596899224806202,0.403100775193798,1
"12154","PDCD1LG2",9,11,20,0.55,0.45,1
"12155","PDCD2",7,9,16,0.5625,0.4375,1
"12156","PDCD2L",8,16,24,0.666666666666667,0.333333333333333,1
"12157","PDCD4",16,25,41,0.609756097560976,0.390243902439024,1
"12158","PDCD5",6,9,15,0.6,0.4,1
"12159","PDCD6",9,7,16,0.4375,0.5625,1
"12160","PDCD6IP",25,38,63,0.603174603174603,0.396825396825397,1
"12161","PDCD7",12,22,34,0.647058823529412,0.352941176470588,1
"12162","PDCL",18,15,33,0.454545454545455,0.545454545454545,1
"12163","PDCL2",2,17,19,0.894736842105263,0.105263157894737,1
"12164","PDCL3",22,18,40,0.45,0.55,1
"12165","PDE10A",64,97,161,0.602484472049689,0.397515527950311,1
"12166","PDE11A",55,100,155,0.645161290322581,0.354838709677419,1
"12167","PDE12",10,21,31,0.67741935483871,0.32258064516129,1
"12168","PDE1A",40,81,121,0.669421487603306,0.330578512396694,1
"12169","PDE1B",41,63,104,0.605769230769231,0.394230769230769,1
"12170","PDE1C",95,151,246,0.613821138211382,0.386178861788618,1
"12171","PDE2A",22,63,85,0.741176470588235,0.258823529411765,1
"12172","PDE3A",95,138,233,0.592274678111588,0.407725321888412,1
"12173","PDE3B",42,67,109,0.614678899082569,0.385321100917431,1
"12174","PDE4A",25,42,67,0.626865671641791,0.373134328358209,1
"12175","PDE4B",30,42,72,0.583333333333333,0.416666666666667,1
"12176","PDE4C",0,1,1,1,0,1
"12177","PDE4D",30,36,66,0.545454545454545,0.454545454545455,1
"12178","PDE4DIP",76,113,189,0.597883597883598,0.402116402116402,1
"12179","PDE5A",37,57,94,0.606382978723404,0.393617021276596,1
"12180","PDE6A",40,64,104,0.615384615384615,0.384615384615385,1
"12181","PDE6B",35,66,101,0.653465346534653,0.346534653465347,1
"12182","PDE6C",39,61,100,0.61,0.39,1
"12183","PDE6D",5,5,10,0.5,0.5,1
"12184","PDE6G",2,9,11,0.818181818181818,0.181818181818182,1
"12185","PDE6H",7,3,10,0.3,0.7,1
"12186","PDE7A",20,17,37,0.459459459459459,0.540540540540541,1
"12187","PDE7B",24,38,62,0.612903225806452,0.387096774193548,1
"12188","PDE8A",32,39,71,0.549295774647887,0.450704225352113,1
"12189","PDE8B",44,73,117,0.623931623931624,0.376068376068376,1
"12190","PDE9A",29,47,76,0.618421052631579,0.381578947368421,1
"12191","PDF",2,1,3,0.333333333333333,0.666666666666667,1
"12192","PDGFA",5,19,24,0.791666666666667,0.208333333333333,1
"12193","PDGFB",8,18,26,0.692307692307692,0.307692307692308,1
"12194","PDGFC",23,45,68,0.661764705882353,0.338235294117647,1
"12195","PDGFD",30,48,78,0.615384615384615,0.384615384615385,1
"12196","PDGFRA",89,159,248,0.641129032258065,0.358870967741935,1
"12197","PDGFRB",36,88,124,0.709677419354839,0.290322580645161,1
"12198","PDGFRL",9,26,35,0.742857142857143,0.257142857142857,1
"12199","PDHA1",24,12,36,0.333333333333333,0.666666666666667,1
"12200","PDHA2",48,95,143,0.664335664335664,0.335664335664336,1
"12201","PDHB",9,9,18,0.5,0.5,1
"12202","PDHX",14,18,32,0.5625,0.4375,1
"12203","PDIA2",14,34,48,0.708333333333333,0.291666666666667,1
"12204","PDIA3",27,20,47,0.425531914893617,0.574468085106383,1
"12205","PDIA4",21,28,49,0.571428571428571,0.428571428571429,1
"12206","PDIA5",27,26,53,0.490566037735849,0.509433962264151,1
"12207","PDIA6",9,24,33,0.727272727272727,0.272727272727273,1
"12208","PDIK1L",6,14,20,0.7,0.3,1
"12209","PDILT",42,84,126,0.666666666666667,0.333333333333333,1
"12210","PDK1",16,17,33,0.515151515151515,0.484848484848485,1
"12211","PDK2",7,22,29,0.758620689655172,0.241379310344828,1
"12212","PDK3",24,16,40,0.4,0.6,1
"12213","PDK4",16,31,47,0.659574468085106,0.340425531914894,1
"12214","PDLIM1",22,18,40,0.45,0.55,1
"12215","PDLIM2",13,24,37,0.648648648648649,0.351351351351351,1
"12216","PDLIM3",7,12,19,0.631578947368421,0.368421052631579,1
"12217","PDLIM4",12,18,30,0.6,0.4,1
"12218","PDLIM5",30,40,70,0.571428571428571,0.428571428571429,1
"12219","PDLIM7",12,12,24,0.5,0.5,1
"12220","PDP1",18,30,48,0.625,0.375,1
"12221","PDP2",9,22,31,0.709677419354839,0.290322580645161,1
"12222","PDPK1",4,14,18,0.777777777777778,0.222222222222222,1
"12223","PDPN",13,19,32,0.59375,0.40625,1
"12224","PDPR",31,44,75,0.586666666666667,0.413333333333333,1
"12225","PDRG1",6,5,11,0.454545454545455,0.545454545454545,1
"12226","PDS5A",49,74,123,0.601626016260163,0.398373983739837,1
"12227","PDS5B",62,90,152,0.592105263157895,0.407894736842105,1
"12228","PDSS1",18,27,45,0.6,0.4,1
"12229","PDSS2",8,25,33,0.757575757575758,0.242424242424242,1
"12230","PDX1",11,9,20,0.45,0.55,1
"12231","PDXDC1",19,38,57,0.666666666666667,0.333333333333333,1
"12232","PDXK",4,10,14,0.714285714285714,0.285714285714286,1
"12233","PDXP",1,6,7,0.857142857142857,0.142857142857143,1
"12234","PDYN",33,65,98,0.663265306122449,0.336734693877551,1
"12235","PDZD11",7,5,12,0.416666666666667,0.583333333333333,1
"12236","PDZD2",127,240,367,0.653950953678474,0.346049046321526,1
"12237","PDZD3",9,23,32,0.71875,0.28125,1
"12238","PDZD4",45,34,79,0.430379746835443,0.569620253164557,1
"12239","PDZD7",22,27,49,0.551020408163265,0.448979591836735,1
"12240","PDZD8",32,67,99,0.676767676767677,0.323232323232323,1
"12241","PDZD9",8,18,26,0.692307692307692,0.307692307692308,1
"12242","PDZK1",9,20,29,0.689655172413793,0.310344827586207,1
"12243","PDZK1IP1",3,6,9,0.666666666666667,0.333333333333333,1
"12244","PDZRN3",73,124,197,0.629441624365482,0.370558375634518,1
"12245","PDZRN4",79,132,211,0.625592417061611,0.374407582938389,1
"12246","PEA15",2,7,9,0.777777777777778,0.222222222222222,1
"12247","PEAK1",70,103,173,0.595375722543353,0.404624277456647,1
"12248","PEAK3",8,12,20,0.6,0.4,0.54
"12249","PEAR1",40,71,111,0.63963963963964,0.36036036036036,0.77
"12250","PEBP1",5,10,15,0.666666666666667,0.333333333333333,1
"12251","PEBP4",5,14,19,0.736842105263158,0.263157894736842,1
"12252","PECAM1",2,3,5,0.6,0.4,1
"12253","PECR",9,13,22,0.590909090909091,0.409090909090909,1
"12254","PEDS1",9,4,13,0.307692307692308,0.692307692307692,1
"12255","PEDS1-UBE2V1",7,6,13,0.461538461538462,0.538461538461538,1
"12256","PEF1",7,10,17,0.588235294117647,0.411764705882353,1
"12257","PEG10",21,30,51,0.588235294117647,0.411764705882353,1
"12258","PEG3",193,308,501,0.614770459081836,0.385229540918164,1
"12259","PELI1",19,14,33,0.424242424242424,0.575757575757576,1
"12260","PELI2",22,27,49,0.551020408163265,0.448979591836735,1
"12261","PELI3",15,22,37,0.594594594594595,0.405405405405405,1
"12262","PELO",11,15,26,0.576923076923077,0.423076923076923,1
"12263","PELP1",48,41,89,0.460674157303371,0.539325842696629,1
"12264","PEMT",5,7,12,0.583333333333333,0.416666666666667,1
"12265","PENK",34,54,88,0.613636363636364,0.386363636363636,1
"12266","PEPD",9,24,33,0.727272727272727,0.272727272727273,1
"12267","PER1",34,61,95,0.642105263157895,0.357894736842105,1
"12268","PER2",35,61,96,0.635416666666667,0.364583333333333,1
"12269","PER3",40,68,108,0.62962962962963,0.37037037037037,1
"12270","PERM1",0,1,1,1,0,1
"12271","PERP",12,8,20,0.4,0.6,1
"12272","PES1",16,26,42,0.619047619047619,0.380952380952381,1
"12273","PEX1",41,71,112,0.633928571428571,0.366071428571429,1
"12274","PEX10",7,12,19,0.631578947368421,0.368421052631579,1
"12275","PEX11A",3,23,26,0.884615384615385,0.115384615384615,1
"12276","PEX11B",9,15,24,0.625,0.375,1
"12277","PEX11G",3,8,11,0.727272727272727,0.272727272727273,1
"12278","PEX12",7,31,38,0.815789473684211,0.184210526315789,1
"12279","PEX13",10,21,31,0.67741935483871,0.32258064516129,1
"12280","PEX14",11,20,31,0.645161290322581,0.354838709677419,1
"12281","PEX16",18,14,32,0.4375,0.5625,1
"12282","PEX19",9,15,24,0.625,0.375,1
"12283","PEX2",14,26,40,0.65,0.35,1
"12284","PEX26",5,11,16,0.6875,0.3125,1
"12285","PEX3",16,14,30,0.466666666666667,0.533333333333333,1
"12286","PEX5",16,28,44,0.636363636363636,0.363636363636364,1
"12287","PEX5L",48,73,121,0.603305785123967,0.396694214876033,1
"12288","PEX6",20,29,49,0.591836734693878,0.408163265306122,1
"12289","PEX7",8,11,19,0.578947368421053,0.421052631578947,1
"12290","PF4",2,4,6,0.666666666666667,0.333333333333333,1
"12291","PF4V1",6,3,9,0.333333333333333,0.666666666666667,1
"12292","PFAS",46,57,103,0.553398058252427,0.446601941747573,1
"12293","PFDN1",2,5,7,0.714285714285714,0.285714285714286,1
"12294","PFDN2",4,7,11,0.636363636363636,0.363636363636364,1
"12295","PFDN4",5,9,14,0.642857142857143,0.357142857142857,1
"12296","PFDN5",1,10,11,0.909090909090909,0.0909090909090909,1
"12297","PFDN6",5,4,9,0.444444444444444,0.555555555555556,1
"12298","PFKFB1",54,19,73,0.26027397260274,0.73972602739726,1
"12299","PFKFB2",16,26,42,0.619047619047619,0.380952380952381,1
"12300","PFKFB3",16,35,51,0.686274509803922,0.313725490196078,1
"12301","PFKFB4",14,26,40,0.65,0.35,1
"12302","PFKL",22,42,64,0.65625,0.34375,1
"12303","PFKM",17,32,49,0.653061224489796,0.346938775510204,1
"12304","PFKP",42,46,88,0.522727272727273,0.477272727272727,1
"12305","PFN1",5,7,12,0.583333333333333,0.416666666666667,1
"12306","PFN2",3,4,7,0.571428571428571,0.428571428571429,1
"12307","PFN3",3,4,7,0.571428571428571,0.428571428571429,1
"12308","PFN4",3,9,12,0.75,0.25,1
"12309","PGA3",2,8,10,0.8,0.2,1
"12310","PGA5",7,12,19,0.631578947368421,0.368421052631579,1
"12311","PGAM1",10,4,14,0.285714285714286,0.714285714285714,1
"12312","PGAM2",7,28,35,0.8,0.2,1
"12313","PGAM4",18,7,25,0.28,0.72,1
"12314","PGAM5",10,7,17,0.411764705882353,0.588235294117647,1
"12315","PGAP1",31,53,84,0.630952380952381,0.369047619047619,1
"12316","PGAP2",7,12,19,0.631578947368421,0.368421052631579,1
"12317","PGAP3",4,9,13,0.692307692307692,0.307692307692308,1
"12318","PGAP4",27,24,51,0.470588235294118,0.529411764705882,1
"12319","PGAP6",25,27,52,0.519230769230769,0.480769230769231,1
"12320","PGBD1",35,77,112,0.6875,0.3125,1
"12321","PGBD2",22,42,64,0.65625,0.34375,1
"12322","PGBD4",22,35,57,0.614035087719298,0.385964912280702,1
"12323","PGBD5",19,38,57,0.666666666666667,0.333333333333333,1
"12324","PGC",14,31,45,0.688888888888889,0.311111111111111,1
"12325","PGD",12,35,47,0.74468085106383,0.25531914893617,1
"12326","PGF",5,11,16,0.6875,0.3125,1
"12327","PGGHG",16,21,37,0.567567567567568,0.432432432432432,1
"12328","PGGT1B",14,15,29,0.517241379310345,0.482758620689655,1
"12329","PGK1",28,11,39,0.282051282051282,0.717948717948718,1
"12330","PGK2",45,88,133,0.661654135338346,0.338345864661654,1
"12331","PGLS",6,9,15,0.6,0.4,1
"12332","PGLYRP1",7,13,20,0.65,0.35,1
"12333","PGLYRP2",22,62,84,0.738095238095238,0.261904761904762,1
"12334","PGLYRP3",17,32,49,0.653061224489796,0.346938775510204,1
"12335","PGLYRP4",23,43,66,0.651515151515151,0.348484848484849,1
"12336","PGM1",15,25,40,0.625,0.375,1
"12337","PGM2",14,32,46,0.695652173913043,0.304347826086957,1
"12338","PGM2L1",10,35,45,0.777777777777778,0.222222222222222,1
"12339","PGM3",16,30,46,0.652173913043478,0.347826086956522,1
"12340","PGM5",44,48,92,0.521739130434783,0.478260869565217,1
"12341","PGP",4,6,10,0.6,0.4,1
"12342","PGPEP1",3,14,17,0.823529411764706,0.176470588235294,1
"12343","PGPEP1L",8,13,21,0.619047619047619,0.380952380952381,1
"12344","PGR",53,81,134,0.604477611940298,0.395522388059701,1
"12345","PGRMC1",20,7,27,0.259259259259259,0.740740740740741,1
"12346","PGRMC2",3,2,5,0.4,0.6,1
"12347","PGS1",15,25,40,0.625,0.375,1
"12348","PHACTR1",28,50,78,0.641025641025641,0.358974358974359,1
"12349","PHACTR2",26,57,83,0.686746987951807,0.313253012048193,0.35
"12350","PHACTR3",39,83,122,0.680327868852459,0.319672131147541,0.09
"12351","PHACTR4",26,55,81,0.679012345679012,0.320987654320988,1
"12352","PHAX",19,18,37,0.486486486486487,0.513513513513513,1
"12353","PHB",6,12,18,0.666666666666667,0.333333333333333,1
"12354","PHB2",7,10,17,0.588235294117647,0.411764705882353,1
"12355","PHC1",27,34,61,0.557377049180328,0.442622950819672,1
"12356","PHC2",16,38,54,0.703703703703704,0.296296296296296,1
"12357","PHC3",25,43,68,0.632352941176471,0.367647058823529,1
"12358","PHETA1",5,7,12,0.583333333333333,0.416666666666667,1
"12359","PHETA2",6,11,17,0.647058823529412,0.352941176470588,1
"12360","PHEX",62,48,110,0.436363636363636,0.563636363636364,1
"12361","PHF1",21,33,54,0.611111111111111,0.388888888888889,1
"12362","PHF10",19,22,41,0.536585365853659,0.463414634146341,1
"12363","PHF11",4,19,23,0.826086956521739,0.173913043478261,1
"12364","PHF12",22,43,65,0.661538461538462,0.338461538461538,1
"12365","PHF13",11,21,32,0.65625,0.34375,1
"12366","PHF14",29,59,88,0.670454545454545,0.329545454545455,1
"12367","PHF19",10,21,31,0.67741935483871,0.32258064516129,1
"12368","PHF2",50,63,113,0.557522123893805,0.442477876106195,1
"12369","PHF20",33,64,97,0.65979381443299,0.34020618556701,1
"12370","PHF20L1",62,81,143,0.566433566433566,0.433566433566434,1
"12371","PHF21A",29,32,61,0.524590163934426,0.475409836065574,1
"12372","PHF21B",22,45,67,0.671641791044776,0.328358208955224,1
"12373","PHF23",24,21,45,0.466666666666667,0.533333333333333,1
"12374","PHF24",25,36,61,0.590163934426229,0.409836065573771,1
"12375","PHF3",81,145,226,0.641592920353982,0.358407079646018,1
"12376","PHF5A",3,9,12,0.75,0.25,1
"12377","PHF6",19,16,35,0.457142857142857,0.542857142857143,1
"12378","PHF7",13,19,32,0.59375,0.40625,1
"12379","PHF8",38,29,67,0.432835820895522,0.567164179104478,1
"12380","PHGDH",12,28,40,0.7,0.3,1
"12381","PHGR1",0,2,2,1,0,1
"12382","PHIP",61,101,162,0.623456790123457,0.376543209876543,1
"12383","PHKA1",68,79,147,0.537414965986395,0.462585034013605,1
"12384","PHKA2",71,44,115,0.382608695652174,0.617391304347826,1
"12385","PHKB",33,69,102,0.676470588235294,0.323529411764706,1
"12386","PHKG1",11,27,38,0.710526315789474,0.289473684210526,1
"12387","PHKG2",17,19,36,0.527777777777778,0.472222222222222,1
"12388","PHLDA1",12,28,40,0.7,0.3,1
"12389","PHLDA2",6,5,11,0.454545454545455,0.545454545454545,1
"12390","PHLDA3",4,9,13,0.692307692307692,0.307692307692308,1
"12391","PHLDB1",46,74,120,0.616666666666667,0.383333333333333,1
"12392","PHLDB2",67,121,188,0.643617021276596,0.356382978723404,1
"12393","PHLDB3",11,23,34,0.676470588235294,0.323529411764706,1
"12394","PHLPP1",37,66,103,0.640776699029126,0.359223300970874,1
"12395","PHLPP2",44,64,108,0.592592592592593,0.407407407407407,1
"12396","PHOSPHO1",2,7,9,0.777777777777778,0.222222222222222,1
"12397","PHOSPHO2",13,21,34,0.617647058823529,0.382352941176471,1
"12398","PHOX2A",5,11,16,0.6875,0.3125,1
"12399","PHOX2B",17,35,52,0.673076923076923,0.326923076923077,1
"12400","PHPT1",5,8,13,0.615384615384615,0.384615384615385,1
"12401","PHRF1",50,83,133,0.62406015037594,0.37593984962406,1
"12402","PHTF1",27,58,85,0.682352941176471,0.317647058823529,1
"12403","PHTF2",23,36,59,0.610169491525424,0.389830508474576,1
"12404","PHYH",12,30,42,0.714285714285714,0.285714285714286,1
"12405","PHYHD1",5,11,16,0.6875,0.3125,1
"12406","PHYHIP",14,18,32,0.5625,0.4375,1
"12407","PHYHIPL",15,30,45,0.666666666666667,0.333333333333333,1
"12408","PHYKPL",16,10,26,0.384615384615385,0.615384615384615,1
"12409","PI15",30,48,78,0.615384615384615,0.384615384615385,1
"12410","PI16",22,26,48,0.541666666666667,0.458333333333333,1
"12411","PI3",7,18,25,0.72,0.28,1
"12412","PI4K2A",11,22,33,0.666666666666667,0.333333333333333,1
"12413","PI4K2B",19,17,36,0.472222222222222,0.527777777777778,1
"12414","PI4KA",60,99,159,0.622641509433962,0.377358490566038,1
"12415","PI4KB",27,47,74,0.635135135135135,0.364864864864865,1
"12416","PIANP",11,16,27,0.592592592592593,0.407407407407407,1
"12417","PIAS1",32,30,62,0.483870967741935,0.516129032258065,1
"12418","PIAS2",32,28,60,0.466666666666667,0.533333333333333,1
"12419","PIAS3",22,37,59,0.627118644067797,0.372881355932203,1
"12420","PIAS4",18,21,39,0.538461538461538,0.461538461538462,1
"12421","PIBF1",30,52,82,0.634146341463415,0.365853658536585,1
"12422","PICALM",27,29,56,0.517857142857143,0.482142857142857,1
"12423","PICK1",9,19,28,0.678571428571429,0.321428571428571,1
"12424","PID1",15,36,51,0.705882352941177,0.294117647058824,1
"12425","PIDD1",19,35,54,0.648148148148148,0.351851851851852,1
"12426","PIEZO1",1,5,6,0.833333333333333,0.166666666666667,1
"12427","PIEZO2",31,68,99,0.686868686868687,0.313131313131313,1
"12428","PIF1",17,24,41,0.585365853658537,0.414634146341463,1
"12429","PIFO",5,16,21,0.761904761904762,0.238095238095238,1
"12430","PIGA",15,10,25,0.4,0.6,1
"12431","PIGB",16,23,39,0.58974358974359,0.41025641025641,1
"12432","PIGC",9,17,26,0.653846153846154,0.346153846153846,1
"12433","PIGF",1,12,13,0.923076923076923,0.0769230769230769,1
"12434","PIGG",31,61,92,0.66304347826087,0.33695652173913,1
"12435","PIGH",3,2,5,0.4,0.6,1
"12436","PIGK",12,32,44,0.727272727272727,0.272727272727273,1
"12437","PIGL",8,14,22,0.636363636363636,0.363636363636364,1
"12438","PIGM",11,14,25,0.56,0.44,1
"12439","PIGN",15,28,43,0.651162790697674,0.348837209302326,1
"12440","PIGO",62,50,112,0.446428571428571,0.553571428571429,1
"12441","PIGP",6,3,9,0.333333333333333,0.666666666666667,1
"12442","PIGQ",23,31,54,0.574074074074074,0.425925925925926,1
"12443","PIGR",28,63,91,0.692307692307692,0.307692307692308,1
"12444","PIGS",19,20,39,0.512820512820513,0.487179487179487,1
"12445","PIGT",18,28,46,0.608695652173913,0.391304347826087,1
"12446","PIGU",11,24,35,0.685714285714286,0.314285714285714,1
"12447","PIGV",17,30,47,0.638297872340426,0.361702127659574,1
"12448","PIGW",17,18,35,0.514285714285714,0.485714285714286,1
"12449","PIGX",3,14,17,0.823529411764706,0.176470588235294,1
"12450","PIGY",2,1,3,0.333333333333333,0.666666666666667,1
"12451","PIGZ",14,23,37,0.621621621621622,0.378378378378378,1
"12452","PIH1D1",11,25,36,0.694444444444444,0.305555555555556,1
"12453","PIH1D2",16,17,33,0.515151515151515,0.484848484848485,1
"12454","PIK3AP1",42,76,118,0.644067796610169,0.355932203389831,1
"12455","PIK3C2A",42,87,129,0.674418604651163,0.325581395348837,1
"12456","PIK3C2B",66,129,195,0.661538461538462,0.338461538461538,1
"12457","PIK3C2G",77,151,228,0.662280701754386,0.337719298245614,1
"12458","PIK3C3",37,50,87,0.574712643678161,0.425287356321839,1
"12459","PIK3CA",272,420,692,0.606936416184971,0.393063583815029,1
"12460","PIK3CB",46,53,99,0.535353535353535,0.464646464646465,1
"12461","PIK3CD",31,53,84,0.630952380952381,0.369047619047619,1
"12462","PIK3CG",91,167,258,0.647286821705426,0.352713178294574,1
"12463","PIK3IP1",7,8,15,0.533333333333333,0.466666666666667,1
"12464","PIK3R1",63,123,186,0.661290322580645,0.338709677419355,1
"12465","PIK3R2",25,43,68,0.632352941176471,0.367647058823529,1
"12466","PIK3R3",15,30,45,0.666666666666667,0.333333333333333,1
"12467","PIK3R4",61,67,128,0.5234375,0.4765625,1
"12468","PIK3R5",40,58,98,0.591836734693878,0.408163265306122,1
"12469","PIK3R6",38,33,71,0.464788732394366,0.535211267605634,1
"12470","PIKFYVE",69,121,190,0.636842105263158,0.363157894736842,1
"12471","PILRA",7,23,30,0.766666666666667,0.233333333333333,1
"12472","PILRB",5,15,20,0.75,0.25,1
"12473","PIM1",17,37,54,0.685185185185185,0.314814814814815,1
"12474","PIM2",24,14,38,0.368421052631579,0.631578947368421,1
"12475","PIM3",6,10,16,0.625,0.375,1
"12476","PIMREG",13,10,23,0.434782608695652,0.565217391304348,1
"12477","PIN1",3,7,10,0.7,0.3,1
"12478","PIN4",8,6,14,0.428571428571429,0.571428571428571,1
"12479","PINK1",22,16,38,0.421052631578947,0.578947368421053,1
"12480","PINX1",6,14,20,0.7,0.3,1
"12481","PIP",9,20,29,0.689655172413793,0.310344827586207,1
"12482","PIP4K2A",26,37,63,0.587301587301587,0.412698412698413,1
"12483","PIP4K2B",11,18,29,0.620689655172414,0.379310344827586,1
"12484","PIP4K2C",18,28,46,0.608695652173913,0.391304347826087,1
"12485","PIP4P1",6,16,22,0.727272727272727,0.272727272727273,1
"12486","PIP4P2",21,24,45,0.533333333333333,0.466666666666667,1
"12487","PIP5K1A",22,32,54,0.592592592592593,0.407407407407407,1
"12488","PIP5K1B",27,44,71,0.619718309859155,0.380281690140845,1
"12489","PIP5K1C",35,40,75,0.533333333333333,0.466666666666667,1
"12490","PIP5KL1",10,5,15,0.333333333333333,0.666666666666667,1
"12491","PIPOX",20,25,45,0.555555555555556,0.444444444444444,1
"12492","PIPSL",4,7,11,0.636363636363636,0.363636363636364,1
"12493","PIR",10,6,16,0.375,0.625,1
"12494","PIRT",2,8,10,0.8,0.2,1
"12495","PISD",10,11,21,0.523809523809524,0.476190476190476,1
"12496","PITHD1",7,15,22,0.681818181818182,0.318181818181818,1
"12497","PITPNA",6,5,11,0.454545454545455,0.545454545454545,1
"12498","PITPNB",12,14,26,0.538461538461538,0.461538461538462,1
"12499","PITPNC1",19,18,37,0.486486486486487,0.513513513513513,1
"12500","PITPNM1",36,58,94,0.617021276595745,0.382978723404255,1
"12501","PITPNM2",42,52,94,0.553191489361702,0.446808510638298,1
"12502","PITPNM3",39,60,99,0.606060606060606,0.393939393939394,1
"12503","PITRM1",16,36,52,0.692307692307692,0.307692307692308,1
"12504","PITX1",12,14,26,0.538461538461538,0.461538461538462,1
"12505","PITX2",23,33,56,0.589285714285714,0.410714285714286,1
"12506","PITX3",7,9,16,0.5625,0.4375,1
"12507","PIWIL1",56,100,156,0.641025641025641,0.358974358974359,1
"12508","PIWIL2",55,69,124,0.556451612903226,0.443548387096774,1
"12509","PIWIL3",29,66,95,0.694736842105263,0.305263157894737,1
"12510","PIWIL4",25,51,76,0.671052631578947,0.328947368421053,1
"12511","PJA1",40,25,65,0.384615384615385,0.615384615384615,1
"12512","PJA2",18,34,52,0.653846153846154,0.346153846153846,1
"12513","PJVK",16,20,36,0.555555555555556,0.444444444444444,1
"12514","PKD1",101,132,233,0.566523605150215,0.433476394849785,1
"12515","PKD1L1",129,197,326,0.604294478527607,0.395705521472393,1
"12516","PKD1L2",72,128,200,0.64,0.36,1
"12517","PKD1L3",0,5,5,1,0,1
"12518","PKD2",29,66,95,0.694736842105263,0.305263157894737,1
"12519","PKD2L1",42,62,104,0.596153846153846,0.403846153846154,1
"12520","PKD2L2",32,47,79,0.594936708860759,0.40506329113924,1
"12521","PKDCC",9,16,25,0.64,0.36,1
"12522","PKDREJ",82,138,220,0.627272727272727,0.372727272727273,1
"12523","PKHD1",221,392,613,0.639477977161501,0.360522022838499,1
"12524","PKHD1L1",259,510,769,0.663198959687906,0.336801040312094,1
"12525","PKIA",6,8,14,0.571428571428571,0.428571428571429,1
"12526","PKIB",6,5,11,0.454545454545455,0.545454545454545,1
"12527","PKIG",5,5,10,0.5,0.5,1
"12528","PKLR",37,45,82,0.548780487804878,0.451219512195122,1
"12529","PKM",23,29,52,0.557692307692308,0.442307692307692,1
"12530","PKMYT1",12,14,26,0.538461538461538,0.461538461538462,1
"12531","PKN1",30,38,68,0.558823529411765,0.441176470588235,1
"12532","PKN2",41,49,90,0.544444444444444,0.455555555555556,1
"12533","PKN3",36,52,88,0.590909090909091,0.409090909090909,1
"12534","PKNOX1",16,27,43,0.627906976744186,0.372093023255814,1
"12535","PKNOX2",20,49,69,0.710144927536232,0.289855072463768,1
"12536","PKP1",24,37,61,0.60655737704918,0.39344262295082,1
"12537","PKP2",53,102,155,0.658064516129032,0.341935483870968,1
"12538","PKP3",27,30,57,0.526315789473684,0.473684210526316,1
"12539","PKP4",38,78,116,0.672413793103448,0.327586206896552,1
"12540","PLA1A",14,54,68,0.794117647058823,0.205882352941176,1
"12541","PLA2G10",0,2,2,1,0,1
"12542","PLA2G12A",4,2,6,0.333333333333333,0.666666666666667,1
"12543","PLA2G12B",7,10,17,0.588235294117647,0.411764705882353,1
"12544","PLA2G15",12,27,39,0.692307692307692,0.307692307692308,1
"12545","PLA2G1B",9,7,16,0.4375,0.5625,1
"12546","PLA2G2A",8,9,17,0.529411764705882,0.470588235294118,1
"12547","PLA2G2C",2,3,5,0.6,0.4,1
"12548","PLA2G2D",7,12,19,0.631578947368421,0.368421052631579,1
"12549","PLA2G2E",11,11,22,0.5,0.5,1
"12550","PLA2G2F",7,19,26,0.730769230769231,0.269230769230769,1
"12551","PLA2G3",29,46,75,0.613333333333333,0.386666666666667,1
"12552","PLA2G4A",39,76,115,0.660869565217391,0.339130434782609,1
"12553","PLA2G4B",0,1,1,1,0,1
"12554","PLA2G4C",29,50,79,0.632911392405063,0.367088607594937,1
"12555","PLA2G4D",30,34,64,0.53125,0.46875,1
"12556","PLA2G4E",14,37,51,0.725490196078431,0.274509803921569,1
"12557","PLA2G4F",23,44,67,0.656716417910448,0.343283582089552,1
"12558","PLA2G5",10,10,20,0.5,0.5,1
"12559","PLA2G6",30,42,72,0.583333333333333,0.416666666666667,1
"12560","PLA2G7",21,40,61,0.655737704918033,0.344262295081967,1
"12561","PLA2R1",63,98,161,0.608695652173913,0.391304347826087,1
"12562","PLAA",18,27,45,0.6,0.4,1
"12563","PLAAT1",7,21,28,0.75,0.25,1
"12564","PLAAT2",5,16,21,0.761904761904762,0.238095238095238,1
"12565","PLAAT3",6,4,10,0.4,0.6,1
"12566","PLAAT4",20,18,38,0.473684210526316,0.526315789473684,1
"12567","PLAAT5",10,29,39,0.743589743589744,0.256410256410256,1
"12568","PLAC1",8,10,18,0.555555555555556,0.444444444444444,1
"12569","PLAC8",5,6,11,0.545454545454545,0.454545454545455,1
"12570","PLAC8L1",3,10,13,0.769230769230769,0.230769230769231,1
"12571","PLAC9",3,5,8,0.625,0.375,1
"12572","PLAG1",26,64,90,0.711111111111111,0.288888888888889,1
"12573","PLAGL1",12,24,36,0.666666666666667,0.333333333333333,0.62
"12574","PLAGL2",25,32,57,0.56140350877193,0.43859649122807,0.62
"12575","PLAT",20,51,71,0.71830985915493,0.28169014084507,1
"12576","PLAU",16,16,32,0.5,0.5,1
"12577","PLAUR",6,26,32,0.8125,0.1875,1
"12578","PLB1",61,120,181,0.662983425414365,0.337016574585635,1
"12579","PLBD1",10,36,46,0.782608695652174,0.217391304347826,1
"12580","PLBD2",17,28,45,0.622222222222222,0.377777777777778,1
"12581","PLCB1",101,180,281,0.640569395017794,0.359430604982206,1
"12582","PLCB2",47,54,101,0.534653465346535,0.465346534653465,1
"12583","PLCB3",35,63,98,0.642857142857143,0.357142857142857,1
"12584","PLCB4",97,204,301,0.677740863787375,0.322259136212625,1
"12585","PLCD1",22,33,55,0.6,0.4,1
"12586","PLCD3",14,18,32,0.5625,0.4375,1
"12587","PLCD4",18,30,48,0.625,0.375,1
"12588","PLCE1",100,185,285,0.649122807017544,0.350877192982456,1
"12589","PLCG1",39,75,114,0.657894736842105,0.342105263157895,1
"12590","PLCG2",67,118,185,0.637837837837838,0.362162162162162,1
"12591","PLCH1",105,188,293,0.641638225255973,0.358361774744027,1
"12592","PLCH2",43,53,96,0.552083333333333,0.447916666666667,1
"12593","PLCL1",69,136,205,0.663414634146341,0.336585365853659,1
"12594","PLCL2",42,108,150,0.72,0.28,1
"12595","PLCXD1",8,21,29,0.724137931034483,0.275862068965517,1
"12596","PLCXD2",14,29,43,0.674418604651163,0.325581395348837,1
"12597","PLCXD3",37,77,114,0.675438596491228,0.324561403508772,1
"12598","PLCZ1",40,85,125,0.68,0.32,1
"12599","PLD1",62,84,146,0.575342465753425,0.424657534246575,1
"12600","PLD2",40,33,73,0.452054794520548,0.547945205479452,1
"12601","PLD3",20,21,41,0.51219512195122,0.48780487804878,1
"12602","PLD4",12,15,27,0.555555555555556,0.444444444444444,1
"12603","PLD5",33,79,112,0.705357142857143,0.294642857142857,1
"12604","PLD6",4,6,10,0.6,0.4,1
"12605","PLEC",202,251,453,0.554083885209713,0.445916114790287,1
"12606","PLEK",13,45,58,0.775862068965517,0.224137931034483,1
"12607","PLEK2",9,13,22,0.590909090909091,0.409090909090909,1
"12608","PLEKHA1",17,21,38,0.552631578947368,0.447368421052632,1
"12609","PLEKHA2",12,24,36,0.666666666666667,0.333333333333333,1
"12610","PLEKHA3",13,18,31,0.580645161290323,0.419354838709677,1
"12611","PLEKHA4",38,56,94,0.595744680851064,0.404255319148936,1
"12612","PLEKHA5",44,86,130,0.661538461538462,0.338461538461538,1
"12613","PLEKHA6",70,91,161,0.565217391304348,0.434782608695652,1
"12614","PLEKHA7",48,95,143,0.664335664335664,0.335664335664336,1
"12615","PLEKHA8",19,33,52,0.634615384615385,0.365384615384615,1
"12616","PLEKHA8P1",23,50,73,0.684931506849315,0.315068493150685,1
"12617","PLEKHB1",9,7,16,0.4375,0.5625,1
"12618","PLEKHB2",10,15,25,0.6,0.4,1
"12619","PLEKHD1",0,4,4,1,0,1
"12620","PLEKHF1",5,12,17,0.705882352941177,0.294117647058824,1
"12621","PLEKHF2",8,16,24,0.666666666666667,0.333333333333333,1
"12622","PLEKHG1",40,93,133,0.699248120300752,0.300751879699248,1
"12623","PLEKHG2",45,73,118,0.61864406779661,0.38135593220339,1
"12624","PLEKHG3",34,65,99,0.656565656565657,0.343434343434343,1
"12625","PLEKHG4",29,63,92,0.684782608695652,0.315217391304348,1
"12626","PLEKHG4B",61,104,165,0.63030303030303,0.36969696969697,1
"12627","PLEKHG5",18,47,65,0.723076923076923,0.276923076923077,1
"12628","PLEKHG6",26,37,63,0.587301587301587,0.412698412698413,1
"12629","PLEKHG7",22,48,70,0.685714285714286,0.314285714285714,1
"12630","PLEKHH1",29,47,76,0.618421052631579,0.381578947368421,1
"12631","PLEKHH2",55,119,174,0.683908045977011,0.316091954022989,1
"12632","PLEKHH3",21,42,63,0.666666666666667,0.333333333333333,1
"12633","PLEKHJ1",4,6,10,0.6,0.4,1
"12634","PLEKHM1",35,63,98,0.642857142857143,0.357142857142857,1
"12635","PLEKHM2",27,38,65,0.584615384615385,0.415384615384615,1
"12636","PLEKHM3",29,53,82,0.646341463414634,0.353658536585366,1
"12637","PLEKHN1",16,21,37,0.567567567567568,0.432432432432432,1
"12638","PLEKHO1",27,26,53,0.490566037735849,0.509433962264151,1
"12639","PLEKHO2",14,37,51,0.725490196078431,0.274509803921569,1
"12640","PLEKHS1",20,40,60,0.666666666666667,0.333333333333333,1
"12641","PLET1",1,1,2,0.5,0.5,1
"12642","PLG",82,121,203,0.596059113300493,0.403940886699507,1
"12643","PLGLB1",1,0,1,0,1,1
"12644","PLGLB2",1,0,1,0,1,1
"12645","PLGRKT",9,20,29,0.689655172413793,0.310344827586207,1
"12646","PLIN1",13,19,32,0.59375,0.40625,1
"12647","PLIN2",14,22,36,0.611111111111111,0.388888888888889,1
"12648","PLIN3",18,22,40,0.55,0.45,1
"12649","PLIN4",40,59,99,0.595959595959596,0.404040404040404,1
"12650","PLIN5",16,18,34,0.529411764705882,0.470588235294118,1
"12651","PLK1",31,54,85,0.635294117647059,0.364705882352941,1
"12652","PLK2",34,33,67,0.492537313432836,0.507462686567164,1
"12653","PLK3",21,32,53,0.60377358490566,0.39622641509434,1
"12654","PLK4",37,43,80,0.5375,0.4625,1
"12655","PLLP",2,7,9,0.777777777777778,0.222222222222222,1
"12656","PLN",1,6,7,0.857142857142857,0.142857142857143,1
"12657","PLOD1",22,30,52,0.576923076923077,0.423076923076923,1
"12658","PLOD2",30,54,84,0.642857142857143,0.357142857142857,1
"12659","PLOD3",27,40,67,0.597014925373134,0.402985074626866,1
"12660","PLP1",19,20,39,0.512820512820513,0.487179487179487,1
"12661","PLP2",17,6,23,0.260869565217391,0.739130434782609,1
"12662","PLPBP",5,16,21,0.761904761904762,0.238095238095238,1
"12663","PLPP1",11,12,23,0.521739130434783,0.478260869565217,1
"12664","PLPP2",12,18,30,0.6,0.4,1
"12665","PLPP3",8,27,35,0.771428571428571,0.228571428571429,1
"12666","PLPP4",19,31,50,0.62,0.38,1
"12667","PLPP5",7,5,12,0.416666666666667,0.583333333333333,1
"12668","PLPP6",6,6,12,0.5,0.5,1
"12669","PLPP7",13,21,34,0.617647058823529,0.382352941176471,1
"12670","PLPPR1",12,46,58,0.793103448275862,0.206896551724138,1
"12671","PLPPR2",11,21,32,0.65625,0.34375,1
"12672","PLPPR3",21,13,34,0.382352941176471,0.617647058823529,1
"12673","PLPPR4",83,88,171,0.514619883040936,0.485380116959064,1
"12674","PLPPR5",23,38,61,0.622950819672131,0.377049180327869,1
"12675","PLRG1",16,38,54,0.703703703703704,0.296296296296296,1
"12676","PLS1",19,55,74,0.743243243243243,0.256756756756757,1
"12677","PLS3",31,16,47,0.340425531914894,0.659574468085106,1
"12678","PLSCR1",14,23,37,0.621621621621622,0.378378378378378,1
"12679","PLSCR2",21,23,44,0.522727272727273,0.477272727272727,1
"12680","PLSCR3",8,7,15,0.466666666666667,0.533333333333333,1
"12681","PLSCR4",19,37,56,0.660714285714286,0.339285714285714,1
"12682","PLSCR5",14,14,28,0.5,0.5,1
"12683","PLTP",21,29,50,0.58,0.42,1
"12684","PLVAP",24,41,65,0.630769230769231,0.369230769230769,1
"12685","PLXDC1",24,30,54,0.555555555555556,0.444444444444444,1
"12686","PLXDC2",45,86,131,0.656488549618321,0.343511450381679,1
"12687","PLXNA1",96,97,193,0.50259067357513,0.49740932642487,1
"12688","PLXNA2",82,126,208,0.605769230769231,0.394230769230769,1
"12689","PLXNA3",105,62,167,0.37125748502994,0.62874251497006,1
"12690","PLXNA4",154,273,427,0.639344262295082,0.360655737704918,1
"12691","PLXNB1",58,96,154,0.623376623376623,0.376623376623377,1
"12692","PLXNB2",85,122,207,0.589371980676328,0.410628019323671,1
"12693","PLXNB3",103,50,153,0.326797385620915,0.673202614379085,1
"12694","PLXNC1",60,88,148,0.594594594594595,0.405405405405405,1
"12695","PLXND1",73,107,180,0.594444444444444,0.405555555555556,1
"12696","PM20D1",22,31,53,0.584905660377358,0.415094339622642,1
"12697","PM20D2",8,19,27,0.703703703703704,0.296296296296296,1
"12698","PMAIP1",1,2,3,0.666666666666667,0.333333333333333,1
"12699","PMCH",4,12,16,0.75,0.25,1
"12700","PMEL",22,26,48,0.541666666666667,0.458333333333333,1
"12701","PMEPA1",22,34,56,0.607142857142857,0.392857142857143,1
"12702","PMF1",8,12,20,0.6,0.4,1
"12703","PMF1-BGLAP",1,2,3,0.666666666666667,0.333333333333333,1
"12704","PMFBP1",55,80,135,0.592592592592593,0.407407407407407,1
"12705","PML",35,36,71,0.507042253521127,0.492957746478873,1
"12706","PMM1",10,23,33,0.696969696969697,0.303030303030303,1
"12707","PMM2",6,5,11,0.454545454545455,0.545454545454545,1
"12708","PMP2",10,8,18,0.444444444444444,0.555555555555556,1
"12709","PMP22",9,5,14,0.357142857142857,0.642857142857143,1
"12710","PMPCA",16,19,35,0.542857142857143,0.457142857142857,1
"12711","PMPCB",18,19,37,0.513513513513513,0.486486486486487,1
"12712","PMS1",32,58,90,0.644444444444444,0.355555555555556,1
"12713","PMS2",37,57,94,0.606382978723404,0.393617021276596,1
"12714","PMS2P3",2,3,5,0.6,0.4,1
"12715","PMVK",1,12,13,0.923076923076923,0.0769230769230769,1
"12716","PNCK",25,13,38,0.342105263157895,0.657894736842105,1
"12717","PNISR",52,55,107,0.514018691588785,0.485981308411215,1
"12718","PNKD",7,18,25,0.72,0.28,1
"12719","PNKP",10,21,31,0.67741935483871,0.32258064516129,1
"12720","PNLDC1",50,40,90,0.444444444444444,0.555555555555556,1
"12721","PNLIP",39,74,113,0.654867256637168,0.345132743362832,1
"12722","PNLIPRP1",29,41,70,0.585714285714286,0.414285714285714,1
"12723","PNLIPRP2",7,41,48,0.854166666666667,0.145833333333333,1
"12724","PNLIPRP3",37,56,93,0.602150537634409,0.397849462365591,1
"12725","PNMA1",10,21,31,0.67741935483871,0.32258064516129,1
"12726","PNMA2",16,20,36,0.555555555555556,0.444444444444444,1
"12727","PNMA3",33,24,57,0.421052631578947,0.578947368421053,1
"12728","PNMA5",39,27,66,0.409090909090909,0.590909090909091,1
"12729","PNMA6A",1,1,2,0.5,0.5,1
"12730","PNMA8A",20,29,49,0.591836734693878,0.408163265306122,1
"12731","PNMA8B",19,39,58,0.672413793103448,0.327586206896552,1
"12732","PNMT",8,18,26,0.692307692307692,0.307692307692308,1
"12733","PNN",28,31,59,0.525423728813559,0.474576271186441,1
"12734","PNO1",8,10,18,0.555555555555556,0.444444444444444,1
"12735","PNOC",11,6,17,0.352941176470588,0.647058823529412,1
"12736","PNP",10,17,27,0.62962962962963,0.37037037037037,1
"12737","PNPLA1",15,44,59,0.745762711864407,0.254237288135593,1
"12738","PNPLA2",4,16,20,0.8,0.2,1
"12739","PNPLA3",19,25,44,0.568181818181818,0.431818181818182,1
"12740","PNPLA4",15,10,25,0.4,0.6,1
"12741","PNPLA5",31,34,65,0.523076923076923,0.476923076923077,1
"12742","PNPLA6",45,73,118,0.61864406779661,0.38135593220339,1
"12743","PNPLA7",49,78,127,0.614173228346457,0.385826771653543,1
"12744","PNPLA8",33,51,84,0.607142857142857,0.392857142857143,1
"12745","PNPO",5,5,10,0.5,0.5,1
"12746","PNPT1",26,44,70,0.628571428571429,0.371428571428571,1
"12747","PNRC1",6,21,27,0.777777777777778,0.222222222222222,1
"12748","PNRC2",6,6,12,0.5,0.5,1
"12749","POC1A",13,14,27,0.518518518518518,0.481481481481481,1
"12750","POC1B",20,15,35,0.428571428571429,0.571428571428571,1
"12751","POC1B-GALNT4",17,26,43,0.604651162790698,0.395348837209302,1
"12752","POC5",14,18,32,0.5625,0.4375,1
"12753","PODN",26,44,70,0.628571428571429,0.371428571428571,1
"12754","PODNL1",13,13,26,0.5,0.5,1
"12755","PODXL",19,33,52,0.634615384615385,0.365384615384615,1
"12756","PODXL2",17,35,52,0.673076923076923,0.326923076923077,1
"12757","POF1B",41,71,112,0.633928571428571,0.366071428571429,1
"12758","POFUT1",9,25,34,0.735294117647059,0.264705882352941,1
"12759","POFUT2",17,21,38,0.552631578947368,0.447368421052632,1
"12760","POGK",24,34,58,0.586206896551724,0.413793103448276,1
"12761","POGLUT1",19,34,53,0.641509433962264,0.358490566037736,1
"12762","POGLUT2",21,37,58,0.637931034482759,0.362068965517241,1
"12763","POGLUT3",10,23,33,0.696969696969697,0.303030303030303,1
"12764","POGZ",47,59,106,0.556603773584906,0.443396226415094,1
"12765","POLA1",64,36,100,0.36,0.64,1
"12766","POLA2",12,30,42,0.714285714285714,0.285714285714286,1
"12767","POLB",6,27,33,0.818181818181818,0.181818181818182,1
"12768","POLD1",43,52,95,0.547368421052632,0.452631578947368,1
"12769","POLD2",14,17,31,0.548387096774194,0.451612903225806,1
"12770","POLD3",20,29,49,0.591836734693878,0.408163265306122,1
"12771","POLD4",0,6,6,1,0,1
"12772","POLDIP2",4,14,18,0.777777777777778,0.222222222222222,1
"12773","POLDIP3",15,28,43,0.651162790697674,0.348837209302326,1
"12774","POLE",97,154,251,0.613545816733068,0.386454183266932,1
"12775","POLE2",10,21,31,0.67741935483871,0.32258064516129,1
"12776","POLE3",6,9,15,0.6,0.4,1
"12777","POLE4",3,1,4,0.25,0.75,1
"12778","POLG",33,47,80,0.5875,0.4125,1
"12779","POLG2",13,28,41,0.682926829268293,0.317073170731707,1
"12780","POLH",19,30,49,0.612244897959184,0.387755102040816,1
"12781","POLI",15,30,45,0.666666666666667,0.333333333333333,1
"12782","POLK",26,47,73,0.643835616438356,0.356164383561644,1
"12783","POLL",8,29,37,0.783783783783784,0.216216216216216,1
"12784","POLM",29,36,65,0.553846153846154,0.446153846153846,1
"12785","POLN",26,52,78,0.666666666666667,0.333333333333333,1
"12786","POLQ",122,191,313,0.610223642172524,0.389776357827476,1
"12787","POLR1A",66,80,146,0.547945205479452,0.452054794520548,1
"12788","POLR1B",35,54,89,0.606741573033708,0.393258426966292,1
"12789","POLR1C",9,13,22,0.590909090909091,0.409090909090909,1
"12790","POLR1D",5,5,10,0.5,0.5,1
"12791","POLR1E",13,14,27,0.518518518518518,0.481481481481481,1
"12792","POLR1F",22,20,42,0.476190476190476,0.523809523809524,1
"12793","POLR1G",15,18,33,0.545454545454545,0.454545454545455,1
"12794","POLR1H",2,4,6,0.666666666666667,0.333333333333333,1
"12795","POLR2A",64,94,158,0.594936708860759,0.40506329113924,1
"12796","POLR2B",53,80,133,0.601503759398496,0.398496240601504,1
"12797","POLR2C",6,8,14,0.571428571428571,0.428571428571429,1
"12798","POLR2D",6,9,15,0.6,0.4,1
"12799","POLR2E",12,11,23,0.478260869565217,0.521739130434783,1
"12800","POLR2F",10,14,24,0.583333333333333,0.416666666666667,1
"12801","POLR2G",6,14,20,0.7,0.3,1
"12802","POLR2H",7,5,12,0.416666666666667,0.583333333333333,1
"12803","POLR2I",7,11,18,0.611111111111111,0.388888888888889,1
"12804","POLR2J",4,9,13,0.692307692307692,0.307692307692308,1
"12805","POLR2J3",2,1,3,0.333333333333333,0.666666666666667,1
"12806","POLR2K",1,3,4,0.75,0.25,1
"12807","POLR2KP2",0,1,1,1,0,1
"12808","POLR2L",2,2,4,0.5,0.5,1
"12809","POLR2M",7,8,15,0.533333333333333,0.466666666666667,1
"12810","POLR3A",43,72,115,0.626086956521739,0.373913043478261,1
"12811","POLR3B",51,62,113,0.548672566371681,0.451327433628319,1
"12812","POLR3C",15,30,45,0.666666666666667,0.333333333333333,1
"12813","POLR3D",10,10,20,0.5,0.5,1
"12814","POLR3E",24,39,63,0.619047619047619,0.380952380952381,1
"12815","POLR3F",2,11,13,0.846153846153846,0.153846153846154,1
"12816","POLR3G",8,6,14,0.428571428571429,0.571428571428571,1
"12817","POLR3GL",6,8,14,0.571428571428571,0.428571428571429,1
"12818","POLR3H",7,11,18,0.611111111111111,0.388888888888889,1
"12819","POLR3K",6,4,10,0.4,0.6,1
"12820","POLRMT",29,51,80,0.6375,0.3625,1
"12821","POM121",33,51,84,0.607142857142857,0.392857142857143,1
"12822","POM121C",30,36,66,0.545454545454545,0.454545454545455,1
"12823","POM121L12",82,147,229,0.641921397379913,0.358078602620087,1
"12824","POM121L2",1,3,4,0.75,0.25,1
"12825","POM121L4P",0,4,4,1,0,1
"12826","POMC",12,17,29,0.586206896551724,0.413793103448276,1
"12827","POMGNT1",19,25,44,0.568181818181818,0.431818181818182,1
"12828","POMGNT2",18,24,42,0.571428571428571,0.428571428571429,1
"12829","POMK",12,21,33,0.636363636363636,0.363636363636364,1
"12830","POMP",5,3,8,0.375,0.625,1
"12831","POMT1",19,26,45,0.577777777777778,0.422222222222222,1
"12832","POMT2",23,27,50,0.54,0.46,1
"12833","POMZP3",4,13,17,0.764705882352941,0.235294117647059,1
"12834","PON1",33,46,79,0.582278481012658,0.417721518987342,1
"12835","PON2",15,14,29,0.482758620689655,0.517241379310345,1
"12836","PON3",16,45,61,0.737704918032787,0.262295081967213,1
"12837","POP1",67,69,136,0.507352941176471,0.492647058823529,1
"12838","POP4",5,16,21,0.761904761904762,0.238095238095238,1
"12839","POP5",1,7,8,0.875,0.125,1
"12840","POP7",6,10,16,0.625,0.375,1
"12841","POPDC2",12,29,41,0.707317073170732,0.292682926829268,1
"12842","POPDC3",21,30,51,0.588235294117647,0.411764705882353,1
"12843","POR",15,26,41,0.634146341463415,0.365853658536585,1
"12844","PORCN",34,14,48,0.291666666666667,0.708333333333333,1
"12845","POSTN",64,121,185,0.654054054054054,0.345945945945946,1
"12846","POT1",39,57,96,0.59375,0.40625,1
"12847","POTEA",30,64,94,0.680851063829787,0.319148936170213,1
"12848","POTEC",0,5,5,1,0,1
"12849","POTED",13,33,46,0.717391304347826,0.282608695652174,1
"12850","POTEE",50,152,202,0.752475247524752,0.247524752475248,1
"12851","POTEF",58,103,161,0.639751552795031,0.360248447204969,1
"12852","POTEH",30,61,91,0.67032967032967,0.32967032967033,1
"12853","POTEI",0,2,2,1,0,1
"12854","POTEJ",0,6,6,1,0,1
"12855","POTEM",17,17,34,0.5,0.5,1
"12856","POU1F1",14,23,37,0.621621621621622,0.378378378378378,1
"12857","POU2AF1",10,22,32,0.6875,0.3125,1
"12858","POU2F1",28,26,54,0.481481481481481,0.518518518518518,1
"12859","POU2F2",29,29,58,0.5,0.5,1
"12860","POU2F3",16,30,46,0.652173913043478,0.347826086956522,1
"12861","POU3F1",5,10,15,0.666666666666667,0.333333333333333,1
"12862","POU3F2",13,30,43,0.697674418604651,0.302325581395349,1
"12863","POU3F3",15,23,38,0.605263157894737,0.394736842105263,1
"12864","POU3F4",45,30,75,0.4,0.6,1
"12865","POU4F1",12,18,30,0.6,0.4,1
"12866","POU4F2",29,49,78,0.628205128205128,0.371794871794872,1
"12867","POU4F3",13,27,40,0.675,0.325,1
"12868","POU5F1",9,14,23,0.608695652173913,0.391304347826087,1
"12869","POU5F1B",0,1,1,1,0,1
"12870","POU5F2",17,21,38,0.552631578947368,0.447368421052632,1
"12871","POU6F1",12,18,30,0.6,0.4,1
"12872","POU6F2",36,82,118,0.694915254237288,0.305084745762712,1
"12873","PPA1",7,13,20,0.65,0.35,1
"12874","PPA2",11,18,29,0.620689655172414,0.379310344827586,1
"12875","PPAN",0,2,2,1,0,1
"12876","PPAN-P2RY11",21,46,67,0.686567164179104,0.313432835820896,1
"12877","PPARA",25,22,47,0.468085106382979,0.531914893617021,0.77
"12878","PPARD",23,19,42,0.452380952380952,0.547619047619048,0.77
"12879","PPARG",16,41,57,0.719298245614035,0.280701754385965,0.77
"12880","PPARGC1A",47,98,145,0.675862068965517,0.324137931034483,0.77
"12881","PPARGC1B",45,51,96,0.53125,0.46875,0.77
"12882","PPAT",16,29,45,0.644444444444444,0.355555555555556,1
"12883","PPBP",9,14,23,0.608695652173913,0.391304347826087,1
"12884","PPBPP1",0,1,1,1,0,1
"12885","PPCDC",0,5,5,1,0,1
"12886","PPCS",11,19,30,0.633333333333333,0.366666666666667,1
"12887","PPDPF",1,7,8,0.875,0.125,1
"12888","PPDPFL",9,19,28,0.678571428571429,0.321428571428571,1
"12889","PPEF1",45,31,76,0.407894736842105,0.592105263157895,1
"12890","PPEF2",37,73,110,0.663636363636364,0.336363636363636,1
"12891","PPFIA1",39,74,113,0.654867256637168,0.345132743362832,1
"12892","PPFIA2",87,195,282,0.691489361702128,0.308510638297872,1
"12893","PPFIA3",45,61,106,0.575471698113208,0.424528301886792,1
"12894","PPFIA4",44,68,112,0.607142857142857,0.392857142857143,1
"12895","PPFIBP1",34,42,76,0.552631578947368,0.447368421052632,1
"12896","PPFIBP2",34,43,77,0.558441558441558,0.441558441558442,1
"12897","PPHLN1",22,26,48,0.541666666666667,0.458333333333333,1
"12898","PPIA",2,6,8,0.75,0.25,1
"12899","PPIAL4A",14,19,33,0.575757575757576,0.424242424242424,1
"12900","PPIAL4G",8,17,25,0.68,0.32,1
"12901","PPIB",6,9,15,0.6,0.4,1
"12902","PPIC",9,12,21,0.571428571428571,0.428571428571429,1
"12903","PPID",15,10,25,0.4,0.6,1
"12904","PPIE",13,10,23,0.434782608695652,0.565217391304348,1
"12905","PPIF",2,6,8,0.75,0.25,1
"12906","PPIG",36,56,92,0.608695652173913,0.391304347826087,1
"12907","PPIH",3,5,8,0.625,0.375,1
"12908","PPIL1",6,10,16,0.625,0.375,1
"12909","PPIL2",10,25,35,0.714285714285714,0.285714285714286,1
"12910","PPIL3",1,8,9,0.888888888888889,0.111111111111111,1
"12911","PPIL4",15,24,39,0.615384615384615,0.384615384615385,1
"12912","PPIL6",8,14,22,0.636363636363636,0.363636363636364,1
"12913","PPIP5K1",15,28,43,0.651162790697674,0.348837209302326,1
"12914","PPIP5K2",37,72,109,0.660550458715596,0.339449541284404,1
"12915","PPL",52,94,146,0.643835616438356,0.356164383561644,1
"12916","PPM1A",21,23,44,0.522727272727273,0.477272727272727,1
"12917","PPM1B",26,34,60,0.566666666666667,0.433333333333333,1
"12918","PPM1D",30,42,72,0.583333333333333,0.416666666666667,1
"12919","PPM1E",31,39,70,0.557142857142857,0.442857142857143,1
"12920","PPM1F",16,18,34,0.529411764705882,0.470588235294118,1
"12921","PPM1G",7,27,34,0.794117647058823,0.205882352941176,1
"12922","PPM1H",22,26,48,0.541666666666667,0.458333333333333,1
"12923","PPM1J",8,14,22,0.636363636363636,0.363636363636364,1
"12924","PPM1K",18,23,41,0.560975609756098,0.439024390243902,1
"12925","PPM1L",19,31,50,0.62,0.38,1
"12926","PPM1M",3,8,11,0.727272727272727,0.272727272727273,1
"12927","PPM1N",9,9,18,0.5,0.5,1
"12928","PPME1",6,14,20,0.7,0.3,1
"12929","PPOX",14,27,41,0.658536585365854,0.341463414634146,1
"12930","PPP1CA",10,18,28,0.642857142857143,0.357142857142857,1
"12931","PPP1CB",9,20,29,0.689655172413793,0.310344827586207,1
"12932","PPP1CC",6,18,24,0.75,0.25,1
"12933","PPP1R10",47,44,91,0.483516483516484,0.516483516483517,1
"12934","PPP1R11",4,8,12,0.666666666666667,0.333333333333333,1
"12935","PPP1R12A",15,35,50,0.7,0.3,1
"12936","PPP1R12B",45,56,101,0.554455445544555,0.445544554455446,1
"12937","PPP1R12C",26,29,55,0.527272727272727,0.472727272727273,1
"12938","PPP1R13B",40,53,93,0.56989247311828,0.43010752688172,1
"12939","PPP1R13L",29,50,79,0.632911392405063,0.367088607594937,1
"12940","PPP1R14A",5,7,12,0.583333333333333,0.416666666666667,1
"12941","PPP1R14B",3,2,5,0.4,0.6,1
"12942","PPP1R14C",2,7,9,0.777777777777778,0.222222222222222,1
"12943","PPP1R14D",5,4,9,0.444444444444444,0.555555555555556,1
"12944","PPP1R15A",22,35,57,0.614035087719298,0.385964912280702,1
"12945","PPP1R15B",24,29,53,0.547169811320755,0.452830188679245,1
"12946","PPP1R16A",20,26,46,0.565217391304348,0.434782608695652,1
"12947","PPP1R16B",42,69,111,0.621621621621622,0.378378378378378,1
"12948","PPP1R17",14,20,34,0.588235294117647,0.411764705882353,1
"12949","PPP1R18",15,27,42,0.642857142857143,0.357142857142857,1
"12950","PPP1R1A",6,8,14,0.571428571428571,0.428571428571429,1
"12951","PPP1R1B",7,9,16,0.5625,0.4375,1
"12952","PPP1R1C",4,6,10,0.6,0.4,1
"12953","PPP1R2",10,15,25,0.6,0.4,1
"12954","PPP1R21",30,40,70,0.571428571428571,0.428571428571429,1
"12955","PPP1R26",46,72,118,0.610169491525424,0.389830508474576,1
"12956","PPP1R27",3,2,5,0.4,0.6,1
"12957","PPP1R2P1",0,1,1,1,0,1
"12958","PPP1R32",9,30,39,0.769230769230769,0.230769230769231,1
"12959","PPP1R35",2,7,9,0.777777777777778,0.222222222222222,1
"12960","PPP1R36",23,29,52,0.557692307692308,0.442307692307692,1
"12961","PPP1R3A",115,234,349,0.670487106017192,0.329512893982808,1
"12962","PPP1R3B",8,21,29,0.724137931034483,0.275862068965517,1
"12963","PPP1R3C",18,20,38,0.526315789473684,0.473684210526316,1
"12964","PPP1R3D",12,14,26,0.538461538461538,0.461538461538462,1
"12965","PPP1R3F",35,17,52,0.326923076923077,0.673076923076923,1
"12966","PPP1R3G",0,1,1,1,0,1
"12967","PPP1R42",16,14,30,0.466666666666667,0.533333333333333,1
"12968","PPP1R7",13,20,33,0.606060606060606,0.393939393939394,1
"12969","PPP1R8",0,13,13,1,0,1
"12970","PPP1R9A",56,115,171,0.672514619883041,0.327485380116959,1
"12971","PPP1R9B",10,15,25,0.6,0.4,1
"12972","PPP2CA",12,15,27,0.555555555555556,0.444444444444444,1
"12973","PPP2CB",10,13,23,0.565217391304348,0.434782608695652,1
"12974","PPP2R1A",33,48,81,0.592592592592593,0.407407407407407,1
"12975","PPP2R1B",30,32,62,0.516129032258065,0.483870967741935,1
"12976","PPP2R2A",22,40,62,0.645161290322581,0.354838709677419,1
"12977","PPP2R2B",30,40,70,0.571428571428571,0.428571428571429,1
"12978","PPP2R2C",23,45,68,0.661764705882353,0.338235294117647,1
"12979","PPP2R2D",12,26,38,0.684210526315789,0.315789473684211,1
"12980","PPP2R3A",36,56,92,0.608695652173913,0.391304347826087,1
"12981","PPP2R3B",26,19,45,0.422222222222222,0.577777777777778,1
"12982","PPP2R3C",12,20,32,0.625,0.375,1
"12983","PPP2R5A",11,32,43,0.744186046511628,0.255813953488372,1
"12984","PPP2R5B",21,31,52,0.596153846153846,0.403846153846154,1
"12985","PPP2R5C",22,25,47,0.531914893617021,0.468085106382979,1
"12986","PPP2R5D",15,37,52,0.711538461538462,0.288461538461538,1
"12987","PPP2R5E",23,27,50,0.54,0.46,1
"12988","PPP3CA",30,39,69,0.565217391304348,0.434782608695652,1
"12989","PPP3CB",16,30,46,0.652173913043478,0.347826086956522,1
"12990","PPP3CC",13,15,28,0.535714285714286,0.464285714285714,1
"12991","PPP3R1",7,11,18,0.611111111111111,0.388888888888889,1
"12992","PPP3R2",9,37,46,0.804347826086957,0.195652173913043,1
"12993","PPP4C",6,16,22,0.727272727272727,0.272727272727273,1
"12994","PPP4R1",26,62,88,0.704545454545455,0.295454545454545,1
"12995","PPP4R1L",0,6,6,1,0,1
"12996","PPP4R2",15,11,26,0.423076923076923,0.576923076923077,1
"12997","PPP4R3A",21,43,64,0.671875,0.328125,1
"12998","PPP4R3B",21,47,68,0.691176470588235,0.308823529411765,1
"12999","PPP4R4",60,97,157,0.617834394904459,0.382165605095541,1
"13000","PPP5C",16,35,51,0.686274509803922,0.313725490196078,1
"13001","PPP6C",23,39,62,0.629032258064516,0.370967741935484,1
"13002","PPP6R1",16,27,43,0.627906976744186,0.372093023255814,1
"13003","PPP6R2",40,37,77,0.480519480519481,0.519480519480519,1
"13004","PPP6R3",40,50,90,0.555555555555556,0.444444444444444,1
"13005","PPRC1",56,98,154,0.636363636363636,0.363636363636364,1
"13006","PPT1",7,12,19,0.631578947368421,0.368421052631579,1
"13007","PPT2",14,18,32,0.5625,0.4375,1
"13008","PPTC7",7,18,25,0.72,0.28,1
"13009","PPWD1",17,27,44,0.613636363636364,0.386363636363636,1
"13010","PPY",2,8,10,0.8,0.2,1
"13011","PQBP1",13,6,19,0.315789473684211,0.684210526315789,1
"13012","PRAC1",3,2,5,0.4,0.6,1
"13013","PRADC1",8,7,15,0.466666666666667,0.533333333333333,1
"13014","PRAF2",4,0,4,0,1,1
"13015","PRAG1",67,83,150,0.553333333333333,0.446666666666667,1
"13016","PRAM1",38,39,77,0.506493506493506,0.493506493506494,1
"13017","PRAME",32,43,75,0.573333333333333,0.426666666666667,1
"13018","PRAMEF1",32,62,94,0.659574468085106,0.340425531914894,1
"13019","PRAMEF10",27,43,70,0.614285714285714,0.385714285714286,1
"13020","PRAMEF11",0,1,1,1,0,1
"13021","PRAMEF12",29,63,92,0.684782608695652,0.315217391304348,1
"13022","PRAMEF14",33,80,113,0.707964601769911,0.292035398230089,1
"13023","PRAMEF15",28,74,102,0.725490196078431,0.274509803921569,1
"13024","PRAMEF17",33,66,99,0.666666666666667,0.333333333333333,1
"13025","PRAMEF18",38,61,99,0.616161616161616,0.383838383838384,1
"13026","PRAMEF19",44,87,131,0.66412213740458,0.33587786259542,1
"13027","PRAMEF2",35,64,99,0.646464646464647,0.353535353535354,1
"13028","PRAMEF20",58,74,132,0.560606060606061,0.439393939393939,1
"13029","PRAMEF4",28,67,95,0.705263157894737,0.294736842105263,1
"13030","PRAMEF5",8,18,26,0.692307692307692,0.307692307692308,1
"13031","PRAMEF6",10,19,29,0.655172413793103,0.344827586206897,1
"13032","PRAMEF7",9,27,36,0.75,0.25,1
"13033","PRAMEF8",15,27,42,0.642857142857143,0.357142857142857,1
"13034","PRB1",17,31,48,0.645833333333333,0.354166666666667,1
"13035","PRB2",31,81,112,0.723214285714286,0.276785714285714,1
"13036","PRB3",20,53,73,0.726027397260274,0.273972602739726,1
"13037","PRB4",20,56,76,0.736842105263158,0.263157894736842,1
"13038","PRC1",14,36,50,0.72,0.28,1
"13039","PRCC",24,41,65,0.630769230769231,0.369230769230769,1
"13040","PRCD",1,0,1,0,1,1
"13041","PRCP",16,33,49,0.673469387755102,0.326530612244898,1
"13042","PRDM1",37,67,104,0.644230769230769,0.355769230769231,1
"13043","PRDM10",59,58,117,0.495726495726496,0.504273504273504,1
"13044","PRDM11",31,41,72,0.569444444444444,0.430555555555556,1
"13045","PRDM12",7,9,16,0.5625,0.4375,1
"13046","PRDM13",26,35,61,0.573770491803279,0.426229508196721,1
"13047","PRDM14",37,57,94,0.606382978723404,0.393617021276596,1
"13048","PRDM15",37,56,93,0.602150537634409,0.397849462365591,1
"13049","PRDM16",56,120,176,0.681818181818182,0.318181818181818,1
"13050","PRDM2",73,102,175,0.582857142857143,0.417142857142857,1
"13051","PRDM4",27,33,60,0.55,0.45,1
"13052","PRDM5",44,79,123,0.642276422764228,0.357723577235772,1
"13053","PRDM6",0,3,3,1,0,1
"13054","PRDM7",19,16,35,0.457142857142857,0.542857142857143,1
"13055","PRDM8",12,26,38,0.684210526315789,0.315789473684211,1
"13056","PRDM9",144,253,397,0.63727959697733,0.36272040302267,1
"13057","PRDX1",10,15,25,0.6,0.4,1
"13058","PRDX2",9,9,18,0.5,0.5,1
"13059","PRDX3",10,5,15,0.333333333333333,0.666666666666667,1
"13060","PRDX4",10,13,23,0.565217391304348,0.434782608695652,1
"13061","PRDX5",5,2,7,0.285714285714286,0.714285714285714,1
"13062","PRDX6",11,21,32,0.65625,0.34375,1
"13063","PREB",18,14,32,0.4375,0.5625,1
"13064","PRELID1",4,11,15,0.733333333333333,0.266666666666667,1
"13065","PRELID2",6,6,12,0.5,0.5,1
"13066","PRELID3A",6,4,10,0.4,0.6,1
"13067","PRELID3B",7,10,17,0.588235294117647,0.411764705882353,1
"13068","PRELP",16,34,50,0.68,0.32,1
"13069","PREP",17,36,53,0.679245283018868,0.320754716981132,1
"13070","PREPL",29,43,72,0.597222222222222,0.402777777777778,1
"13071","PREX1",88,121,209,0.578947368421053,0.421052631578947,1
"13072","PREX2",151,275,426,0.645539906103286,0.354460093896714,1
"13073","PRF1",31,51,82,0.621951219512195,0.378048780487805,1
"13074","PRG2",12,17,29,0.586206896551724,0.413793103448276,1
"13075","PRG3",12,16,28,0.571428571428571,0.428571428571429,1
"13076","PRG4",59,99,158,0.626582278481013,0.373417721518987,1
"13077","PRH1",5,19,24,0.791666666666667,0.208333333333333,1
"13078","PRH2",7,25,32,0.78125,0.21875,1
"13079","PRICKLE1",45,80,125,0.64,0.36,1
"13080","PRICKLE2",48,58,106,0.547169811320755,0.452830188679245,1
"13081","PRICKLE3",26,13,39,0.333333333333333,0.666666666666667,1
"13082","PRICKLE4",13,20,33,0.606060606060606,0.393939393939394,1
"13083","PRIM1",12,16,28,0.571428571428571,0.428571428571429,1
"13084","PRIM2",11,10,21,0.476190476190476,0.523809523809524,1
"13085","PRIMA1",2,19,21,0.904761904761905,0.0952380952380952,1
"13086","PRIMPOL",20,19,39,0.487179487179487,0.512820512820513,1
"13087","PRKAA1",17,26,43,0.604651162790698,0.395348837209302,1
"13088","PRKAA2",39,76,115,0.660869565217391,0.339130434782609,1
"13089","PRKAB1",10,17,27,0.62962962962963,0.37037037037037,1
"13090","PRKAB2",12,11,23,0.478260869565217,0.521739130434783,1
"13091","PRKACA",11,19,30,0.633333333333333,0.366666666666667,1
"13092","PRKACB",16,23,39,0.58974358974359,0.41025641025641,1
"13093","PRKACG",13,38,51,0.745098039215686,0.254901960784314,1
"13094","PRKAG1",11,23,34,0.676470588235294,0.323529411764706,1
"13095","PRKAG2",27,37,64,0.578125,0.421875,1
"13096","PRKAG3",22,35,57,0.614035087719298,0.385964912280702,1
"13097","PRKAR1A",16,23,39,0.58974358974359,0.41025641025641,0.77
"13098","PRKAR1B",15,21,36,0.583333333333333,0.416666666666667,0.77
"13099","PRKAR2A",4,15,19,0.789473684210526,0.210526315789474,0.77
"13100","PRKAR2B",23,26,49,0.530612244897959,0.469387755102041,0.77
"13101","PRKCA",33,43,76,0.565789473684211,0.434210526315789,1
"13102","PRKCB",60,108,168,0.642857142857143,0.357142857142857,1
"13103","PRKCD",26,36,62,0.580645161290323,0.419354838709677,1
"13104","PRKCE",26,48,74,0.648648648648649,0.351351351351351,1
"13105","PRKCG",70,73,143,0.510489510489511,0.48951048951049,1
"13106","PRKCH",32,39,71,0.549295774647887,0.450704225352113,1
"13107","PRKCI",36,55,91,0.604395604395604,0.395604395604396,1
"13108","PRKCQ",32,72,104,0.692307692307692,0.307692307692308,1
"13109","PRKCSH",16,25,41,0.609756097560976,0.390243902439024,1
"13110","PRKCZ",19,32,51,0.627450980392157,0.372549019607843,1
"13111","PRKD1",62,101,163,0.619631901840491,0.380368098159509,1
"13112","PRKD2",34,39,73,0.534246575342466,0.465753424657534,1
"13113","PRKD3",28,48,76,0.631578947368421,0.368421052631579,1
"13114","PRKDC",169,225,394,0.571065989847716,0.428934010152284,1
"13115","PRKG1",51,93,144,0.645833333333333,0.354166666666667,1
"13116","PRKG2",40,82,122,0.672131147540984,0.327868852459016,1
"13117","PRKN",30,59,89,0.662921348314607,0.337078651685393,1
"13118","PRKRA",17,19,36,0.527777777777778,0.472222222222222,1
"13119","PRKRIP1",9,12,21,0.571428571428571,0.428571428571429,1
"13120","PRKX",21,11,32,0.34375,0.65625,1
"13121","PRKY",0,6,6,1,0,1
"13122","PRL",13,26,39,0.666666666666667,0.333333333333333,1
"13123","PRLH",3,2,5,0.4,0.6,1
"13124","PRLHR",21,33,54,0.611111111111111,0.388888888888889,1
"13125","PRLR",42,97,139,0.697841726618705,0.302158273381295,1
"13126","PRM1",3,2,5,0.4,0.6,1
"13127","PRM2",2,10,12,0.833333333333333,0.166666666666667,1
"13128","PRM3",3,3,6,0.5,0.5,1
"13129","PRMT1",9,18,27,0.666666666666667,0.333333333333333,1
"13130","PRMT2",15,25,40,0.625,0.375,1
"13131","PRMT3",30,27,57,0.473684210526316,0.526315789473684,1
"13132","PRMT5",15,36,51,0.705882352941177,0.294117647058824,1
"13133","PRMT6",13,18,31,0.580645161290323,0.419354838709677,1
"13134","PRMT7",20,39,59,0.661016949152542,0.338983050847458,1
"13135","PRMT8",20,52,72,0.722222222222222,0.277777777777778,1
"13136","PRMT9",30,26,56,0.464285714285714,0.535714285714286,1
"13137","PRND",2,12,14,0.857142857142857,0.142857142857143,1
"13138","PRNP",10,15,25,0.6,0.4,1
"13139","PROC",18,43,61,0.704918032786885,0.295081967213115,1
"13140","PROCA1",13,18,31,0.580645161290323,0.419354838709677,1
"13141","PROCR",7,16,23,0.695652173913043,0.304347826086957,1
"13142","PRODH2",21,42,63,0.666666666666667,0.333333333333333,1
"13143","PROK1",0,15,15,1,0,1
"13144","PROK2",9,6,15,0.4,0.6,1
"13145","PROKR1",29,45,74,0.608108108108108,0.391891891891892,1
"13146","PROKR2",34,65,99,0.656565656565657,0.343434343434343,1
"13147","PROM1",31,31,62,0.5,0.5,1
"13148","PROM2",33,48,81,0.592592592592593,0.407407407407407,1
"13149","PROP1",8,8,16,0.5,0.5,1
"13150","PRORP",21,28,49,0.571428571428571,0.428571428571429,1
"13151","PROS1",49,90,139,0.647482014388489,0.352517985611511,1
"13152","PROSER1",26,63,89,0.707865168539326,0.292134831460674,1
"13153","PROSER2",11,12,23,0.521739130434783,0.478260869565217,1
"13154","PROSER3",16,25,41,0.609756097560976,0.390243902439024,1
"13155","PROX1",52,103,155,0.664516129032258,0.335483870967742,1
"13156","PROX2",14,41,55,0.745454545454545,0.254545454545455,1
"13157","PROZ",11,15,26,0.576923076923077,0.423076923076923,1
"13158","PRPF18",15,19,34,0.558823529411765,0.441176470588235,1
"13159","PRPF19",12,28,40,0.7,0.3,1
"13160","PRPF3",30,44,74,0.594594594594595,0.405405405405405,1
"13161","PRPF31",11,23,34,0.676470588235294,0.323529411764706,1
"13162","PRPF38A",7,16,23,0.695652173913043,0.304347826086957,1
"13163","PRPF38B",19,34,53,0.641509433962264,0.358490566037736,1
"13164","PRPF39",11,24,35,0.685714285714286,0.314285714285714,1
"13165","PRPF4",21,17,38,0.447368421052632,0.552631578947368,1
"13166","PRPF40A",16,49,65,0.753846153846154,0.246153846153846,1
"13167","PRPF40B",36,68,104,0.653846153846154,0.346153846153846,1
"13168","PRPF4B",29,54,83,0.650602409638554,0.349397590361446,1
"13169","PRPF6",40,52,92,0.565217391304348,0.434782608695652,1
"13170","PRPF8",67,108,175,0.617142857142857,0.382857142857143,1
"13171","PRPH",10,18,28,0.642857142857143,0.357142857142857,1
"13172","PRPH2",9,24,33,0.727272727272727,0.272727272727273,1
"13173","PRPS1",14,11,25,0.44,0.56,1
"13174","PRPS1L1",21,44,65,0.676923076923077,0.323076923076923,1
"13175","PRPS2",19,14,33,0.424242424242424,0.575757575757576,1
"13176","PRPSAP1",16,26,42,0.619047619047619,0.380952380952381,1
"13177","PRPSAP2",7,21,28,0.75,0.25,1
"13178","PRR11",27,24,51,0.470588235294118,0.529411764705882,1
"13179","PRR12",32,48,80,0.6,0.4,1
"13180","PRR13",2,2,4,0.5,0.5,1
"13181","PRR14",26,36,62,0.580645161290323,0.419354838709677,1
"13182","PRR14L",7,20,27,0.740740740740741,0.259259259259259,1
"13183","PRR15",4,0,4,0,1,1
"13184","PRR15L",6,5,11,0.454545454545455,0.545454545454545,1
"13185","PRR16",26,57,83,0.686746987951807,0.313253012048193,1
"13186","PRR18",1,3,4,0.75,0.25,1
"13187","PRR19",21,26,47,0.553191489361702,0.446808510638298,1
"13188","PRR22",4,7,11,0.636363636363636,0.363636363636364,1
"13189","PRR23A",1,0,1,0,1,1
"13190","PRR23B",35,53,88,0.602272727272727,0.397727272727273,1
"13191","PRR23C",2,0,2,0,1,1
"13192","PRR27",15,29,44,0.659090909090909,0.340909090909091,1
"13193","PRR3",4,7,11,0.636363636363636,0.363636363636364,1
"13194","PRR30",26,33,59,0.559322033898305,0.440677966101695,1
"13195","PRR32",1,1,2,0.5,0.5,1
"13196","PRR33",0,2,2,1,0,1
"13197","PRR34",2,2,4,0.5,0.5,1
"13198","PRR35",14,17,31,0.548387096774194,0.451612903225806,1
"13199","PRR4",1,0,1,0,1,1
"13200","PRR5",14,21,35,0.6,0.4,1
"13201","PRR5-ARHGAP8",10,25,35,0.714285714285714,0.285714285714286,1
"13202","PRR5L",17,30,47,0.638297872340426,0.361702127659574,1
"13203","PRR7",2,6,8,0.75,0.25,1
"13204","PRRC1",11,18,29,0.620689655172414,0.379310344827586,1
"13205","PRRC2A",87,113,200,0.565,0.435,1
"13206","PRRC2B",65,105,170,0.617647058823529,0.382352941176471,1
"13207","PRRC2C",81,125,206,0.606796116504854,0.393203883495146,1
"13208","PRRG1",21,26,47,0.553191489361702,0.446808510638298,1
"13209","PRRG2",5,6,11,0.545454545454545,0.454545454545455,1
"13210","PRRG3",32,30,62,0.483870967741935,0.516129032258065,1
"13211","PRRG4",3,11,14,0.785714285714286,0.214285714285714,1
"13212","PRRT1",12,14,26,0.538461538461538,0.461538461538462,1
"13213","PRRT2",15,25,40,0.625,0.375,1
"13214","PRRT3",15,32,47,0.680851063829787,0.319148936170213,1
"13215","PRRT4",1,3,4,0.75,0.25,1
"13216","PRRX1",20,29,49,0.591836734693878,0.408163265306122,1
"13217","PRRX2",7,8,15,0.533333333333333,0.466666666666667,1
"13218","PRSS1",31,61,92,0.66304347826087,0.33695652173913,1
"13219","PRSS12",33,61,94,0.648936170212766,0.351063829787234,1
"13220","PRSS16",28,52,80,0.65,0.35,1
"13221","PRSS21",13,15,28,0.535714285714286,0.464285714285714,1
"13222","PRSS22",12,20,32,0.625,0.375,1
"13223","PRSS23",17,24,41,0.585365853658537,0.414634146341463,1
"13224","PRSS27",3,8,11,0.727272727272727,0.272727272727273,1
"13225","PRSS3",2,9,11,0.818181818181818,0.181818181818182,1
"13226","PRSS33",4,6,10,0.6,0.4,1
"13227","PRSS35",36,50,86,0.581395348837209,0.418604651162791,1
"13228","PRSS36",34,47,81,0.580246913580247,0.419753086419753,1
"13229","PRSS37",18,24,42,0.571428571428571,0.428571428571429,1
"13230","PRSS38",17,30,47,0.638297872340426,0.361702127659574,1
"13231","PRSS45P",10,13,23,0.565217391304348,0.434782608695652,1
"13232","PRSS48",9,25,34,0.735294117647059,0.264705882352941,1
"13233","PRSS53",13,17,30,0.566666666666667,0.433333333333333,1
"13234","PRSS54",15,32,47,0.680851063829787,0.319148936170213,1
"13235","PRSS55",16,51,67,0.761194029850746,0.238805970149254,1
"13236","PRSS57",8,11,19,0.578947368421053,0.421052631578947,1
"13237","PRSS58",26,49,75,0.653333333333333,0.346666666666667,1
"13238","PRSS8",11,8,19,0.421052631578947,0.578947368421053,1
"13239","PRTFDC1",6,9,15,0.6,0.4,1
"13240","PRTG",63,103,166,0.620481927710843,0.379518072289157,1
"13241","PRTN3",5,8,13,0.615384615384615,0.384615384615385,1
"13242","PRUNE1",10,26,36,0.722222222222222,0.277777777777778,1
"13243","PRUNE2",150,265,415,0.63855421686747,0.36144578313253,1
"13244","PRX",65,85,150,0.566666666666667,0.433333333333333,1
"13245","PRXL2A",8,16,24,0.666666666666667,0.333333333333333,1
"13246","PRXL2B",2,9,11,0.818181818181818,0.181818181818182,1
"13247","PRXL2C",6,6,12,0.5,0.5,1
"13248","PSAP",18,30,48,0.625,0.375,1
"13249","PSAPL1",15,27,42,0.642857142857143,0.357142857142857,1
"13250","PSAT1",9,24,33,0.727272727272727,0.272727272727273,1
"13251","PSCA",4,9,13,0.692307692307692,0.307692307692308,1
"13252","PSD",37,94,131,0.717557251908397,0.282442748091603,1
"13253","PSD2",41,79,120,0.658333333333333,0.341666666666667,1
"13254","PSD3",39,82,121,0.677685950413223,0.322314049586777,1
"13255","PSD4",41,74,115,0.643478260869565,0.356521739130435,1
"13256","PSEN1",14,26,40,0.65,0.35,1
"13257","PSEN2",23,21,44,0.477272727272727,0.522727272727273,1
"13258","PSENEN",4,8,12,0.666666666666667,0.333333333333333,1
"13259","PSG1",30,67,97,0.690721649484536,0.309278350515464,1
"13260","PSG11",27,60,87,0.689655172413793,0.310344827586207,1
"13261","PSG2",37,72,109,0.660550458715596,0.339449541284404,1
"13262","PSG3",34,63,97,0.649484536082474,0.350515463917526,1
"13263","PSG4",46,63,109,0.577981651376147,0.422018348623853,1
"13264","PSG5",26,66,92,0.717391304347826,0.282608695652174,1
"13265","PSG6",34,74,108,0.685185185185185,0.314814814814815,1
"13266","PSG7",36,77,113,0.68141592920354,0.31858407079646,1
"13267","PSG8",43,74,117,0.632478632478632,0.367521367521368,1
"13268","PSG9",39,61,100,0.61,0.39,1
"13269","PSIP1",25,50,75,0.666666666666667,0.333333333333333,1
"13270","PSKH1",19,14,33,0.424242424242424,0.575757575757576,1
"13271","PSKH2",26,50,76,0.657894736842105,0.342105263157895,1
"13272","PSMA1",13,21,34,0.617647058823529,0.382352941176471,1
"13273","PSMA2",5,6,11,0.545454545454545,0.454545454545455,1
"13274","PSMA3",11,9,20,0.45,0.55,1
"13275","PSMA4",12,18,30,0.6,0.4,1
"13276","PSMA5",10,11,21,0.523809523809524,0.476190476190476,1
"13277","PSMA6",11,17,28,0.607142857142857,0.392857142857143,1
"13278","PSMA7",7,11,18,0.611111111111111,0.388888888888889,1
"13279","PSMA8",20,32,52,0.615384615384615,0.384615384615385,1
"13280","PSMB1",7,10,17,0.588235294117647,0.411764705882353,1
"13281","PSMB10",6,6,12,0.5,0.5,1
"13282","PSMB11",12,26,38,0.684210526315789,0.315789473684211,1
"13283","PSMB2",8,9,17,0.529411764705882,0.470588235294118,1
"13284","PSMB3",4,13,17,0.764705882352941,0.235294117647059,1
"13285","PSMB4",6,13,19,0.684210526315789,0.315789473684211,1
"13286","PSMB5",5,16,21,0.761904761904762,0.238095238095238,1
"13287","PSMB6",4,7,11,0.636363636363636,0.363636363636364,1
"13288","PSMB7",6,7,13,0.538461538461538,0.461538461538462,1
"13289","PSMB8",14,17,31,0.548387096774194,0.451612903225806,1
"13290","PSMB9",7,9,16,0.5625,0.4375,1
"13291","PSMC1",10,17,27,0.62962962962963,0.37037037037037,1
"13292","PSMC2",21,28,49,0.571428571428571,0.428571428571429,1
"13293","PSMC3",13,23,36,0.638888888888889,0.361111111111111,1
"13294","PSMC3IP",9,11,20,0.55,0.45,1
"13295","PSMC4",19,20,39,0.512820512820513,0.487179487179487,1
"13296","PSMC5",14,27,41,0.658536585365854,0.341463414634146,1
"13297","PSMC6",15,27,42,0.642857142857143,0.357142857142857,1
"13298","PSMD1",32,59,91,0.648351648351648,0.351648351648352,1
"13299","PSMD10",3,5,8,0.625,0.375,1
"13300","PSMD11",13,22,35,0.628571428571429,0.371428571428571,1
"13301","PSMD12",15,24,39,0.615384615384615,0.384615384615385,1
"13302","PSMD13",5,13,18,0.722222222222222,0.277777777777778,1
"13303","PSMD14",4,11,15,0.733333333333333,0.266666666666667,1
"13304","PSMD2",27,41,68,0.602941176470588,0.397058823529412,1
"13305","PSMD3",21,24,45,0.533333333333333,0.466666666666667,1
"13306","PSMD4",8,18,26,0.692307692307692,0.307692307692308,1
"13307","PSMD5",11,15,26,0.576923076923077,0.423076923076923,1
"13308","PSMD6",9,16,25,0.64,0.36,1
"13309","PSMD7",11,9,20,0.45,0.55,1
"13310","PSMD8",6,5,11,0.454545454545455,0.545454545454545,1
"13311","PSMD9",11,5,16,0.3125,0.6875,1
"13312","PSME1",4,7,11,0.636363636363636,0.363636363636364,1
"13313","PSME2",9,11,20,0.55,0.45,1
"13314","PSME3",8,13,21,0.619047619047619,0.380952380952381,1
"13315","PSME3IP1",5,11,16,0.6875,0.3125,1
"13316","PSME4",62,102,164,0.621951219512195,0.378048780487805,1
"13317","PSMF1",11,22,33,0.666666666666667,0.333333333333333,1
"13318","PSMG1",8,10,18,0.555555555555556,0.444444444444444,1
"13319","PSMG2",6,11,17,0.647058823529412,0.352941176470588,1
"13320","PSMG3",3,6,9,0.666666666666667,0.333333333333333,1
"13321","PSORS1C1",4,13,17,0.764705882352941,0.235294117647059,1
"13322","PSORS1C2",2,9,11,0.818181818181818,0.181818181818182,1
"13323","PSPC1",21,50,71,0.704225352112676,0.295774647887324,1
"13324","PSPH",10,16,26,0.615384615384615,0.384615384615385,1
"13325","PSPN",3,5,8,0.625,0.375,1
"13326","PSRC1",10,8,18,0.444444444444444,0.555555555555556,1
"13327","PSTK",10,20,30,0.666666666666667,0.333333333333333,1
"13328","PSTPIP1",7,12,19,0.631578947368421,0.368421052631579,1
"13329","PSTPIP2",11,20,31,0.645161290322581,0.354838709677419,1
"13330","PTAFR",14,20,34,0.588235294117647,0.411764705882353,1
"13331","PTAR1",11,13,24,0.541666666666667,0.458333333333333,0.77
"13332","PTBP1",20,24,44,0.545454545454545,0.454545454545455,1
"13333","PTBP2",34,45,79,0.569620253164557,0.430379746835443,1
"13334","PTBP3",14,25,39,0.641025641025641,0.358974358974359,1
"13335","PTCD1",21,38,59,0.644067796610169,0.355932203389831,1
"13336","PTCD2",14,15,29,0.517241379310345,0.482758620689655,1
"13337","PTCD3",22,27,49,0.551020408163265,0.448979591836735,1
"13338","PTCH1",72,97,169,0.57396449704142,0.42603550295858,1
"13339","PTCH2",41,65,106,0.613207547169811,0.386792452830189,1
"13340","PTCHD1",71,38,109,0.348623853211009,0.651376146788991,1
"13341","PTCHD3",60,84,144,0.583333333333333,0.416666666666667,1
"13342","PTCHD4",58,100,158,0.632911392405063,0.367088607594937,1
"13343","PTCRA",12,17,29,0.586206896551724,0.413793103448276,1
"13344","PTDSS1",22,47,69,0.681159420289855,0.318840579710145,1
"13345","PTDSS2",9,14,23,0.608695652173913,0.391304347826087,1
"13346","PTEN",189,280,469,0.597014925373134,0.402985074626866,1
"13347","PTER",16,26,42,0.619047619047619,0.380952380952381,1
"13348","PTF1A",11,21,32,0.65625,0.34375,1
"13349","PTGDR",16,41,57,0.719298245614035,0.280701754385965,1
"13350","PTGDR2",7,7,14,0.5,0.5,1
"13351","PTGDS",9,15,24,0.625,0.375,1
"13352","PTGER1",3,3,6,0.5,0.5,1
"13353","PTGER2",23,28,51,0.549019607843137,0.450980392156863,1
"13354","PTGER3",31,65,96,0.677083333333333,0.322916666666667,1
"13355","PTGER4",21,27,48,0.5625,0.4375,1
"13356","PTGES",2,5,7,0.714285714285714,0.285714285714286,1
"13357","PTGES2",6,9,15,0.6,0.4,1
"13358","PTGES3",1,6,7,0.857142857142857,0.142857142857143,1
"13359","PTGES3L-AARSD1",18,26,44,0.590909090909091,0.409090909090909,0.77
"13360","PTGFR",33,57,90,0.633333333333333,0.366666666666667,1
"13361","PTGFRN",26,54,80,0.675,0.325,1
"13362","PTGIR",11,16,27,0.592592592592593,0.407407407407407,1
"13363","PTGIS",16,51,67,0.761194029850746,0.238805970149254,1
"13364","PTGR1",9,17,26,0.653846153846154,0.346153846153846,1
"13365","PTGR2",9,11,20,0.55,0.45,1
"13366","PTGS1",29,64,93,0.688172043010753,0.311827956989247,1
"13367","PTGS2",27,47,74,0.635135135135135,0.364864864864865,1
"13368","PTH",9,11,20,0.55,0.45,1
"13369","PTH1R",25,40,65,0.615384615384615,0.384615384615385,1
"13370","PTH2",2,4,6,0.666666666666667,0.333333333333333,1
"13371","PTH2R",44,64,108,0.592592592592593,0.407407407407407,1
"13372","PTHLH",10,23,33,0.696969696969697,0.303030303030303,1
"13373","PTK2",42,58,100,0.58,0.42,1
"13374","PTK2B",38,71,109,0.651376146788991,0.348623853211009,1
"13375","PTK6",10,17,27,0.62962962962963,0.37037037037037,1
"13376","PTK7",35,61,96,0.635416666666667,0.364583333333333,1
"13377","PTMA",3,5,8,0.625,0.375,1
"13378","PTMAP5",0,5,5,1,0,1
"13379","PTMS",4,4,8,0.5,0.5,1
"13380","PTN",17,24,41,0.585365853658537,0.414634146341463,1
"13381","PTOV1",23,22,45,0.488888888888889,0.511111111111111,1
"13382","PTP4A1",7,5,12,0.416666666666667,0.583333333333333,1
"13383","PTP4A2",4,7,11,0.636363636363636,0.363636363636364,1
"13384","PTP4A3",5,19,24,0.791666666666667,0.208333333333333,1
"13385","PTPA",8,14,22,0.636363636363636,0.363636363636364,1
"13386","PTPDC1",20,34,54,0.62962962962963,0.37037037037037,1
"13387","PTPMT1",4,12,16,0.75,0.25,1
"13388","PTPN1",14,26,40,0.65,0.35,1
"13389","PTPN11",32,57,89,0.640449438202247,0.359550561797753,1
"13390","PTPN12",35,47,82,0.573170731707317,0.426829268292683,1
"13391","PTPN13",75,146,221,0.660633484162896,0.339366515837104,1
"13392","PTPN14",58,97,155,0.625806451612903,0.374193548387097,1
"13393","PTPN18",6,19,25,0.76,0.24,1
"13394","PTPN2",11,28,39,0.717948717948718,0.282051282051282,1
"13395","PTPN20",16,32,48,0.666666666666667,0.333333333333333,1
"13396","PTPN21",47,67,114,0.587719298245614,0.412280701754386,1
"13397","PTPN22",26,65,91,0.714285714285714,0.285714285714286,1
"13398","PTPN23",49,47,96,0.489583333333333,0.510416666666667,1
"13399","PTPN3",46,69,115,0.6,0.4,1
"13400","PTPN4",46,69,115,0.6,0.4,1
"13401","PTPN5",26,46,72,0.638888888888889,0.361111111111111,1
"13402","PTPN6",26,31,57,0.543859649122807,0.456140350877193,1
"13403","PTPN7",16,19,35,0.542857142857143,0.457142857142857,1
"13404","PTPN9",31,32,63,0.507936507936508,0.492063492063492,1
"13405","PTPRA",26,50,76,0.657894736842105,0.342105263157895,1
"13406","PTPRB",104,247,351,0.703703703703704,0.296296296296296,1
"13407","PTPRC",90,189,279,0.67741935483871,0.32258064516129,1
"13408","PTPRCAP",3,8,11,0.727272727272727,0.272727272727273,1
"13409","PTPRD",175,291,466,0.624463519313305,0.375536480686695,1
"13410","PTPRE",28,58,86,0.674418604651163,0.325581395348837,1
"13411","PTPRF",64,105,169,0.621301775147929,0.378698224852071,1
"13412","PTPRG",59,84,143,0.587412587412587,0.412587412587413,1
"13413","PTPRH",57,98,155,0.632258064516129,0.367741935483871,1
"13414","PTPRJ",45,74,119,0.621848739495798,0.378151260504202,1
"13415","PTPRK",78,161,239,0.673640167364017,0.326359832635983,1
"13416","PTPRM",89,127,216,0.587962962962963,0.412037037037037,1
"13417","PTPRN",49,72,121,0.59504132231405,0.40495867768595,1
"13418","PTPRN2",83,125,208,0.600961538461538,0.399038461538462,1
"13419","PTPRO",53,107,160,0.66875,0.33125,1
"13420","PTPRQ",2,8,10,0.8,0.2,1
"13421","PTPRR",56,87,143,0.608391608391608,0.391608391608392,1
"13422","PTPRS",74,113,187,0.60427807486631,0.39572192513369,1
"13423","PTPRT",188,302,490,0.616326530612245,0.383673469387755,1
"13424","PTPRU",71,102,173,0.589595375722543,0.410404624277457,1
"13425","PTPRZ1",131,218,349,0.624641833810888,0.375358166189112,1
"13426","PTRH1",4,9,13,0.692307692307692,0.307692307692308,1
"13427","PTRH2",1,9,10,0.9,0.1,1
"13428","PTRHD1",5,7,12,0.583333333333333,0.416666666666667,1
"13429","PTS",1,2,3,0.666666666666667,0.333333333333333,1
"13430","PTTG1",6,10,16,0.625,0.375,1
"13431","PTTG1IP",11,10,21,0.476190476190476,0.523809523809524,1
"13432","PTTG2",6,15,21,0.714285714285714,0.285714285714286,1
"13433","PTX3",12,16,28,0.571428571428571,0.428571428571429,1
"13434","PTX4",15,36,51,0.705882352941177,0.294117647058824,1
"13435","PUDP",4,14,18,0.777777777777778,0.222222222222222,1
"13436","PUF60",11,20,31,0.645161290322581,0.354838709677419,1
"13437","PUM1",34,81,115,0.704347826086957,0.295652173913043,1
"13438","PUM2",36,58,94,0.617021276595745,0.382978723404255,1
"13439","PUM3",24,30,54,0.555555555555556,0.444444444444444,1
"13440","PURA",12,9,21,0.428571428571429,0.571428571428571,1
"13441","PURB",5,11,16,0.6875,0.3125,1
"13442","PURG",18,30,48,0.625,0.375,1
"13443","PUS1",8,22,30,0.733333333333333,0.266666666666667,1
"13444","PUS10",11,31,42,0.738095238095238,0.261904761904762,1
"13445","PUS3",14,27,41,0.658536585365854,0.341463414634146,1
"13446","PUS7",29,46,75,0.613333333333333,0.386666666666667,1
"13447","PUS7L",29,36,65,0.553846153846154,0.446153846153846,1
"13448","PUSL1",2,7,9,0.777777777777778,0.222222222222222,1
"13449","PVALB",6,10,16,0.625,0.375,0.86
"13450","PVR",15,15,30,0.5,0.5,1
"13451","PVRIG",7,21,28,0.75,0.25,1
"13452","PWP1",22,26,48,0.541666666666667,0.458333333333333,1
"13453","PWP2",0,2,2,1,0,1
"13454","PWWP2A",11,15,26,0.576923076923077,0.423076923076923,1
"13455","PWWP2B",21,34,55,0.618181818181818,0.381818181818182,1
"13456","PWWP3A",16,24,40,0.6,0.4,1
"13457","PWWP3B",54,57,111,0.513513513513513,0.486486486486487,1
"13458","PXDC1",4,11,15,0.733333333333333,0.266666666666667,1
"13459","PXDN",89,178,267,0.666666666666667,0.333333333333333,1
"13460","PXDNL",159,259,418,0.619617224880383,0.380382775119617,1
"13461","PXK",20,36,56,0.642857142857143,0.357142857142857,1
"13462","PXMP2",5,8,13,0.615384615384615,0.384615384615385,1
"13463","PXMP4",7,11,18,0.611111111111111,0.388888888888889,1
"13464","PXN",18,14,32,0.4375,0.5625,1
"13465","PXT1",3,10,13,0.769230769230769,0.230769230769231,1
"13466","PXYLP1",14,22,36,0.611111111111111,0.388888888888889,1
"13467","PYCARD",10,8,18,0.444444444444444,0.555555555555556,0.77
"13468","PYCR1",9,8,17,0.470588235294118,0.529411764705882,1
"13469","PYCR2",12,10,22,0.454545454545455,0.545454545454545,1
"13470","PYCR3",3,5,8,0.625,0.375,1
"13471","PYDC1",6,17,23,0.739130434782609,0.260869565217391,1
"13472","PYDC2",5,14,19,0.736842105263158,0.263157894736842,1
"13473","PYGB",34,32,66,0.484848484848485,0.515151515151515,1
"13474","PYGL",24,55,79,0.69620253164557,0.30379746835443,1
"13475","PYGM",39,68,107,0.635514018691589,0.364485981308411,1
"13476","PYGO1",16,37,53,0.69811320754717,0.30188679245283,1
"13477","PYGO2",25,32,57,0.56140350877193,0.43859649122807,1
"13478","PYHIN1",48,94,142,0.661971830985915,0.338028169014085,1
"13479","PYM1",7,12,19,0.631578947368421,0.368421052631579,1
"13480","PYROXD1",15,14,29,0.482758620689655,0.517241379310345,1
"13481","PYROXD2",10,23,33,0.696969696969697,0.303030303030303,1
"13482","PYY",2,7,9,0.777777777777778,0.222222222222222,1
"13483","PYY3",7,6,13,0.461538461538462,0.538461538461538,1
"13484","PZP",89,144,233,0.618025751072961,0.381974248927039,1
"13485","QARS1",23,40,63,0.634920634920635,0.365079365079365,0.77
"13486","QDPR",13,14,27,0.518518518518518,0.481481481481481,1
"13487","QKI",31,45,76,0.592105263157895,0.407894736842105,1
"13488","QPCT",9,27,36,0.75,0.25,1
"13489","QPCTL",8,15,23,0.652173913043478,0.347826086956522,1
"13490","QPRT",8,14,22,0.636363636363636,0.363636363636364,1
"13491","QRFP",2,7,9,0.777777777777778,0.222222222222222,1
"13492","QRFPR",21,45,66,0.681818181818182,0.318181818181818,1
"13493","QRICH1",27,38,65,0.584615384615385,0.415384615384615,1
"13494","QRICH2",45,72,117,0.615384615384615,0.384615384615385,1
"13495","QRSL1",23,23,46,0.5,0.5,1
"13496","QSER1",61,89,150,0.593333333333333,0.406666666666667,1
"13497","QSOX1",19,35,54,0.648148148148148,0.351851851851852,1
"13498","QSOX2",20,34,54,0.62962962962963,0.37037037037037,1
"13499","QTRT1",16,23,39,0.58974358974359,0.41025641025641,1
"13500","QTRT2",15,22,37,0.594594594594595,0.405405405405405,1
"13501","R3HCC1",0,1,1,1,0,1
"13502","R3HCC1L",20,48,68,0.705882352941177,0.294117647058824,1
"13503","R3HDM1",42,90,132,0.681818181818182,0.318181818181818,1
"13504","R3HDM2",26,29,55,0.527272727272727,0.472727272727273,1
"13505","R3HDM4",12,7,19,0.368421052631579,0.631578947368421,1
"13506","R3HDML",15,25,40,0.625,0.375,1
"13507","RAB10",6,9,15,0.6,0.4,1
"13508","RAB11A",7,9,16,0.5625,0.4375,1
"13509","RAB11B",12,18,30,0.6,0.4,1
"13510","RAB11FIP1",42,75,117,0.641025641025641,0.358974358974359,1
"13511","RAB11FIP2",19,30,49,0.612244897959184,0.387755102040816,1
"13512","RAB11FIP3",14,19,33,0.575757575757576,0.424242424242424,1
"13513","RAB11FIP4",18,32,50,0.64,0.36,1
"13514","RAB11FIP5",20,36,56,0.642857142857143,0.357142857142857,1
"13515","RAB12",5,11,16,0.6875,0.3125,1
"13516","RAB13",5,11,16,0.6875,0.3125,1
"13517","RAB14",8,9,17,0.529411764705882,0.470588235294118,1
"13518","RAB15",3,9,12,0.75,0.25,1
"13519","RAB17",9,9,18,0.5,0.5,1
"13520","RAB18",5,9,14,0.642857142857143,0.357142857142857,1
"13521","RAB19",8,15,23,0.652173913043478,0.347826086956522,1
"13522","RAB1A",6,4,10,0.4,0.6,1
"13523","RAB1B",8,10,18,0.555555555555556,0.444444444444444,1
"13524","RAB20",5,15,20,0.75,0.25,1
"13525","RAB21",4,10,14,0.714285714285714,0.285714285714286,1
"13526","RAB22A",8,12,20,0.6,0.4,1
"13527","RAB23",3,20,23,0.869565217391304,0.130434782608696,1
"13528","RAB24",6,5,11,0.454545454545455,0.545454545454545,1
"13529","RAB25",8,15,23,0.652173913043478,0.347826086956522,1
"13530","RAB26",6,14,20,0.7,0.3,1
"13531","RAB27A",8,12,20,0.6,0.4,1
"13532","RAB27B",12,30,42,0.714285714285714,0.285714285714286,1
"13533","RAB28",8,13,21,0.619047619047619,0.380952380952381,1
"13534","RAB29",7,17,24,0.708333333333333,0.291666666666667,1
"13535","RAB2A",8,9,17,0.529411764705882,0.470588235294118,1
"13536","RAB2B",4,9,13,0.692307692307692,0.307692307692308,1
"13537","RAB30",6,13,19,0.684210526315789,0.315789473684211,1
"13538","RAB31",4,7,11,0.636363636363636,0.363636363636364,1
"13539","RAB32",8,11,19,0.578947368421053,0.421052631578947,1
"13540","RAB33A",12,8,20,0.4,0.6,1
"13541","RAB33B",7,6,13,0.461538461538462,0.538461538461538,1
"13542","RAB34",19,18,37,0.486486486486487,0.513513513513513,1
"13543","RAB35",13,7,20,0.35,0.65,1
"13544","RAB36",15,10,25,0.4,0.6,1
"13545","RAB37",11,21,32,0.65625,0.34375,1
"13546","RAB38",10,12,22,0.545454545454545,0.454545454545455,1
"13547","RAB39A",10,14,24,0.583333333333333,0.416666666666667,1
"13548","RAB39B",21,7,28,0.25,0.75,1
"13549","RAB3A",9,11,20,0.55,0.45,1
"13550","RAB3B",7,14,21,0.666666666666667,0.333333333333333,1
"13551","RAB3C",17,38,55,0.690909090909091,0.309090909090909,1
"13552","RAB3D",11,15,26,0.576923076923077,0.423076923076923,1
"13553","RAB3GAP1",24,60,84,0.714285714285714,0.285714285714286,1
"13554","RAB3GAP2",37,96,133,0.721804511278195,0.278195488721804,1
"13555","RAB3IL1",10,17,27,0.62962962962963,0.37037037037037,1
"13556","RAB3IP",24,50,74,0.675675675675676,0.324324324324324,1
"13557","RAB40A",19,6,25,0.24,0.76,1
"13558","RAB40AL",12,16,28,0.571428571428571,0.428571428571429,1
"13559","RAB40B",10,14,24,0.583333333333333,0.416666666666667,1
"13560","RAB40C",14,15,29,0.517241379310345,0.482758620689655,1
"13561","RAB41",17,6,23,0.260869565217391,0.739130434782609,1
"13562","RAB42",6,13,19,0.684210526315789,0.315789473684211,1
"13563","RAB43",5,9,14,0.642857142857143,0.357142857142857,1
"13564","RAB44",0,1,1,1,0,1
"13565","RAB4A",9,13,22,0.590909090909091,0.409090909090909,1
"13566","RAB4B",11,10,21,0.476190476190476,0.523809523809524,1
"13567","RAB5A",9,17,26,0.653846153846154,0.346153846153846,1
"13568","RAB5B",5,9,14,0.642857142857143,0.357142857142857,1
"13569","RAB5C",5,13,18,0.722222222222222,0.277777777777778,1
"13570","RAB5IF",0,6,6,1,0,1
"13571","RAB6A",8,13,21,0.619047619047619,0.380952380952381,1
"13572","RAB6B",18,19,37,0.513513513513513,0.486486486486487,1
"13573","RAB6C",13,19,32,0.59375,0.40625,1
"13574","RAB6D",12,15,27,0.555555555555556,0.444444444444444,1
"13575","RAB7A",9,11,20,0.55,0.45,1
"13576","RAB8A",9,11,20,0.55,0.45,1
"13577","RAB8B",7,14,21,0.666666666666667,0.333333333333333,1
"13578","RAB9A",8,1,9,0.111111111111111,0.888888888888889,1
"13579","RAB9B",14,7,21,0.333333333333333,0.666666666666667,1
"13580","RABAC1",7,10,17,0.588235294117647,0.411764705882353,1
"13581","RABEP1",18,41,59,0.694915254237288,0.305084745762712,1
"13582","RABEP2",29,30,59,0.508474576271186,0.491525423728814,1
"13583","RABEPK",15,15,30,0.5,0.5,1
"13584","RABGAP1",51,48,99,0.484848484848485,0.515151515151515,1
"13585","RABGAP1L",43,53,96,0.552083333333333,0.447916666666667,1
"13586","RABGEF1",24,33,57,0.578947368421053,0.421052631578947,1
"13587","RABGGTA",19,25,44,0.568181818181818,0.431818181818182,1
"13588","RABGGTB",15,30,45,0.666666666666667,0.333333333333333,1
"13589","RABIF",4,6,10,0.6,0.4,1
"13590","RABL2A",3,19,22,0.863636363636364,0.136363636363636,0.39
"13591","RABL2B",4,9,13,0.692307692307692,0.307692307692308,0.39
"13592","RABL3",16,24,40,0.6,0.4,1
"13593","RABL6",14,30,44,0.681818181818182,0.318181818181818,1
"13594","RAC1",25,37,62,0.596774193548387,0.403225806451613,1
"13595","RAC2",10,19,29,0.655172413793103,0.344827586206897,1
"13596","RAC3",7,8,15,0.533333333333333,0.466666666666667,1
"13597","RACGAP1",14,30,44,0.681818181818182,0.318181818181818,1
"13598","RACK1",13,12,25,0.48,0.52,1
"13599","RAD1",8,16,24,0.666666666666667,0.333333333333333,1
"13600","RAD17",23,34,57,0.596491228070175,0.403508771929825,1
"13601","RAD18",18,33,51,0.647058823529412,0.352941176470588,1
"13602","RAD21",29,51,80,0.6375,0.3625,1
"13603","RAD21L1",0,3,3,1,0,1
"13604","RAD23A",16,19,35,0.542857142857143,0.457142857142857,1
"13605","RAD23B",15,21,36,0.583333333333333,0.416666666666667,1
"13606","RAD50",41,87,128,0.6796875,0.3203125,1
"13607","RAD51",5,14,19,0.736842105263158,0.263157894736842,1
"13608","RAD51AP1",23,23,46,0.5,0.5,1
"13609","RAD51AP2",74,110,184,0.597826086956522,0.402173913043478,1
"13610","RAD51B",7,16,23,0.695652173913043,0.304347826086957,1
"13611","RAD51C",19,18,37,0.486486486486487,0.513513513513513,1
"13612","RAD51D",10,20,30,0.666666666666667,0.333333333333333,1
"13613","RAD52",8,16,24,0.666666666666667,0.333333333333333,1
"13614","RAD54B",25,47,72,0.652777777777778,0.347222222222222,1
"13615","RAD54L",23,29,52,0.557692307692308,0.442307692307692,1
"13616","RAD54L2",42,67,109,0.614678899082569,0.385321100917431,1
"13617","RAD9A",12,10,22,0.454545454545455,0.545454545454545,1
"13618","RAD9B",10,22,32,0.6875,0.3125,1
"13619","RADIL",49,81,130,0.623076923076923,0.376923076923077,1
"13620","RADX",31,40,71,0.563380281690141,0.436619718309859,1
"13621","RAE1",13,22,35,0.628571428571429,0.371428571428571,1
"13622","RAET1E",6,8,14,0.571428571428571,0.428571428571429,1
"13623","RAET1G",4,14,18,0.777777777777778,0.222222222222222,1
"13624","RAET1L",8,14,22,0.636363636363636,0.363636363636364,1
"13625","RAF1",24,34,58,0.586206896551724,0.413793103448276,1
"13626","RAG1",77,87,164,0.530487804878049,0.469512195121951,1
"13627","RAG2",32,56,88,0.636363636363636,0.363636363636364,1
"13628","RAI1",64,107,171,0.625730994152047,0.374269005847953,1
"13629","RAI14",36,66,102,0.647058823529412,0.352941176470588,1
"13630","RAI2",43,28,71,0.394366197183099,0.605633802816901,1
"13631","RALA",13,11,24,0.458333333333333,0.541666666666667,1
"13632","RALB",6,20,26,0.769230769230769,0.230769230769231,0.86
"13633","RALBP1",20,26,46,0.565217391304348,0.434782608695652,0.86
"13634","RALGAPA1",64,109,173,0.630057803468208,0.369942196531792,1
"13635","RALGAPA2",48,104,152,0.684210526315789,0.315789473684211,1
"13636","RALGAPB",73,95,168,0.56547619047619,0.43452380952381,1
"13637","RALGDS",22,37,59,0.627118644067797,0.372881355932203,1
"13638","RALGPS1",15,35,50,0.7,0.3,1
"13639","RALGPS2",27,53,80,0.6625,0.3375,1
"13640","RALY",10,20,30,0.666666666666667,0.333333333333333,1
"13641","RALYL",23,64,87,0.735632183908046,0.264367816091954,1
"13642","RAMAC",1,2,3,0.666666666666667,0.333333333333333,1
"13643","RAMP1",3,7,10,0.7,0.3,1
"13644","RAMP2",2,10,12,0.833333333333333,0.166666666666667,1
"13645","RAMP3",17,9,26,0.346153846153846,0.653846153846154,1
"13646","RAN",10,11,21,0.523809523809524,0.476190476190476,1
"13647","RANBP1",4,10,14,0.714285714285714,0.285714285714286,1
"13648","RANBP10",20,38,58,0.655172413793103,0.344827586206897,1
"13649","RANBP17",48,79,127,0.622047244094488,0.377952755905512,1
"13650","RANBP2",106,188,294,0.639455782312925,0.360544217687075,1
"13651","RANBP3",21,37,58,0.637931034482759,0.362068965517241,1
"13652","RANBP3L",27,44,71,0.619718309859155,0.380281690140845,1
"13653","RANBP6",36,53,89,0.595505617977528,0.404494382022472,1
"13654","RANBP9",14,30,44,0.681818181818182,0.318181818181818,1
"13655","RANGAP1",14,32,46,0.695652173913043,0.304347826086957,0.11
"13656","RANGRF",5,2,7,0.285714285714286,0.714285714285714,0.11
"13657","RAP1A",8,10,18,0.555555555555556,0.444444444444444,1
"13658","RAP1B",8,11,19,0.578947368421053,0.421052631578947,1
"13659","RAP1GAP",16,43,59,0.728813559322034,0.271186440677966,1
"13660","RAP1GAP2",18,39,57,0.684210526315789,0.315789473684211,1
"13661","RAP1GDS1",19,37,56,0.660714285714286,0.339285714285714,1
"13662","RAP2A",4,8,12,0.666666666666667,0.333333333333333,1
"13663","RAP2B",10,10,20,0.5,0.5,1
"13664","RAP2C",14,4,18,0.222222222222222,0.777777777777778,1
"13665","RAPGEF1",36,46,82,0.560975609756098,0.439024390243902,1
"13666","RAPGEF2",70,109,179,0.608938547486033,0.391061452513966,1
"13667","RAPGEF3",27,54,81,0.666666666666667,0.333333333333333,1
"13668","RAPGEF4",38,67,105,0.638095238095238,0.361904761904762,1
"13669","RAPGEF5",27,46,73,0.63013698630137,0.36986301369863,1
"13670","RAPGEF6",57,73,130,0.561538461538462,0.438461538461538,1
"13671","RAPGEFL1",12,17,29,0.586206896551724,0.413793103448276,1
"13672","RAPH1",40,48,88,0.545454545454545,0.454545454545455,1
"13673","RAPSN",9,12,21,0.571428571428571,0.428571428571429,1
"13674","RARA",16,36,52,0.692307692307692,0.307692307692308,0.77
"13675","RARB",32,40,72,0.555555555555556,0.444444444444444,0.77
"13676","RARG",24,36,60,0.6,0.4,0.77
"13677","RARRES1",8,13,21,0.619047619047619,0.380952380952381,0.77
"13678","RARRES2",7,7,14,0.5,0.5,0.77
"13679","RARS1",16,37,53,0.69811320754717,0.30188679245283,0.77
"13680","RARS2",22,37,59,0.627118644067797,0.372881355932203,0.77
"13681","RASA1",49,110,159,0.691823899371069,0.308176100628931,1
"13682","RASA2",32,65,97,0.670103092783505,0.329896907216495,1
"13683","RASA3",45,43,88,0.488636363636364,0.511363636363636,1
"13684","RASA4",3,6,9,0.666666666666667,0.333333333333333,1
"13685","RASA4B",0,1,1,1,0,1
"13686","RASAL1",42,67,109,0.614678899082569,0.385321100917431,1
"13687","RASAL2",63,95,158,0.60126582278481,0.39873417721519,1
"13688","RASAL3",27,55,82,0.670731707317073,0.329268292682927,1
"13689","RASD1",5,11,16,0.6875,0.3125,1
"13690","RASD2",17,28,45,0.622222222222222,0.377777777777778,1
"13691","RASEF",41,40,81,0.493827160493827,0.506172839506173,1
"13692","RASGEF1A",18,33,51,0.647058823529412,0.352941176470588,1
"13693","RASGEF1B",13,37,50,0.74,0.26,1
"13694","RASGEF1C",20,36,56,0.642857142857143,0.357142857142857,1
"13695","RASGRF1",48,118,166,0.710843373493976,0.289156626506024,1
"13696","RASGRF2",63,113,176,0.642045454545455,0.357954545454545,1
"13697","RASGRP1",29,43,72,0.597222222222222,0.402777777777778,1
"13698","RASGRP2",28,40,68,0.588235294117647,0.411764705882353,1
"13699","RASGRP3",34,63,97,0.649484536082474,0.350515463917526,1
"13700","RASGRP4",22,39,61,0.639344262295082,0.360655737704918,1
"13701","RASIP1",15,35,50,0.7,0.3,1
"13702","RASL10A",2,4,6,0.666666666666667,0.333333333333333,1
"13703","RASL10B",10,14,24,0.583333333333333,0.416666666666667,1
"13704","RASL11A",10,11,21,0.523809523809524,0.476190476190476,1
"13705","RASL11B",9,7,16,0.4375,0.5625,1
"13706","RASL12",8,17,25,0.68,0.32,1
"13707","RASSF1",11,8,19,0.421052631578947,0.578947368421053,1
"13708","RASSF10",6,21,27,0.777777777777778,0.222222222222222,1
"13709","RASSF2",24,43,67,0.641791044776119,0.358208955223881,1
"13710","RASSF3",9,5,14,0.357142857142857,0.642857142857143,1
"13711","RASSF4",7,27,34,0.794117647058823,0.205882352941176,1
"13712","RASSF5",11,19,30,0.633333333333333,0.366666666666667,1
"13713","RASSF6",19,26,45,0.577777777777778,0.422222222222222,1
"13714","RASSF7",8,12,20,0.6,0.4,1
"13715","RASSF8",13,21,34,0.617647058823529,0.382352941176471,1
"13716","RASSF9",26,51,77,0.662337662337662,0.337662337662338,1
"13717","RAVER1",17,33,50,0.66,0.34,1
"13718","RAVER2",22,32,54,0.592592592592593,0.407407407407407,1
"13719","RAX",3,13,16,0.8125,0.1875,1
"13720","RAX2",1,3,4,0.75,0.25,1
"13721","RB1",151,179,330,0.542424242424242,0.457575757575758,1
"13722","RB1CC1",56,99,155,0.638709677419355,0.361290322580645,1
"13723","RBAK",36,53,89,0.595505617977528,0.404494382022472,1
"13724","RBAK-RBAKDN",5,11,16,0.6875,0.3125,1
"13725","RBBP4",15,16,31,0.516129032258065,0.483870967741935,1
"13726","RBBP5",15,28,43,0.651162790697674,0.348837209302326,1
"13727","RBBP6",67,135,202,0.668316831683168,0.331683168316832,1
"13728","RBBP7",28,24,52,0.461538461538462,0.538461538461538,1
"13729","RBBP8",38,53,91,0.582417582417582,0.417582417582418,1
"13730","RBBP8NL",19,32,51,0.627450980392157,0.372549019607843,1
"13731","RBBP9",8,2,10,0.2,0.8,1
"13732","RBCK1",22,13,35,0.371428571428571,0.628571428571429,1
"13733","RBFA",12,19,31,0.612903225806452,0.387096774193548,1
"13734","RBFOX1",44,78,122,0.639344262295082,0.360655737704918,1
"13735","RBFOX2",13,19,32,0.59375,0.40625,1
"13736","RBFOX3",0,2,2,1,0,1
"13737","RBIS",5,5,10,0.5,0.5,1
"13738","RBKS",11,11,22,0.5,0.5,1
"13739","RBL1",36,67,103,0.650485436893204,0.349514563106796,1
"13740","RBL2",34,58,92,0.630434782608696,0.369565217391304,1
"13741","RBM10",71,68,139,0.489208633093525,0.510791366906475,1
"13742","RBM11",13,26,39,0.666666666666667,0.333333333333333,1
"13743","RBM12",25,46,71,0.647887323943662,0.352112676056338,1
"13744","RBM12B",49,49,98,0.5,0.5,1
"13745","RBM14",22,41,63,0.650793650793651,0.349206349206349,1
"13746","RBM15",56,50,106,0.471698113207547,0.528301886792453,1
"13747","RBM15B",24,37,61,0.60655737704918,0.39344262295082,1
"13748","RBM17",15,26,41,0.634146341463415,0.365853658536585,1
"13749","RBM18",5,13,18,0.722222222222222,0.277777777777778,1
"13750","RBM19",40,63,103,0.611650485436893,0.388349514563107,1
"13751","RBM20",1,4,5,0.8,0.2,1
"13752","RBM22",20,19,39,0.487179487179487,0.512820512820513,1
"13753","RBM23",10,25,35,0.714285714285714,0.285714285714286,1
"13754","RBM24",14,7,21,0.333333333333333,0.666666666666667,1
"13755","RBM25",28,53,81,0.654320987654321,0.345679012345679,1
"13756","RBM26",26,65,91,0.714285714285714,0.285714285714286,1
"13757","RBM27",63,86,149,0.577181208053691,0.422818791946309,1
"13758","RBM28",22,38,60,0.633333333333333,0.366666666666667,1
"13759","RBM3",5,6,11,0.545454545454545,0.454545454545455,1
"13760","RBM33",35,49,84,0.583333333333333,0.416666666666667,1
"13761","RBM34",17,24,41,0.585365853658537,0.414634146341463,1
"13762","RBM38",7,13,20,0.65,0.35,1
"13763","RBM39",24,31,55,0.563636363636364,0.436363636363636,1
"13764","RBM4",15,19,34,0.558823529411765,0.441176470588235,1
"13765","RBM41",14,10,24,0.416666666666667,0.583333333333333,1
"13766","RBM42",29,23,52,0.442307692307692,0.557692307692308,1
"13767","RBM43",23,33,56,0.589285714285714,0.410714285714286,1
"13768","RBM44",8,15,23,0.652173913043478,0.347826086956522,1
"13769","RBM45",23,33,56,0.589285714285714,0.410714285714286,1
"13770","RBM46",44,57,101,0.564356435643564,0.435643564356436,1
"13771","RBM47",37,74,111,0.666666666666667,0.333333333333333,1
"13772","RBM48",19,35,54,0.648148148148148,0.351851851851852,1
"13773","RBM4B",12,14,26,0.538461538461538,0.461538461538462,1
"13774","RBM5",29,45,74,0.608108108108108,0.391891891891892,1
"13775","RBM6",48,55,103,0.533980582524272,0.466019417475728,1
"13776","RBM7",11,22,33,0.666666666666667,0.333333333333333,1
"13777","RBM8A",6,19,25,0.76,0.24,1
"13778","RBMS1",16,22,38,0.578947368421053,0.421052631578947,1
"13779","RBMS2",14,27,41,0.658536585365854,0.341463414634146,1
"13780","RBMS3",32,35,67,0.522388059701492,0.477611940298507,1
"13781","RBMX",23,16,39,0.41025641025641,0.58974358974359,1
"13782","RBMX2",12,18,30,0.6,0.4,1
"13783","RBMXL1",23,33,56,0.589285714285714,0.410714285714286,1
"13784","RBMXL2",26,48,74,0.648648648648649,0.351351351351351,1
"13785","RBMXL3",1,3,4,0.75,0.25,1
"13786","RBMY1A1",0,5,5,1,0,1
"13787","RBMY1E",0,12,12,1,0,1
"13788","RBMY1F",0,1,1,1,0,1
"13789","RBMY1J",0,1,1,1,0,1
"13790","RBP1",4,14,18,0.777777777777778,0.222222222222222,1
"13791","RBP2",14,14,28,0.5,0.5,1
"13792","RBP3",76,137,213,0.643192488262911,0.356807511737089,1
"13793","RBP4",7,13,20,0.65,0.35,1
"13794","RBP5",4,8,12,0.666666666666667,0.333333333333333,1
"13795","RBP7",3,6,9,0.666666666666667,0.333333333333333,1
"13796","RBPJ",19,42,61,0.688524590163934,0.311475409836066,1
"13797","RBPJL",32,29,61,0.475409836065574,0.524590163934426,1
"13798","RBPMS",6,13,19,0.684210526315789,0.315789473684211,1
"13799","RBPMS2",4,13,17,0.764705882352941,0.235294117647059,1
"13800","RBSN",27,37,64,0.578125,0.421875,1
"13801","RBX1",2,10,12,0.833333333333333,0.166666666666667,1
"13802","RC3H1",43,69,112,0.616071428571429,0.383928571428571,1
"13803","RC3H2",33,57,90,0.633333333333333,0.366666666666667,1
"13804","RCAN1",10,10,20,0.5,0.5,1
"13805","RCAN2",11,19,30,0.633333333333333,0.366666666666667,1
"13806","RCAN3",4,13,17,0.764705882352941,0.235294117647059,1
"13807","RCBTB1",12,21,33,0.636363636363636,0.363636363636364,1
"13808","RCBTB2",22,40,62,0.645161290322581,0.354838709677419,1
"13809","RCC1",18,21,39,0.538461538461538,0.461538461538462,1
"13810","RCC1L",11,20,31,0.645161290322581,0.354838709677419,1
"13811","RCC2",18,35,53,0.660377358490566,0.339622641509434,1
"13812","RCCD1",2,11,13,0.846153846153846,0.153846153846154,1
"13813","RCE1",8,13,21,0.619047619047619,0.380952380952381,1
"13814","RCHY1",4,10,14,0.714285714285714,0.285714285714286,1
"13815","RCL1",10,15,25,0.6,0.4,1
"13816","RCN1",5,12,17,0.705882352941177,0.294117647058824,1
"13817","RCN2",11,19,30,0.633333333333333,0.366666666666667,1
"13818","RCN3",12,20,32,0.625,0.375,1
"13819","RCOR1",14,20,34,0.588235294117647,0.411764705882353,1
"13820","RCOR2",17,22,39,0.564102564102564,0.435897435897436,1
"13821","RCOR3",25,34,59,0.576271186440678,0.423728813559322,1
"13822","RCSD1",19,42,61,0.688524590163934,0.311475409836066,1
"13823","RCVRN",14,16,30,0.533333333333333,0.466666666666667,1
"13824","RD3",11,23,34,0.676470588235294,0.323529411764706,1
"13825","RDH10",10,17,27,0.62962962962963,0.37037037037037,1
"13826","RDH11",7,11,18,0.611111111111111,0.388888888888889,1
"13827","RDH12",10,20,30,0.666666666666667,0.333333333333333,1
"13828","RDH13",5,15,20,0.75,0.25,1
"13829","RDH14",3,1,4,0.25,0.75,1
"13830","RDH16",23,34,57,0.596491228070175,0.403508771929825,1
"13831","RDH5",6,19,25,0.76,0.24,1
"13832","RDH8",16,40,56,0.714285714285714,0.285714285714286,1
"13833","RDM1",9,13,22,0.590909090909091,0.409090909090909,1
"13834","RDX",24,29,53,0.547169811320755,0.452830188679245,1
"13835","REC114",8,21,29,0.724137931034483,0.275862068965517,1
"13836","REC8",16,25,41,0.609756097560976,0.390243902439024,1
"13837","RECK",37,51,88,0.579545454545455,0.420454545454545,1
"13838","RECQL",26,28,54,0.518518518518518,0.481481481481481,1
"13839","RECQL4",29,43,72,0.597222222222222,0.402777777777778,1
"13840","RECQL5",30,55,85,0.647058823529412,0.352941176470588,1
"13841","REEP1",10,19,29,0.655172413793103,0.344827586206897,1
"13842","REEP2",12,15,27,0.555555555555556,0.444444444444444,1
"13843","REEP3",5,15,20,0.75,0.25,1
"13844","REEP4",7,14,21,0.666666666666667,0.333333333333333,1
"13845","REEP5",10,14,24,0.583333333333333,0.416666666666667,1
"13846","REEP6",6,5,11,0.454545454545455,0.545454545454545,1
"13847","REG1A",34,63,97,0.649484536082474,0.350515463917526,1
"13848","REG1B",31,63,94,0.670212765957447,0.329787234042553,1
"13849","REG3A",38,56,94,0.595744680851064,0.404255319148936,1
"13850","REG3G",24,56,80,0.7,0.3,1
"13851","REG4",5,9,14,0.642857142857143,0.357142857142857,1
"13852","REL",28,25,53,0.471698113207547,0.528301886792453,1
"13853","RELA",19,30,49,0.612244897959184,0.387755102040816,1
"13854","RELB",15,26,41,0.634146341463415,0.365853658536585,1
"13855","RELCH",39,60,99,0.606060606060606,0.393939393939394,1
"13856","RELL1",4,8,12,0.666666666666667,0.333333333333333,1
"13857","RELL2",7,25,32,0.78125,0.21875,1
"13858","RELN",226,436,662,0.658610271903323,0.341389728096677,1
"13859","RELT",9,24,33,0.727272727272727,0.272727272727273,1
"13860","REM1",26,31,57,0.543859649122807,0.456140350877193,1
"13861","REM2",12,16,28,0.571428571428571,0.428571428571429,1
"13862","REN",18,36,54,0.666666666666667,0.333333333333333,1
"13863","RENBP",19,18,37,0.486486486486487,0.513513513513513,1
"13864","REP15",9,6,15,0.4,0.6,1
"13865","REPIN1",20,26,46,0.565217391304348,0.434782608695652,1
"13866","REPS1",25,52,77,0.675324675324675,0.324675324675325,1
"13867","REPS2",37,24,61,0.39344262295082,0.60655737704918,1
"13868","RER1",7,7,14,0.5,0.5,1
"13869","RERE",66,96,162,0.592592592592593,0.407407407407407,1
"13870","RERG",10,31,41,0.75609756097561,0.24390243902439,1
"13871","RERGL",15,35,50,0.7,0.3,1
"13872","RESF1",57,116,173,0.670520231213873,0.329479768786127,1
"13873","RESP18",0,2,2,1,0,1
"13874","REST",47,69,116,0.594827586206897,0.405172413793103,1
"13875","RET",61,104,165,0.63030303030303,0.36969696969697,1
"13876","RETN",3,4,7,0.571428571428571,0.428571428571429,1
"13877","RETNLB",11,16,27,0.592592592592593,0.407407407407407,1
"13878","RETREG1",9,27,36,0.75,0.25,1
"13879","RETREG2",10,35,45,0.777777777777778,0.222222222222222,1
"13880","RETREG3",13,22,35,0.628571428571429,0.371428571428571,1
"13881","RETSAT",25,30,55,0.545454545454545,0.454545454545455,1
"13882","REV1",44,56,100,0.56,0.44,1
"13883","REV3L",102,187,289,0.647058823529412,0.352941176470588,1
"13884","REX1BD",2,0,2,0,1,1
"13885","REXO1",20,40,60,0.666666666666667,0.333333333333333,1
"13886","REXO1L1P",4,10,14,0.714285714285714,0.285714285714286,1
"13887","REXO2",6,4,10,0.4,0.6,1
"13888","REXO4",14,15,29,0.517241379310345,0.482758620689655,1
"13889","REXO5",23,30,53,0.566037735849057,0.433962264150943,1
"13890","RFC1",42,69,111,0.621621621621622,0.378378378378378,1
"13891","RFC2",9,19,28,0.678571428571429,0.321428571428571,1
"13892","RFC3",11,16,27,0.592592592592593,0.407407407407407,1
"13893","RFC4",31,23,54,0.425925925925926,0.574074074074074,1
"13894","RFC5",11,22,33,0.666666666666667,0.333333333333333,1
"13895","RFESD",5,14,19,0.736842105263158,0.263157894736842,1
"13896","RFFL",13,17,30,0.566666666666667,0.433333333333333,1
"13897","RFK",3,6,9,0.666666666666667,0.333333333333333,1
"13898","RFLNA",7,10,17,0.588235294117647,0.411764705882353,1
"13899","RFLNB",8,8,16,0.5,0.5,1
"13900","RFNG",2,8,10,0.8,0.2,1
"13901","RFPL1",19,25,44,0.568181818181818,0.431818181818182,1
"13902","RFPL2",12,42,54,0.777777777777778,0.222222222222222,1
"13903","RFPL3",15,41,56,0.732142857142857,0.267857142857143,1
"13904","RFPL4A",0,2,2,1,0,1
"13905","RFPL4B",19,29,48,0.604166666666667,0.395833333333333,1
"13906","RFT1",11,13,24,0.541666666666667,0.458333333333333,1
"13907","RFTN1",24,46,70,0.657142857142857,0.342857142857143,1
"13908","RFTN2",15,45,60,0.75,0.25,1
"13909","RFWD3",20,33,53,0.622641509433962,0.377358490566038,1
"13910","RFX1",28,28,56,0.5,0.5,1
"13911","RFX2",17,37,54,0.685185185185185,0.314814814814815,1
"13912","RFX3",26,44,70,0.628571428571429,0.371428571428571,1
"13913","RFX4",33,61,94,0.648936170212766,0.351063829787234,1
"13914","RFX5",38,41,79,0.518987341772152,0.481012658227848,1
"13915","RFX6",73,142,215,0.66046511627907,0.33953488372093,1
"13916","RFX7",43,58,101,0.574257425742574,0.425742574257426,1
"13917","RFX8",1,2,3,0.666666666666667,0.333333333333333,1
"13918","RFXANK",4,8,12,0.666666666666667,0.333333333333333,1
"13919","RFXAP",5,9,14,0.642857142857143,0.357142857142857,1
"13920","RGCC",2,1,3,0.333333333333333,0.666666666666667,1
"13921","RGL1",32,78,110,0.709090909090909,0.290909090909091,1
"13922","RGL2",21,50,71,0.704225352112676,0.295774647887324,1
"13923","RGL3",21,44,65,0.676923076923077,0.323076923076923,1
"13924","RGL4",11,32,43,0.744186046511628,0.255813953488372,1
"13925","RGMA",12,21,33,0.636363636363636,0.363636363636364,1
"13926","RGMB",14,15,29,0.517241379310345,0.482758620689655,1
"13927","RGN",10,5,15,0.333333333333333,0.666666666666667,1
"13928","RGP1",8,19,27,0.703703703703704,0.296296296296296,1
"13929","RGPD1",12,17,29,0.586206896551724,0.413793103448276,1
"13930","RGPD2",9,16,25,0.64,0.36,1
"13931","RGPD3",0,17,17,1,0,1
"13932","RGPD4",4,5,9,0.555555555555556,0.444444444444444,1
"13933","RGPD8",0,1,1,1,0,1
"13934","RGR",17,21,38,0.552631578947368,0.447368421052632,1
"13935","RGS1",18,32,50,0.64,0.36,1
"13936","RGS10",13,11,24,0.458333333333333,0.541666666666667,1
"13937","RGS11",8,22,30,0.733333333333333,0.266666666666667,1
"13938","RGS12",89,114,203,0.561576354679803,0.438423645320197,1
"13939","RGS13",8,14,22,0.636363636363636,0.363636363636364,1
"13940","RGS14",16,20,36,0.555555555555556,0.444444444444444,1
"13941","RGS16",10,14,24,0.583333333333333,0.416666666666667,1
"13942","RGS17",10,20,30,0.666666666666667,0.333333333333333,1
"13943","RGS18",20,53,73,0.726027397260274,0.273972602739726,1
"13944","RGS19",9,8,17,0.470588235294118,0.529411764705882,1
"13945","RGS2",14,16,30,0.533333333333333,0.466666666666667,1
"13946","RGS20",22,27,49,0.551020408163265,0.448979591836735,1
"13947","RGS21",27,24,51,0.470588235294118,0.529411764705882,1
"13948","RGS22",82,160,242,0.661157024793388,0.338842975206612,1
"13949","RGS3",47,70,117,0.598290598290598,0.401709401709402,1
"13950","RGS4",13,26,39,0.666666666666667,0.333333333333333,1
"13951","RGS5",17,18,35,0.514285714285714,0.485714285714286,1
"13952","RGS6",37,63,100,0.63,0.37,1
"13953","RGS7",62,124,186,0.666666666666667,0.333333333333333,1
"13954","RGS7BP",13,33,46,0.717391304347826,0.282608695652174,1
"13955","RGS8",18,20,38,0.526315789473684,0.473684210526316,1
"13956","RGS9",40,49,89,0.550561797752809,0.449438202247191,1
"13957","RGS9BP",3,7,10,0.7,0.3,1
"13958","RGSL1",2,5,7,0.714285714285714,0.285714285714286,1
"13959","RHAG",30,65,95,0.684210526315789,0.315789473684211,1
"13960","RHBDD1",10,24,34,0.705882352941177,0.294117647058824,1
"13961","RHBDD2",10,18,28,0.642857142857143,0.357142857142857,1
"13962","RHBDD3",4,9,13,0.692307692307692,0.307692307692308,1
"13963","RHBDF1",26,33,59,0.559322033898305,0.440677966101695,1
"13964","RHBDF2",22,38,60,0.633333333333333,0.366666666666667,1
"13965","RHBDL1",10,16,26,0.615384615384615,0.384615384615385,1
"13966","RHBDL2",8,20,28,0.714285714285714,0.285714285714286,1
"13967","RHBDL3",15,25,40,0.625,0.375,1
"13968","RHBG",18,30,48,0.625,0.375,1
"13969","RHCE",21,27,48,0.5625,0.4375,1
"13970","RHCG",18,31,49,0.63265306122449,0.36734693877551,1
"13971","RHD",14,17,31,0.548387096774194,0.451612903225806,1
"13972","RHEB",11,13,24,0.541666666666667,0.458333333333333,1
"13973","RHEBL1",5,6,11,0.545454545454545,0.454545454545455,1
"13974","RHEX",14,17,31,0.548387096774194,0.451612903225806,1
"13975","RHNO1",10,13,23,0.565217391304348,0.434782608695652,1
"13976","RHO",16,24,40,0.6,0.4,1
"13977","RHOA",29,55,84,0.654761904761905,0.345238095238095,1
"13978","RHOB",12,31,43,0.720930232558139,0.27906976744186,1
"13979","RHOBTB1",34,47,81,0.580246913580247,0.419753086419753,1
"13980","RHOBTB2",35,27,62,0.435483870967742,0.564516129032258,1
"13981","RHOBTB3",17,30,47,0.638297872340426,0.361702127659574,1
"13982","RHOC",8,5,13,0.384615384615385,0.615384615384615,1
"13983","RHOD",9,8,17,0.470588235294118,0.529411764705882,1
"13984","RHOF",7,7,14,0.5,0.5,1
"13985","RHOG",3,5,8,0.625,0.375,1
"13986","RHOH",11,26,37,0.702702702702703,0.297297297297297,1
"13987","RHOJ",6,22,28,0.785714285714286,0.214285714285714,1
"13988","RHOQ",10,11,21,0.523809523809524,0.476190476190476,1
"13989","RHOT1",16,32,48,0.666666666666667,0.333333333333333,1
"13990","RHOT2",16,18,34,0.529411764705882,0.470588235294118,1
"13991","RHOU",14,15,29,0.517241379310345,0.482758620689655,1
"13992","RHOV",7,14,21,0.666666666666667,0.333333333333333,1
"13993","RHOXF1",18,12,30,0.4,0.6,1
"13994","RHOXF2",10,8,18,0.444444444444444,0.555555555555556,1
"13995","RHOXF2B",10,6,16,0.375,0.625,1
"13996","RHPN1",14,28,42,0.666666666666667,0.333333333333333,1
"13997","RHPN2",17,33,50,0.66,0.34,1
"13998","RIBC1",14,6,20,0.3,0.7,1
"13999","RIBC2",10,15,25,0.6,0.4,1
"14000","RIC1",40,51,91,0.56043956043956,0.43956043956044,1
"14001","RIC3",13,43,56,0.767857142857143,0.232142857142857,1
"14002","RIC8A",9,27,36,0.75,0.25,1
"14003","RIC8B",12,26,38,0.684210526315789,0.315789473684211,1
"14004","RICTOR",68,103,171,0.60233918128655,0.39766081871345,1
"14005","RIDA",6,16,22,0.727272727272727,0.272727272727273,1
"14006","RIF1",96,142,238,0.596638655462185,0.403361344537815,1
"14007","RIIAD1",0,1,1,1,0,1
"14008","RILP",8,11,19,0.578947368421053,0.421052631578947,1
"14009","RILPL1",13,10,23,0.434782608695652,0.565217391304348,1
"14010","RILPL2",5,7,12,0.583333333333333,0.416666666666667,1
"14011","RIMBP2",99,133,232,0.573275862068966,0.426724137931034,1
"14012","RIMBP3",19,31,50,0.62,0.38,1
"14013","RIMBP3B",0,1,1,1,0,1
"14014","RIMKLA",10,32,42,0.761904761904762,0.238095238095238,1
"14015","RIMKLB",26,28,54,0.518518518518518,0.481481481481481,1
"14016","RIMS1",106,225,331,0.6797583081571,0.3202416918429,1
"14017","RIMS2",157,322,479,0.67223382045929,0.32776617954071,1
"14018","RIMS3",14,18,32,0.5625,0.4375,1
"14019","RIMS4",22,27,49,0.551020408163265,0.448979591836735,1
"14020","RIN1",20,32,52,0.615384615384615,0.384615384615385,1
"14021","RIN2",22,43,65,0.661538461538462,0.338461538461538,1
"14022","RIN3",40,60,100,0.6,0.4,1
"14023","RING1",19,30,49,0.612244897959184,0.387755102040816,1
"14024","RINL",9,20,29,0.689655172413793,0.310344827586207,1
"14025","RINT1",27,48,75,0.64,0.36,1
"14026","RIOK1",26,21,47,0.446808510638298,0.553191489361702,1
"14027","RIOK2",21,35,56,0.625,0.375,1
"14028","RIOK3",16,28,44,0.636363636363636,0.363636363636364,1
"14029","RIOX1",11,23,34,0.676470588235294,0.323529411764706,1
"14030","RIOX2",19,21,40,0.525,0.475,1
"14031","RIPK1",17,34,51,0.666666666666667,0.333333333333333,1
"14032","RIPK2",18,31,49,0.63265306122449,0.36734693877551,1
"14033","RIPK3",9,35,44,0.795454545454545,0.204545454545455,1
"14034","RIPK4",47,65,112,0.580357142857143,0.419642857142857,1
"14035","RIPOR1",33,44,77,0.571428571428571,0.428571428571429,1
"14036","RIPOR2",28,50,78,0.641025641025641,0.358974358974359,1
"14037","RIPOR3",38,52,90,0.577777777777778,0.422222222222222,1
"14038","RIPPLY1",3,3,6,0.5,0.5,1
"14039","RIPPLY2",14,14,28,0.5,0.5,1
"14040","RIPPLY3",10,26,36,0.722222222222222,0.277777777777778,1
"14041","RIT1",14,19,33,0.575757575757576,0.424242424242424,1
"14042","RIT2",23,50,73,0.684931506849315,0.315068493150685,1
"14043","RITA1",10,9,19,0.473684210526316,0.526315789473684,1
"14044","RLBP1",13,17,30,0.566666666666667,0.433333333333333,1
"14045","RLF",45,100,145,0.689655172413793,0.310344827586207,1
"14046","RLIM",42,20,62,0.32258064516129,0.67741935483871,1
"14047","RLN1",4,16,20,0.8,0.2,1
"14048","RLN2",9,9,18,0.5,0.5,1
"14049","RLN3",3,12,15,0.8,0.2,1
"14050","RMC1",20,32,52,0.615384615384615,0.384615384615385,1
"14051","RMDN1",14,19,33,0.575757575757576,0.424242424242424,1
"14052","RMDN2",8,15,23,0.652173913043478,0.347826086956522,1
"14053","RMDN3",15,17,32,0.53125,0.46875,1
"14054","RMI1",19,28,47,0.595744680851064,0.404255319148936,1
"14055","RMI2",1,6,7,0.857142857142857,0.142857142857143,1
"14056","RMND1",11,19,30,0.633333333333333,0.366666666666667,1
"14057","RMND5A",16,17,33,0.515151515151515,0.484848484848485,1
"14058","RMND5B",7,10,17,0.588235294117647,0.411764705882353,1
"14059","RNA5-8SP2",2,3,5,0.6,0.4,1
"14060","RNASE1",2,5,7,0.714285714285714,0.285714285714286,1
"14061","RNASE10",20,24,44,0.545454545454545,0.454545454545455,1
"14062","RNASE11",25,15,40,0.375,0.625,1
"14063","RNASE12",6,12,18,0.666666666666667,0.333333333333333,1
"14064","RNASE13",10,10,20,0.5,0.5,1
"14065","RNASE2",7,15,22,0.681818181818182,0.318181818181818,1
"14066","RNASE3",7,24,31,0.774193548387097,0.225806451612903,1
"14067","RNASE4",7,12,19,0.631578947368421,0.368421052631579,1
"14068","RNASE6",6,8,14,0.571428571428571,0.428571428571429,1
"14069","RNASE7",7,7,14,0.5,0.5,1
"14070","RNASE8",4,5,9,0.555555555555556,0.444444444444444,1
"14071","RNASE9",6,25,31,0.806451612903226,0.193548387096774,1
"14072","RNASEH1",10,13,23,0.565217391304348,0.434782608695652,1
"14073","RNASEH2A",14,13,27,0.481481481481481,0.518518518518518,1
"14074","RNASEH2B",10,9,19,0.473684210526316,0.526315789473684,1
"14075","RNASEH2C",3,2,5,0.4,0.6,1
"14076","RNASEK",0,2,2,1,0,1
"14077","RNASEK-C17orf49",0,1,1,1,0,1
"14078","RNASEL",26,50,76,0.657894736842105,0.342105263157895,1
"14079","RNASET2",6,13,19,0.684210526315789,0.315789473684211,1
"14080","RND1",17,20,37,0.540540540540541,0.459459459459459,1
"14081","RND2",4,9,13,0.692307692307692,0.307692307692308,1
"14082","RND3",13,15,28,0.535714285714286,0.464285714285714,1
"14083","RNF10",19,48,67,0.716417910447761,0.283582089552239,1
"14084","RNF103",24,41,65,0.630769230769231,0.369230769230769,1
"14085","RNF11",5,6,11,0.545454545454545,0.454545454545455,1
"14086","RNF111",40,71,111,0.63963963963964,0.36036036036036,1
"14087","RNF112",14,48,62,0.774193548387097,0.225806451612903,1
"14088","RNF113A",21,9,30,0.3,0.7,1
"14089","RNF113B",18,31,49,0.63265306122449,0.36734693877551,1
"14090","RNF114",3,9,12,0.75,0.25,1
"14091","RNF115",6,14,20,0.7,0.3,1
"14092","RNF121",6,13,19,0.684210526315789,0.315789473684211,1
"14093","RNF122",6,15,21,0.714285714285714,0.285714285714286,1
"14094","RNF123",44,71,115,0.617391304347826,0.382608695652174,1
"14095","RNF125",7,16,23,0.695652173913043,0.304347826086957,1
"14096","RNF126",9,10,19,0.526315789473684,0.473684210526316,1
"14097","RNF128",54,28,82,0.341463414634146,0.658536585365854,1
"14098","RNF13",14,13,27,0.481481481481481,0.518518518518518,1
"14099","RNF130",9,26,35,0.742857142857143,0.257142857142857,1
"14100","RNF133",16,37,53,0.69811320754717,0.30188679245283,1
"14101","RNF135",9,11,20,0.55,0.45,1
"14102","RNF138",13,13,26,0.5,0.5,1
"14103","RNF139",19,35,54,0.648148148148148,0.351851851851852,1
"14104","RNF14",10,18,28,0.642857142857143,0.357142857142857,1
"14105","RNF141",5,19,24,0.791666666666667,0.208333333333333,1
"14106","RNF144A",22,34,56,0.607142857142857,0.392857142857143,1
"14107","RNF144B",9,5,14,0.357142857142857,0.642857142857143,1
"14108","RNF145",31,42,73,0.575342465753425,0.424657534246575,1
"14109","RNF146",13,16,29,0.551724137931034,0.448275862068966,1
"14110","RNF148",29,35,64,0.546875,0.453125,1
"14111","RNF149",10,15,25,0.6,0.4,1
"14112","RNF150",26,33,59,0.559322033898305,0.440677966101695,1
"14113","RNF151",4,10,14,0.714285714285714,0.285714285714286,1
"14114","RNF152",21,27,48,0.5625,0.4375,1
"14115","RNF157",14,38,52,0.730769230769231,0.269230769230769,1
"14116","RNF165",23,38,61,0.622950819672131,0.377049180327869,1
"14117","RNF166",1,10,11,0.909090909090909,0.0909090909090909,1
"14118","RNF167",9,12,21,0.571428571428571,0.428571428571429,1
"14119","RNF168",23,30,53,0.566037735849057,0.433962264150943,1
"14120","RNF169",17,24,41,0.585365853658537,0.414634146341463,1
"14121","RNF17",78,152,230,0.660869565217391,0.339130434782609,1
"14122","RNF170",4,5,9,0.555555555555556,0.444444444444444,1
"14123","RNF175",8,20,28,0.714285714285714,0.285714285714286,1
"14124","RNF180",23,35,58,0.603448275862069,0.396551724137931,1
"14125","RNF181",5,9,14,0.642857142857143,0.357142857142857,1
"14126","RNF182",5,23,28,0.821428571428571,0.178571428571429,1
"14127","RNF183",3,9,12,0.75,0.25,1
"14128","RNF185",7,13,20,0.65,0.35,1
"14129","RNF186",2,11,13,0.846153846153846,0.153846153846154,1
"14130","RNF19A",21,51,72,0.708333333333333,0.291666666666667,1
"14131","RNF19B",17,24,41,0.585365853658537,0.414634146341463,1
"14132","RNF2",13,19,32,0.59375,0.40625,1
"14133","RNF20",38,48,86,0.558139534883721,0.441860465116279,1
"14134","RNF207",12,16,28,0.571428571428571,0.428571428571429,1
"14135","RNF208",7,11,18,0.611111111111111,0.388888888888889,1
"14136","RNF212",12,10,22,0.454545454545455,0.545454545454545,1
"14137","RNF212B",0,2,2,1,0,1
"14138","RNF213",151,211,362,0.582872928176796,0.417127071823204,1
"14139","RNF214",29,40,69,0.579710144927536,0.420289855072464,1
"14140","RNF215",6,9,15,0.6,0.4,1
"14141","RNF216",32,56,88,0.636363636363636,0.363636363636364,1
"14142","RNF217",15,39,54,0.722222222222222,0.277777777777778,1
"14143","RNF217-AS1",23,46,69,0.666666666666667,0.333333333333333,1
"14144","RNF220",28,48,76,0.631578947368421,0.368421052631579,1
"14145","RNF222",0,1,1,1,0,1
"14146","RNF24",9,5,14,0.357142857142857,0.642857142857143,1
"14147","RNF25",21,23,44,0.522727272727273,0.477272727272727,1
"14148","RNF26",11,18,29,0.620689655172414,0.379310344827586,1
"14149","RNF31",29,65,94,0.691489361702128,0.308510638297872,1
"14150","RNF32",20,29,49,0.591836734693878,0.408163265306122,1
"14151","RNF34",16,7,23,0.304347826086957,0.695652173913043,1
"14152","RNF38",20,15,35,0.428571428571429,0.571428571428571,1
"14153","RNF39",16,19,35,0.542857142857143,0.457142857142857,1
"14154","RNF4",3,5,8,0.625,0.375,1
"14155","RNF40",27,60,87,0.689655172413793,0.310344827586207,1
"14156","RNF41",12,11,23,0.478260869565217,0.521739130434783,1
"14157","RNF43",103,104,207,0.502415458937198,0.497584541062802,1
"14158","RNF44",8,19,27,0.703703703703704,0.296296296296296,1
"14159","RNF5",7,7,14,0.5,0.5,1
"14160","RNF6",36,54,90,0.6,0.4,1
"14161","RNF7",2,6,8,0.75,0.25,1
"14162","RNF8",16,26,42,0.619047619047619,0.380952380952381,1
"14163","RNFT1",12,10,22,0.454545454545455,0.545454545454545,1
"14164","RNFT2",11,11,22,0.5,0.5,1
"14165","RNGTT",23,26,49,0.530612244897959,0.469387755102041,1
"14166","RNH1",8,13,21,0.619047619047619,0.380952380952381,1
"14167","RNLS",10,22,32,0.6875,0.3125,1
"14168","RNMT",25,39,64,0.609375,0.390625,1
"14169","RNPC3",2,3,5,0.6,0.4,1
"14170","RNPEP",15,23,38,0.605263157894737,0.394736842105263,1
"14171","RNPEPL1",14,14,28,0.5,0.5,1
"14172","RNPS1",8,10,18,0.555555555555556,0.444444444444444,1
"14173","RO60",16,27,43,0.627906976744186,0.372093023255814,1
"14174","ROBO1",93,153,246,0.621951219512195,0.378048780487805,1
"14175","ROBO2",156,216,372,0.580645161290323,0.419354838709677,1
"14176","ROBO3",40,89,129,0.689922480620155,0.310077519379845,1
"14177","ROBO4",46,97,143,0.678321678321678,0.321678321678322,1
"14178","ROCK1",77,113,190,0.594736842105263,0.405263157894737,1
"14179","ROCK2",37,89,126,0.706349206349206,0.293650793650794,1
"14180","ROGDI",2,8,10,0.8,0.2,1
"14181","ROM1",7,16,23,0.695652173913043,0.304347826086957,1
"14182","ROMO1",3,4,7,0.571428571428571,0.428571428571429,1
"14183","ROPN1",3,15,18,0.833333333333333,0.166666666666667,1
"14184","ROPN1B",11,12,23,0.521739130434783,0.478260869565217,1
"14185","ROPN1L",8,27,35,0.771428571428571,0.228571428571429,1
"14186","ROR1",41,76,117,0.64957264957265,0.35042735042735,1
"14187","ROR2",57,100,157,0.636942675159236,0.363057324840764,1
"14188","RORA",19,27,46,0.58695652173913,0.41304347826087,1
"14189","RORB",31,61,92,0.66304347826087,0.33695652173913,1
"14190","RORC",17,43,60,0.716666666666667,0.283333333333333,1
"14191","ROS1",128,263,391,0.672634271099744,0.327365728900256,1
"14192","RP1",212,445,657,0.677321156773212,0.322678843226788,1
"14193","RP1L1",163,265,428,0.619158878504673,0.380841121495327,1
"14194","RP2",21,7,28,0.25,0.75,1
"14195","RP9",9,9,18,0.5,0.5,1
"14196","RPA1",18,16,34,0.470588235294118,0.529411764705882,1
"14197","RPA2",7,8,15,0.533333333333333,0.466666666666667,1
"14198","RPA3",4,5,9,0.555555555555556,0.444444444444444,1
"14199","RPA4",24,16,40,0.4,0.6,1
"14200","RPAIN",5,12,17,0.705882352941177,0.294117647058824,1
"14201","RPAP1",45,63,108,0.583333333333333,0.416666666666667,1
"14202","RPAP2",26,24,50,0.48,0.52,1
"14203","RPAP3",13,33,46,0.717391304347826,0.282608695652174,1
"14204","RPE",8,14,22,0.636363636363636,0.363636363636364,1
"14205","RPE65",33,60,93,0.645161290322581,0.354838709677419,1
"14206","RPEL1",0,1,1,1,0,1
"14207","RPF1",10,19,29,0.655172413793103,0.344827586206897,1
"14208","RPF2",8,18,26,0.692307692307692,0.307692307692308,1
"14209","RPGR",38,26,64,0.40625,0.59375,1
"14210","RPGRIP1",45,99,144,0.6875,0.3125,1
"14211","RPGRIP1L",45,96,141,0.680851063829787,0.319148936170213,1
"14212","RPH3A",41,81,122,0.663934426229508,0.336065573770492,1
"14213","RPH3AL",15,17,32,0.53125,0.46875,1
"14214","RPIA",15,16,31,0.516129032258065,0.483870967741935,1
"14215","RPL10",17,11,28,0.392857142857143,0.607142857142857,1
"14216","RPL10A",9,18,27,0.666666666666667,0.333333333333333,1
"14217","RPL10L",31,44,75,0.586666666666667,0.413333333333333,1
"14218","RPL11",10,12,22,0.545454545454545,0.454545454545455,1
"14219","RPL12",1,10,11,0.909090909090909,0.0909090909090909,1
"14220","RPL13",4,8,12,0.666666666666667,0.333333333333333,1
"14221","RPL13A",7,11,18,0.611111111111111,0.388888888888889,1
"14222","RPL13AP25",1,1,2,0.5,0.5,1
"14223","RPL14",7,8,15,0.533333333333333,0.466666666666667,1
"14224","RPL15",3,10,13,0.769230769230769,0.230769230769231,1
"14225","RPL17-C18orf32",2,14,16,0.875,0.125,1
"14226","RPL18",2,5,7,0.714285714285714,0.285714285714286,1
"14227","RPL18A",8,11,19,0.578947368421053,0.421052631578947,1
"14228","RPL19",5,8,13,0.615384615384615,0.384615384615385,1
"14229","RPL21",2,8,10,0.8,0.2,1
"14230","RPL22",58,64,122,0.524590163934426,0.475409836065574,1
"14231","RPL22L1",12,2,14,0.142857142857143,0.857142857142857,1
"14232","RPL23",0,11,11,1,0,1
"14233","RPL23A",4,6,10,0.6,0.4,1
"14234","RPL23AP42",12,21,33,0.636363636363636,0.363636363636364,1
"14235","RPL23AP82",2,8,10,0.8,0.2,1
"14236","RPL24",5,7,12,0.583333333333333,0.416666666666667,1
"14237","RPL26",2,10,12,0.833333333333333,0.166666666666667,1
"14238","RPL26L1",5,10,15,0.666666666666667,0.333333333333333,1
"14239","RPL26P30",15,20,35,0.571428571428571,0.428571428571429,1
"14240","RPL27",5,11,16,0.6875,0.3125,1
"14241","RPL27A",2,3,5,0.6,0.4,1
"14242","RPL28",10,10,20,0.5,0.5,1
"14243","RPL29",1,6,7,0.857142857142857,0.142857142857143,1
"14244","RPL3",8,18,26,0.692307692307692,0.307692307692308,1
"14245","RPL30",5,5,10,0.5,0.5,1
"14246","RPL31",4,7,11,0.636363636363636,0.363636363636364,1
"14247","RPL31P57",5,14,19,0.736842105263158,0.263157894736842,1
"14248","RPL32",7,7,14,0.5,0.5,1
"14249","RPL34",7,3,10,0.3,0.7,1
"14250","RPL35",5,5,10,0.5,0.5,1
"14251","RPL35A",3,4,7,0.571428571428571,0.428571428571429,1
"14252","RPL35AP3",0,3,3,1,0,1
"14253","RPL36",3,4,7,0.571428571428571,0.428571428571429,1
"14254","RPL36A",7,4,11,0.363636363636364,0.636363636363636,1
"14255","RPL36AL",3,1,4,0.25,0.75,1
"14256","RPL37",3,7,10,0.7,0.3,1
"14257","RPL37A",1,3,4,0.75,0.25,1
"14258","RPL38",1,3,4,0.75,0.25,1
"14259","RPL39",7,0,7,0,1,1
"14260","RPL39L",1,5,6,0.833333333333333,0.166666666666667,1
"14261","RPL3L",21,25,46,0.543478260869565,0.456521739130435,1
"14262","RPL4",9,25,34,0.735294117647059,0.264705882352941,1
"14263","RPL41",1,2,3,0.666666666666667,0.333333333333333,1
"14264","RPL5",17,37,54,0.685185185185185,0.314814814814815,1
"14265","RPL6",11,16,27,0.592592592592593,0.407407407407407,1
"14266","RPL7",10,9,19,0.473684210526316,0.526315789473684,1
"14267","RPL7A",11,8,19,0.421052631578947,0.578947368421053,1
"14268","RPL7L1",8,8,16,0.5,0.5,1
"14269","RPL8",5,17,22,0.772727272727273,0.227272727272727,1
"14270","RPL9",9,5,14,0.357142857142857,0.642857142857143,1
"14271","RPLP0",14,12,26,0.461538461538462,0.538461538461538,1
"14272","RPLP1",1,1,2,0.5,0.5,1
"14273","RPLP2",5,4,9,0.444444444444444,0.555555555555556,1
"14274","RPN1",17,19,36,0.527777777777778,0.472222222222222,1
"14275","RPN2",12,25,37,0.675675675675676,0.324324324324324,1
"14276","RPP14",5,6,11,0.545454545454545,0.454545454545455,1
"14277","RPP21",3,0,3,0,1,1
"14278","RPP25",0,6,6,1,0,1
"14279","RPP25L",10,5,15,0.333333333333333,0.666666666666667,1
"14280","RPP30",8,11,19,0.578947368421053,0.421052631578947,1
"14281","RPP38",3,15,18,0.833333333333333,0.166666666666667,1
"14282","RPP40",16,18,34,0.529411764705882,0.470588235294118,1
"14283","RPRD1A",13,20,33,0.606060606060606,0.393939393939394,1
"14284","RPRD1B",12,12,24,0.5,0.5,1
"14285","RPRD2",60,87,147,0.591836734693878,0.408163265306122,1
"14286","RPRM",9,12,21,0.571428571428571,0.428571428571429,1
"14287","RPRML",2,3,5,0.6,0.4,1
"14288","RPS10-NUDT3",4,9,13,0.692307692307692,0.307692307692308,1
"14289","RPS11",10,3,13,0.230769230769231,0.769230769230769,1
"14290","RPS12",5,6,11,0.545454545454545,0.454545454545455,1
"14291","RPS13",5,12,17,0.705882352941177,0.294117647058824,1
"14292","RPS14",1,4,5,0.8,0.2,1
"14293","RPS15",3,5,8,0.625,0.375,1
"14294","RPS15A",1,3,4,0.75,0.25,1
"14295","RPS16",6,3,9,0.333333333333333,0.666666666666667,1
"14296","RPS17P5",0,1,1,1,0,1
"14297","RPS18",5,10,15,0.666666666666667,0.333333333333333,1
"14298","RPS19",0,9,9,1,0,1
"14299","RPS19BP1",2,1,3,0.333333333333333,0.666666666666667,1
"14300","RPS2",8,14,22,0.636363636363636,0.363636363636364,1
"14301","RPS20",2,10,12,0.833333333333333,0.166666666666667,1
"14302","RPS21",2,5,7,0.714285714285714,0.285714285714286,1
"14303","RPS23",3,5,8,0.625,0.375,1
"14304","RPS24",2,7,9,0.777777777777778,0.222222222222222,1
"14305","RPS25",1,2,3,0.666666666666667,0.333333333333333,1
"14306","RPS26",5,1,6,0.166666666666667,0.833333333333333,1
"14307","RPS26P15",7,22,29,0.758620689655172,0.241379310344828,1
"14308","RPS27",1,7,8,0.875,0.125,1
"14309","RPS27A",3,5,8,0.625,0.375,1
"14310","RPS27L",0,2,2,1,0,1
"14311","RPS28",3,2,5,0.4,0.6,1
"14312","RPS29",0,4,4,1,0,1
"14313","RPS3",9,11,20,0.55,0.45,1
"14314","RPS3A",3,8,11,0.727272727272727,0.272727272727273,1
"14315","RPS4X",10,6,16,0.375,0.625,1
"14316","RPS4Y1",0,8,8,1,0,1
"14317","RPS4Y2",0,14,14,1,0,1
"14318","RPS5",13,7,20,0.35,0.65,1
"14319","RPS6",5,15,20,0.75,0.25,1
"14320","RPS6KA1",20,52,72,0.722222222222222,0.277777777777778,1
"14321","RPS6KA2",40,55,95,0.578947368421053,0.421052631578947,1
"14322","RPS6KA3",45,33,78,0.423076923076923,0.576923076923077,1
"14323","RPS6KA4",19,28,47,0.595744680851064,0.404255319148936,1
"14324","RPS6KA5",25,45,70,0.642857142857143,0.357142857142857,1
"14325","RPS6KA6",68,70,138,0.507246376811594,0.492753623188406,1
"14326","RPS6KB1",17,23,40,0.575,0.425,1
"14327","RPS6KB2",11,18,29,0.620689655172414,0.379310344827586,1
"14328","RPS6KC1",41,73,114,0.640350877192982,0.359649122807018,1
"14329","RPS6KL1",16,23,39,0.58974358974359,0.41025641025641,1
"14330","RPS7",7,11,18,0.611111111111111,0.388888888888889,1
"14331","RPS8",3,5,8,0.625,0.375,1
"14332","RPS9",9,6,15,0.4,0.6,1
"14333","RPSA",11,11,22,0.5,0.5,1
"14334","RPTN",55,113,168,0.672619047619048,0.327380952380952,1
"14335","RPTOR",49,83,132,0.628787878787879,0.371212121212121,1
"14336","RPUSD1",5,17,22,0.772727272727273,0.227272727272727,1
"14337","RPUSD2",4,23,27,0.851851851851852,0.148148148148148,1
"14338","RPUSD3",4,8,12,0.666666666666667,0.333333333333333,1
"14339","RPUSD4",14,20,34,0.588235294117647,0.411764705882353,1
"14340","RRAD",8,14,22,0.636363636363636,0.363636363636364,1
"14341","RRAGA",7,11,18,0.611111111111111,0.388888888888889,0.9
"14342","RRAGB",22,15,37,0.405405405405405,0.594594594594595,1
"14343","RRAGC",7,15,22,0.681818181818182,0.318181818181818,1
"14344","RRAGD",12,16,28,0.571428571428571,0.428571428571429,1
"14345","RRAS",7,8,15,0.533333333333333,0.466666666666667,1
"14346","RRAS2",10,14,24,0.583333333333333,0.416666666666667,1
"14347","RRBP1",36,51,87,0.586206896551724,0.413793103448276,1
"14348","RREB1",53,88,141,0.624113475177305,0.375886524822695,1
"14349","RRH",15,17,32,0.53125,0.46875,1
"14350","RRM1",22,25,47,0.531914893617021,0.468085106382979,1
"14351","RRM2",22,30,52,0.576923076923077,0.423076923076923,1
"14352","RRM2B",11,17,28,0.607142857142857,0.392857142857143,1
"14353","RRN3",11,24,35,0.685714285714286,0.314285714285714,1
"14354","RRNAD1",21,20,41,0.48780487804878,0.51219512195122,1
"14355","RRP1",7,10,17,0.588235294117647,0.411764705882353,1
"14356","RRP12",37,50,87,0.574712643678161,0.425287356321839,1
"14357","RRP15",11,23,34,0.676470588235294,0.323529411764706,1
"14358","RRP1B",23,36,59,0.610169491525424,0.389830508474576,1
"14359","RRP36",4,17,21,0.80952380952381,0.19047619047619,1
"14360","RRP7A",3,10,13,0.769230769230769,0.230769230769231,1
"14361","RRP8",18,26,44,0.590909090909091,0.409090909090909,1
"14362","RRP9",13,17,30,0.566666666666667,0.433333333333333,1
"14363","RRS1",7,13,20,0.65,0.35,1
"14364","RS1",16,12,28,0.428571428571429,0.571428571428571,1
"14365","RSAD1",13,31,44,0.704545454545455,0.295454545454545,1
"14366","RSAD2",14,34,48,0.708333333333333,0.291666666666667,1
"14367","RSBN1",30,45,75,0.6,0.4,1
"14368","RSBN1L",15,37,52,0.711538461538462,0.288461538461538,1
"14369","RSC1A1",19,26,45,0.577777777777778,0.422222222222222,1
"14370","RSF1",51,86,137,0.627737226277372,0.372262773722628,1
"14371","RSKR",10,12,22,0.545454545454545,0.454545454545455,1
"14372","RSL1D1",19,25,44,0.568181818181818,0.431818181818182,1
"14373","RSL24D1",2,4,6,0.666666666666667,0.333333333333333,1
"14374","RSPH1",21,23,44,0.522727272727273,0.477272727272727,1
"14375","RSPH10B",22,40,62,0.645161290322581,0.354838709677419,1
"14376","RSPH10B2",17,32,49,0.653061224489796,0.346938775510204,1
"14377","RSPH14",10,30,40,0.75,0.25,1
"14378","RSPH3",19,17,36,0.472222222222222,0.527777777777778,1
"14379","RSPH4A",28,42,70,0.6,0.4,1
"14380","RSPH6A",19,74,93,0.795698924731183,0.204301075268817,1
"14381","RSPH9",9,24,33,0.727272727272727,0.272727272727273,1
"14382","RSPO1",25,18,43,0.418604651162791,0.581395348837209,1
"14383","RSPO2",26,49,75,0.653333333333333,0.346666666666667,1
"14384","RSPO3",9,25,34,0.735294117647059,0.264705882352941,1
"14385","RSPO4",10,21,31,0.67741935483871,0.32258064516129,1
"14386","RSPRY1",20,30,50,0.6,0.4,1
"14387","RSRC1",16,32,48,0.666666666666667,0.333333333333333,1
"14388","RSRC2",21,24,45,0.533333333333333,0.466666666666667,1
"14389","RSRP1",11,12,23,0.521739130434783,0.478260869565217,1
"14390","RSU1",10,12,22,0.545454545454545,0.454545454545455,1
"14391","RSU1P1",0,1,1,1,0,1
"14392","RTBDN",9,12,21,0.571428571428571,0.428571428571429,1
"14393","RTCA",12,19,31,0.612903225806452,0.387096774193548,1
"14394","RTCB",16,29,45,0.644444444444444,0.355555555555556,1
"14395","RTEL1",35,47,82,0.573170731707317,0.426829268292683,1
"14396","RTF1",21,36,57,0.631578947368421,0.368421052631579,1
"14397","RTF2",12,17,29,0.586206896551724,0.413793103448276,1
"14398","RTKN",17,32,49,0.653061224489796,0.346938775510204,1
"14399","RTKN2",27,31,58,0.53448275862069,0.46551724137931,1
"14400","RTL1",10,40,50,0.8,0.2,1
"14401","RTL10",13,24,37,0.648648648648649,0.351351351351351,1
"14402","RTL3",51,65,116,0.560344827586207,0.439655172413793,1
"14403","RTL4",32,40,72,0.555555555555556,0.444444444444444,1
"14404","RTL5",50,27,77,0.350649350649351,0.649350649350649,1
"14405","RTL6",7,14,21,0.666666666666667,0.333333333333333,1
"14406","RTL8A",12,3,15,0.2,0.8,1
"14407","RTL8B",12,3,15,0.2,0.8,1
"14408","RTL8C",9,5,14,0.357142857142857,0.642857142857143,1
"14409","RTL9",88,78,166,0.469879518072289,0.530120481927711,1
"14410","RTN1",50,96,146,0.657534246575342,0.342465753424658,1
"14411","RTN2",27,34,61,0.557377049180328,0.442622950819672,1
"14412","RTN3",39,66,105,0.628571428571429,0.371428571428571,1
"14413","RTN4",39,65,104,0.625,0.375,1
"14414","RTN4IP1",7,39,46,0.847826086956522,0.152173913043478,1
"14415","RTN4R",12,11,23,0.478260869565217,0.521739130434783,1
"14416","RTN4RL1",16,22,38,0.578947368421053,0.421052631578947,1
"14417","RTN4RL2",11,13,24,0.541666666666667,0.458333333333333,1
"14418","RTP1",18,38,56,0.678571428571429,0.321428571428571,1
"14419","RTP2",12,36,48,0.75,0.25,1
"14420","RTP3",5,17,22,0.772727272727273,0.227272727272727,1
"14421","RTP4",4,16,20,0.8,0.2,1
"14422","RTP5",24,37,61,0.60655737704918,0.39344262295082,1
"14423","RTRAF",4,12,16,0.75,0.25,1
"14424","RTTN",80,127,207,0.613526570048309,0.386473429951691,1
"14425","RUBCN",49,53,102,0.519607843137255,0.480392156862745,1
"14426","RUBCNL",31,38,69,0.550724637681159,0.449275362318841,1
"14427","RUFY1",18,31,49,0.63265306122449,0.36734693877551,1
"14428","RUFY2",27,38,65,0.584615384615385,0.415384615384615,1
"14429","RUFY3",23,38,61,0.622950819672131,0.377049180327869,1
"14430","RUFY4",12,27,39,0.692307692307692,0.307692307692308,1
"14431","RUNDC1",16,22,38,0.578947368421053,0.421052631578947,1
"14432","RUNDC3A",10,11,21,0.523809523809524,0.476190476190476,1
"14433","RUNDC3B",24,68,92,0.739130434782609,0.260869565217391,1
"14434","RUNX1",23,29,52,0.557692307692308,0.442307692307692,1
"14435","RUNX1T1",72,167,239,0.698744769874477,0.301255230125523,1
"14436","RUNX2",34,34,68,0.5,0.5,1
"14437","RUNX3",20,19,39,0.487179487179487,0.512820512820513,1
"14438","RUSC1",38,34,72,0.472222222222222,0.527777777777778,1
"14439","RUSC2",42,65,107,0.607476635514019,0.392523364485981,1
"14440","RUSF1",13,17,30,0.566666666666667,0.433333333333333,1
"14441","RUVBL1",15,39,54,0.722222222222222,0.277777777777778,1
"14442","RUVBL2",24,30,54,0.555555555555556,0.444444444444444,1
"14443","RWDD1",6,10,16,0.625,0.375,1
"14444","RWDD2A",7,7,14,0.5,0.5,1
"14445","RWDD2B",16,30,46,0.652173913043478,0.347826086956522,1
"14446","RWDD3",6,16,22,0.727272727272727,0.272727272727273,1
"14447","RWDD4",6,9,15,0.6,0.4,1
"14448","RXFP1",45,87,132,0.659090909090909,0.340909090909091,1
"14449","RXFP2",44,79,123,0.642276422764228,0.357723577235772,1
"14450","RXFP3",45,62,107,0.579439252336449,0.420560747663551,1
"14451","RXFP4",8,15,23,0.652173913043478,0.347826086956522,1
"14452","RXRA",29,44,73,0.602739726027397,0.397260273972603,1
"14453","RXRB",24,19,43,0.441860465116279,0.558139534883721,1
"14454","RXRG",31,57,88,0.647727272727273,0.352272727272727,1
"14455","RXYLT1",12,27,39,0.692307692307692,0.307692307692308,1
"14456","RYBP",10,11,21,0.523809523809524,0.476190476190476,1
"14457","RYK",15,32,47,0.680851063829787,0.319148936170213,1
"14458","RYR1",257,483,740,0.652702702702703,0.347297297297297,1
"14459","RYR2",539,865,1404,0.616096866096866,0.383903133903134,1
"14460","RYR3",245,549,794,0.691435768261965,0.308564231738035,1
"14461","S100A1",1,3,4,0.75,0.25,1
"14462","S100A10",4,4,8,0.5,0.5,1
"14463","S100A11",3,3,6,0.5,0.5,1
"14464","S100A12",2,11,13,0.846153846153846,0.153846153846154,1
"14465","S100A13",8,2,10,0.2,0.8,1
"14466","S100A14",0,7,7,1,0,1
"14467","S100A16",5,5,10,0.5,0.5,1
"14468","S100A2",7,4,11,0.363636363636364,0.636363636363636,1
"14469","S100A3",3,10,13,0.769230769230769,0.230769230769231,1
"14470","S100A4",2,6,8,0.75,0.25,1
"14471","S100A5",2,7,9,0.777777777777778,0.222222222222222,1
"14472","S100A6",3,3,6,0.5,0.5,1
"14473","S100A7",13,16,29,0.551724137931034,0.448275862068966,1
"14474","S100A7A",6,15,21,0.714285714285714,0.285714285714286,1
"14475","S100A7L2",7,12,19,0.631578947368421,0.368421052631579,1
"14476","S100A8",14,9,23,0.391304347826087,0.608695652173913,1
"14477","S100A9",7,9,16,0.5625,0.4375,1
"14478","S100B",3,7,10,0.7,0.3,1
"14479","S100G",4,4,8,0.5,0.5,1
"14480","S100P",1,4,5,0.8,0.2,1
"14481","S100PBP",14,26,40,0.65,0.35,1
"14482","S100Z",7,3,10,0.3,0.7,1
"14483","S1PR1",33,41,74,0.554054054054054,0.445945945945946,1
"14484","S1PR2",7,14,21,0.666666666666667,0.333333333333333,1
"14485","S1PR3",13,26,39,0.666666666666667,0.333333333333333,1
"14486","S1PR4",22,29,51,0.568627450980392,0.431372549019608,1
"14487","S1PR5",11,20,31,0.645161290322581,0.354838709677419,1
"14488","SAA1",7,9,16,0.5625,0.4375,1
"14489","SAA2",10,8,18,0.444444444444444,0.555555555555556,1
"14490","SAA2-SAA4",4,13,17,0.764705882352941,0.235294117647059,1
"14491","SAA4",0,1,1,1,0,1
"14492","SAAL1",15,24,39,0.615384615384615,0.384615384615385,1
"14493","SAC3D1",5,11,16,0.6875,0.3125,1
"14494","SACM1L",10,26,36,0.722222222222222,0.277777777777778,1
"14495","SACS",205,352,557,0.631956912028725,0.368043087971275,1
"14496","SAE1",7,21,28,0.75,0.25,1
"14497","SAFB",29,57,86,0.662790697674419,0.337209302325581,1
"14498","SAFB2",36,44,80,0.55,0.45,1
"14499","SAG",22,29,51,0.568627450980392,0.431372549019608,1
"14500","SAGE1",92,108,200,0.54,0.46,1
"14501","SALL1",120,238,358,0.664804469273743,0.335195530726257,1
"14502","SALL2",29,69,98,0.704081632653061,0.295918367346939,1
"14503","SALL3",57,126,183,0.688524590163934,0.311475409836066,1
"14504","SALL4",67,104,171,0.608187134502924,0.391812865497076,1
"14505","SAMD1",4,6,10,0.6,0.4,0.29
"14506","SAMD10",3,9,12,0.75,0.25,0.29
"14507","SAMD11",8,29,37,0.783783783783784,0.216216216216216,0.29
"14508","SAMD12",10,27,37,0.72972972972973,0.27027027027027,0.29
"14509","SAMD13",5,8,13,0.615384615384615,0.384615384615385,0.29
"14510","SAMD14",15,29,44,0.659090909090909,0.340909090909091,0.29
"14511","SAMD15",12,49,61,0.80327868852459,0.19672131147541,0.29
"14512","SAMD3",23,63,86,0.732558139534884,0.267441860465116,1
"14513","SAMD4A",24,36,60,0.6,0.4,1
"14514","SAMD4B",23,29,52,0.557692307692308,0.442307692307692,1
"14515","SAMD5",4,2,6,0.333333333333333,0.666666666666667,1
"14516","SAMD7",42,70,112,0.625,0.375,1
"14517","SAMD8",11,14,25,0.56,0.44,1
"14518","SAMD9",115,158,273,0.578754578754579,0.421245421245421,1
"14519","SAMD9L",114,190,304,0.625,0.375,1
"14520","SAMHD1",37,55,92,0.597826086956522,0.402173913043478,1
"14521","SAMM50",12,16,28,0.571428571428571,0.428571428571429,1
"14522","SAMSN1",30,51,81,0.62962962962963,0.37037037037037,1
"14523","SAP130",40,62,102,0.607843137254902,0.392156862745098,1
"14524","SAP18",5,10,15,0.666666666666667,0.333333333333333,1
"14525","SAP30",5,9,14,0.642857142857143,0.357142857142857,1
"14526","SAP30BP",8,23,31,0.741935483870968,0.258064516129032,1
"14527","SAP30L",3,9,12,0.75,0.25,1
"14528","SAPCD1",5,8,13,0.615384615384615,0.384615384615385,0.39
"14529","SAPCD2",3,9,12,0.75,0.25,0.39
"14530","SAR1A",3,14,17,0.823529411764706,0.176470588235294,0.77
"14531","SAR1B",7,5,12,0.416666666666667,0.583333333333333,0.77
"14532","SARAF",6,16,22,0.727272727272727,0.272727272727273,0.82
"14533","SARDH",35,52,87,0.597701149425287,0.402298850574713,0.77
"14534","SARM1",6,9,15,0.6,0.4,0.77
"14535","SARNP",0,5,5,1,0,0.77
"14536","SARS1",12,28,40,0.7,0.3,0.77
"14537","SARS2",2,12,14,0.857142857142857,0.142857142857143,0.77
"14538","SART1",16,21,37,0.567567567567568,0.432432432432432,0.77
"14539","SART3",24,42,66,0.636363636363636,0.363636363636364,0.77
"14540","SASH1",47,72,119,0.605042016806723,0.394957983193277,1
"14541","SASH3",28,18,46,0.391304347826087,0.608695652173913,1
"14542","SASS6",31,35,66,0.53030303030303,0.46969696969697,1
"14543","SAT1",11,11,22,0.5,0.5,1
"14544","SAT2",7,6,13,0.461538461538462,0.538461538461538,1
"14545","SATB1",39,69,108,0.638888888888889,0.361111111111111,1
"14546","SATB2",56,84,140,0.6,0.4,1
"14547","SATL1",40,27,67,0.402985074626866,0.597014925373134,1
"14548","SAV1",10,17,27,0.62962962962963,0.37037037037037,1
"14549","SAXO1",18,24,42,0.571428571428571,0.428571428571429,1
"14550","SAXO2",22,34,56,0.607142857142857,0.392857142857143,1
"14551","SAYSD1",5,12,17,0.705882352941177,0.294117647058824,1
"14552","SBDS",15,9,24,0.375,0.625,1
"14553","SBF1",83,79,162,0.487654320987654,0.512345679012346,1
"14554","SBF2",39,89,128,0.6953125,0.3046875,1
"14555","SBK1",11,18,29,0.620689655172414,0.379310344827586,1
"14556","SBK2",8,19,27,0.703703703703704,0.296296296296296,1
"14557","SBNO1",62,92,154,0.597402597402597,0.402597402597403,1
"14558","SBNO2",28,36,64,0.5625,0.4375,1
"14559","SBSN",10,30,40,0.75,0.25,1
"14560","SBSPON",17,17,34,0.5,0.5,1
"14561","SC5D",14,21,35,0.6,0.4,1
"14562","SCAF1",47,61,108,0.564814814814815,0.435185185185185,1
"14563","SCAF11",66,84,150,0.56,0.44,1
"14564","SCAF4",73,106,179,0.592178770949721,0.407821229050279,1
"14565","SCAF8",47,67,114,0.587719298245614,0.412280701754386,1
"14566","SCAI",22,29,51,0.568627450980392,0.431372549019608,1
"14567","SCAMP1",7,13,20,0.65,0.35,1
"14568","SCAMP2",8,20,28,0.714285714285714,0.285714285714286,1
"14569","SCAMP3",13,15,28,0.535714285714286,0.464285714285714,1
"14570","SCAMP4",4,8,12,0.666666666666667,0.333333333333333,1
"14571","SCAMP5",16,20,36,0.555555555555556,0.444444444444444,1
"14572","SCAND1",4,5,9,0.555555555555556,0.444444444444444,1
"14573","SCAP",38,68,106,0.641509433962264,0.358490566037736,1
"14574","SCAPER",52,68,120,0.566666666666667,0.433333333333333,1
"14575","SCARA3",15,34,49,0.693877551020408,0.306122448979592,0.77
"14576","SCARA5",24,41,65,0.630769230769231,0.369230769230769,0.77
"14577","SCARB1",7,25,32,0.78125,0.21875,0.77
"14578","SCARB2",17,22,39,0.564102564102564,0.435897435897436,0.77
"14579","SCARF1",21,42,63,0.666666666666667,0.333333333333333,0.6
"14580","SCARF2",18,20,38,0.526315789473684,0.473684210526316,0.77
"14581","SCCPDH",13,18,31,0.580645161290323,0.419354838709677,1
"14582","SCD",11,11,22,0.5,0.5,1
"14583","SCD5",13,19,32,0.59375,0.40625,1
"14584","SCEL",24,60,84,0.714285714285714,0.285714285714286,1
"14585","SCFD1",26,33,59,0.559322033898305,0.440677966101695,1
"14586","SCFD2",23,41,64,0.640625,0.359375,1
"14587","SCG2",31,75,106,0.707547169811321,0.292452830188679,1
"14588","SCG3",14,50,64,0.78125,0.21875,1
"14589","SCG5",4,17,21,0.80952380952381,0.19047619047619,1
"14590","SCGB1A1",6,5,11,0.454545454545455,0.545454545454545,1
"14591","SCGB1C1",3,4,7,0.571428571428571,0.428571428571429,1
"14592","SCGB1D1",4,11,15,0.733333333333333,0.266666666666667,1
"14593","SCGB1D2",5,9,14,0.642857142857143,0.357142857142857,1
"14594","SCGB1D4",3,13,16,0.8125,0.1875,1
"14595","SCGB2A1",7,3,10,0.3,0.7,1
"14596","SCGB2A2",5,5,10,0.5,0.5,1
"14597","SCGB2B2",3,10,13,0.769230769230769,0.230769230769231,1
"14598","SCGB3A1",2,2,4,0.5,0.5,1
"14599","SCGB3A2",2,5,7,0.714285714285714,0.285714285714286,1
"14600","SCGN",15,38,53,0.716981132075472,0.283018867924528,1
"14601","SCIMP",4,2,6,0.333333333333333,0.666666666666667,1
"14602","SCIN",15,36,51,0.705882352941177,0.294117647058824,1
"14603","SCLT1",47,41,88,0.465909090909091,0.534090909090909,1
"14604","SCLY",19,18,37,0.486486486486487,0.513513513513513,1
"14605","SCMH1",17,25,42,0.595238095238095,0.404761904761905,1
"14606","SCML1",10,13,23,0.565217391304348,0.434782608695652,1
"14607","SCML2",53,34,87,0.390804597701149,0.609195402298851,1
"14608","SCML4",23,19,42,0.452380952380952,0.547619047619048,1
"14609","SCN10A",142,273,415,0.657831325301205,0.342168674698795,1
"14610","SCN11A",125,277,402,0.689054726368159,0.310945273631841,1
"14611","SCN1A",138,319,457,0.698030634573304,0.301969365426696,1
"14612","SCN1B",5,18,23,0.782608695652174,0.217391304347826,1
"14613","SCN2A",118,249,367,0.678474114441417,0.321525885558583,1
"14614","SCN2B",16,16,32,0.5,0.5,1
"14615","SCN3A",120,214,334,0.640718562874252,0.359281437125749,1
"14616","SCN3B",12,29,41,0.707317073170732,0.292682926829268,1
"14617","SCN4A",86,138,224,0.616071428571429,0.383928571428571,1
"14618","SCN4B",8,9,17,0.529411764705882,0.470588235294118,1
"14619","SCN5A",129,233,362,0.643646408839779,0.356353591160221,1
"14620","SCN7A",105,179,284,0.630281690140845,0.369718309859155,1
"14621","SCN8A",66,97,163,0.595092024539877,0.404907975460123,1
"14622","SCN9A",120,235,355,0.661971830985915,0.338028169014085,1
"14623","SCNM1",7,11,18,0.611111111111111,0.388888888888889,1
"14624","SCNN1A",17,40,57,0.701754385964912,0.298245614035088,1
"14625","SCNN1B",28,51,79,0.645569620253165,0.354430379746835,1
"14626","SCNN1D",22,25,47,0.531914893617021,0.468085106382979,1
"14627","SCNN1G",36,72,108,0.666666666666667,0.333333333333333,1
"14628","SCO1",7,8,15,0.533333333333333,0.466666666666667,1
"14629","SCO2",3,8,11,0.727272727272727,0.272727272727273,1
"14630","SCOC",6,3,9,0.333333333333333,0.666666666666667,1
"14631","SCP2",17,29,46,0.630434782608696,0.369565217391304,1
"14632","SCP2D1",15,19,34,0.558823529411765,0.441176470588235,1
"14633","SCPEP1",10,18,28,0.642857142857143,0.357142857142857,1
"14634","SCRG1",2,3,5,0.6,0.4,1
"14635","SCRIB",64,89,153,0.581699346405229,0.418300653594771,1
"14636","SCRN1",20,33,53,0.622641509433962,0.377358490566038,1
"14637","SCRN2",15,19,34,0.558823529411765,0.441176470588235,1
"14638","SCRN3",10,20,30,0.666666666666667,0.333333333333333,1
"14639","SCRT1",4,10,14,0.714285714285714,0.285714285714286,1
"14640","SCRT2",7,4,11,0.363636363636364,0.636363636363636,1
"14641","SCT",3,1,4,0.25,0.75,1
"14642","SCTR",18,32,50,0.64,0.36,1
"14643","SCUBE1",30,68,98,0.693877551020408,0.306122448979592,1
"14644","SCUBE2",29,59,88,0.670454545454545,0.329545454545455,1
"14645","SCUBE3",34,51,85,0.6,0.4,1
"14646","SCX",1,3,4,0.75,0.25,1
"14647","SCYL1",24,29,53,0.547169811320755,0.452830188679245,1
"14648","SCYL2",27,49,76,0.644736842105263,0.355263157894737,1
"14649","SCYL3",25,32,57,0.56140350877193,0.43859649122807,1
"14650","SDAD1",23,30,53,0.566037735849057,0.433962264150943,1
"14651","SDC1",10,13,23,0.565217391304348,0.434782608695652,1
"14652","SDC2",15,20,35,0.571428571428571,0.428571428571429,1
"14653","SDC3",14,17,31,0.548387096774194,0.451612903225806,1
"14654","SDC4",9,12,21,0.571428571428571,0.428571428571429,1
"14655","SDCBP",13,11,24,0.458333333333333,0.541666666666667,1
"14656","SDCBP2",11,18,29,0.620689655172414,0.379310344827586,1
"14657","SDCCAG8",26,51,77,0.662337662337662,0.337662337662338,1
"14658","SDE2",16,27,43,0.627906976744186,0.372093023255814,1
"14659","SDF2",9,7,16,0.4375,0.5625,1
"14660","SDF2L1",1,8,9,0.888888888888889,0.111111111111111,1
"14661","SDF4",13,20,33,0.606060606060606,0.393939393939394,1
"14662","SDHA",30,46,76,0.605263157894737,0.394736842105263,1
"14663","SDHAF1",1,0,1,0,1,1
"14664","SDHAF2",8,18,26,0.692307692307692,0.307692307692308,1
"14665","SDHAF3",9,8,17,0.470588235294118,0.529411764705882,1
"14666","SDHAF4",4,8,12,0.666666666666667,0.333333333333333,1
"14667","SDHB",6,10,16,0.625,0.375,1
"14668","SDHC",3,10,13,0.769230769230769,0.230769230769231,1
"14669","SDHD",7,12,19,0.631578947368421,0.368421052631579,1
"14670","SDK1",128,249,377,0.660477453580902,0.339522546419098,1
"14671","SDK2",86,132,218,0.605504587155963,0.394495412844037,1
"14672","SDR16C5",24,44,68,0.647058823529412,0.352941176470588,1
"14673","SDR16C6P",0,1,1,1,0,1
"14674","SDR39U1",8,15,23,0.652173913043478,0.347826086956522,1
"14675","SDR42E1",10,44,54,0.814814814814815,0.185185185185185,1
"14676","SDR9C7",7,26,33,0.787878787878788,0.212121212121212,1
"14677","SDS",17,31,48,0.645833333333333,0.354166666666667,1
"14678","SDSL",13,16,29,0.551724137931034,0.448275862068966,1
"14679","SEBOX",3,5,8,0.625,0.375,1
"14680","SEC11A",2,10,12,0.833333333333333,0.166666666666667,1
"14681","SEC11C",7,13,20,0.65,0.35,1
"14682","SEC13",11,18,29,0.620689655172414,0.379310344827586,1
"14683","SEC14L1",27,47,74,0.635135135135135,0.364864864864865,1
"14684","SEC14L2",6,12,18,0.666666666666667,0.333333333333333,1
"14685","SEC14L3",19,43,62,0.693548387096774,0.306451612903226,1
"14686","SEC14L4",23,36,59,0.610169491525424,0.389830508474576,1
"14687","SEC14L5",36,52,88,0.590909090909091,0.409090909090909,1
"14688","SEC16A",59,102,161,0.633540372670807,0.366459627329193,1
"14689","SEC16B",35,57,92,0.619565217391304,0.380434782608696,1
"14690","SEC22A",12,22,34,0.647058823529412,0.352941176470588,1
"14691","SEC22B",1,1,2,0.5,0.5,1
"14692","SEC22C",11,11,22,0.5,0.5,1
"14693","SEC23A",22,52,74,0.702702702702703,0.297297297297297,1
"14694","SEC23B",21,52,73,0.712328767123288,0.287671232876712,1
"14695","SEC23IP",31,59,90,0.655555555555556,0.344444444444444,1
"14696","SEC24A",34,60,94,0.638297872340426,0.361702127659574,1
"14697","SEC24B",37,59,96,0.614583333333333,0.385416666666667,1
"14698","SEC24C",36,56,92,0.608695652173913,0.391304347826087,1
"14699","SEC24D",47,45,92,0.489130434782609,0.510869565217391,1
"14700","SEC31A",55,86,141,0.609929078014184,0.390070921985816,1
"14701","SEC31B",32,64,96,0.666666666666667,0.333333333333333,1
"14702","SEC61A1",19,27,46,0.58695652173913,0.41304347826087,1
"14703","SEC61A2",14,21,35,0.6,0.4,1
"14704","SEC61B",3,5,8,0.625,0.375,1
"14705","SEC61G",2,4,6,0.666666666666667,0.333333333333333,1
"14706","SEC62",9,15,24,0.625,0.375,1
"14707","SEC63",37,46,83,0.55421686746988,0.44578313253012,1
"14708","SECISBP2",25,39,64,0.609375,0.390625,1
"14709","SECISBP2L",39,60,99,0.606060606060606,0.393939393939394,1
"14710","SECTM1",8,12,20,0.6,0.4,1
"14711","SEH1L",11,9,20,0.45,0.55,1
"14712","SEL1L",24,42,66,0.636363636363636,0.363636363636364,1
"14713","SEL1L2",57,88,145,0.606896551724138,0.393103448275862,1
"14714","SEL1L3",50,80,130,0.615384615384615,0.384615384615385,1
"14715","SELE",39,89,128,0.6953125,0.3046875,1
"14716","SELENBP1",13,30,43,0.697674418604651,0.302325581395349,1
"14717","SELENOF",3,4,7,0.571428571428571,0.428571428571429,1
"14718","SELENOH",0,7,7,1,0,1
"14719","SELENOI",7,17,24,0.708333333333333,0.291666666666667,1
"14720","SELENOK",2,1,3,0.333333333333333,0.666666666666667,1
"14721","SELENOM",4,4,8,0.5,0.5,1
"14722","SELENON",10,20,30,0.666666666666667,0.333333333333333,1
"14723","SELENOO",17,19,36,0.527777777777778,0.472222222222222,1
"14724","SELENOP",19,34,53,0.641509433962264,0.358490566037736,1
"14725","SELENOS",4,3,7,0.428571428571429,0.571428571428571,1
"14726","SELENOT",9,7,16,0.4375,0.5625,1
"14727","SELENOV",9,6,15,0.4,0.6,1
"14728","SELENOW",0,4,4,1,0,1
"14729","SELL",17,39,56,0.696428571428571,0.303571428571429,1
"14730","SELP",79,91,170,0.535294117647059,0.464705882352941,1
"14731","SELPLG",18,31,49,0.63265306122449,0.36734693877551,1
"14732","SEM1",8,9,17,0.529411764705882,0.470588235294118,1
"14733","SEMA3A",54,109,163,0.668711656441718,0.331288343558282,1
"14734","SEMA3B",13,22,35,0.628571428571429,0.371428571428571,1
"14735","SEMA3C",40,67,107,0.626168224299065,0.373831775700935,1
"14736","SEMA3D",68,100,168,0.595238095238095,0.404761904761905,1
"14737","SEMA3E",65,115,180,0.638888888888889,0.361111111111111,1
"14738","SEMA3F",33,51,84,0.607142857142857,0.392857142857143,1
"14739","SEMA3G",22,56,78,0.717948717948718,0.282051282051282,1
"14740","SEMA4A",31,46,77,0.597402597402597,0.402597402597403,1
"14741","SEMA4B",22,25,47,0.531914893617021,0.468085106382979,1
"14742","SEMA4C",39,27,66,0.409090909090909,0.590909090909091,1
"14743","SEMA4D",25,52,77,0.675324675324675,0.324675324675325,1
"14744","SEMA4F",31,51,82,0.621951219512195,0.378048780487805,1
"14745","SEMA4G",25,42,67,0.626865671641791,0.373134328358209,1
"14746","SEMA5A",70,130,200,0.65,0.35,1
"14747","SEMA5B",91,96,187,0.513368983957219,0.486631016042781,1
"14748","SEMA6A",48,42,90,0.466666666666667,0.533333333333333,1
"14749","SEMA6B",28,45,73,0.616438356164384,0.383561643835616,1
"14750","SEMA6C",35,40,75,0.533333333333333,0.466666666666667,1
"14751","SEMA6D",67,119,186,0.639784946236559,0.360215053763441,1
"14752","SEMA7A",20,32,52,0.615384615384615,0.384615384615385,1
"14753","SEMG1",26,57,83,0.686746987951807,0.313253012048193,1
"14754","SEMG2",42,60,102,0.588235294117647,0.411764705882353,1
"14755","SENP1",33,32,65,0.492307692307692,0.507692307692308,1
"14756","SENP2",31,28,59,0.474576271186441,0.525423728813559,1
"14757","SENP3",14,18,32,0.5625,0.4375,1
"14758","SENP5",21,46,67,0.686567164179104,0.313432835820896,1
"14759","SENP6",38,52,90,0.577777777777778,0.422222222222222,1
"14760","SENP7",45,75,120,0.625,0.375,1
"14761","SENP8",7,15,22,0.681818181818182,0.318181818181818,1
"14762","SEPHS1",13,15,28,0.535714285714286,0.464285714285714,1
"14763","SEPHS2",11,21,32,0.65625,0.34375,1
"14764","SEPSECS",11,14,25,0.56,0.44,1
"14765","SEPTIN1",10,18,28,0.642857142857143,0.357142857142857,1
"14766","SEPTIN10",13,29,42,0.69047619047619,0.30952380952381,1
"14767","SEPTIN11",9,23,32,0.71875,0.28125,1
"14768","SEPTIN12",13,29,42,0.69047619047619,0.30952380952381,1
"14769","SEPTIN14",32,49,81,0.604938271604938,0.395061728395062,1
"14770","SEPTIN2",17,19,36,0.527777777777778,0.472222222222222,1
"14771","SEPTIN3",17,17,34,0.5,0.5,1
"14772","SEPTIN4",37,64,101,0.633663366336634,0.366336633663366,1
"14773","SEPTIN5",14,20,34,0.588235294117647,0.411764705882353,1
"14774","SEPTIN6",32,15,47,0.319148936170213,0.680851063829787,1
"14775","SEPTIN7",7,17,24,0.708333333333333,0.291666666666667,1
"14776","SEPTIN7P9",0,1,1,1,0,1
"14777","SEPTIN8",16,11,27,0.407407407407407,0.592592592592593,1
"14778","SEPTIN9",25,18,43,0.418604651162791,0.581395348837209,1
"14779","SERAC1",22,30,52,0.576923076923077,0.423076923076923,1
"14780","SERBP1",14,29,43,0.674418604651163,0.325581395348837,1
"14781","SERF1B",0,1,1,1,0,1
"14782","SERF2",2,5,7,0.714285714285714,0.285714285714286,1
"14783","SERGEF",12,21,33,0.636363636363636,0.363636363636364,1
"14784","SERHL",2,0,2,0,1,1
"14785","SERHL2",3,7,10,0.7,0.3,1
"14786","SERINC1",8,20,28,0.714285714285714,0.285714285714286,1
"14787","SERINC2",9,27,36,0.75,0.25,1
"14788","SERINC3",18,29,47,0.617021276595745,0.382978723404255,1
"14789","SERINC4",13,10,23,0.434782608695652,0.565217391304348,1
"14790","SERINC5",10,19,29,0.655172413793103,0.344827586206897,1
"14791","SERP1",2,3,5,0.6,0.4,1
"14792","SERP2",4,3,7,0.428571428571429,0.571428571428571,1
"14793","SERPINA1",15,34,49,0.693877551020408,0.306122448979592,1
"14794","SERPINA10",28,64,92,0.695652173913043,0.304347826086957,1
"14795","SERPINA11",35,45,80,0.5625,0.4375,1
"14796","SERPINA12",28,45,73,0.616438356164384,0.383561643835616,1
"14797","SERPINA13P",21,44,65,0.676923076923077,0.323076923076923,1
"14798","SERPINA3",27,62,89,0.696629213483146,0.303370786516854,1
"14799","SERPINA4",29,54,83,0.650602409638554,0.349397590361446,1
"14800","SERPINA5",30,48,78,0.615384615384615,0.384615384615385,1
"14801","SERPINA6",26,40,66,0.606060606060606,0.393939393939394,1
"14802","SERPINA7",35,54,89,0.606741573033708,0.393258426966292,1
"14803","SERPINA9",33,60,93,0.645161290322581,0.354838709677419,1
"14804","SERPINB1",8,8,16,0.5,0.5,1
"14805","SERPINB10",25,42,67,0.626865671641791,0.373134328358209,1
"14806","SERPINB11",34,48,82,0.585365853658537,0.414634146341463,1
"14807","SERPINB12",34,43,77,0.558441558441558,0.441558441558442,1
"14808","SERPINB13",27,44,71,0.619718309859155,0.380281690140845,1
"14809","SERPINB2",27,61,88,0.693181818181818,0.306818181818182,1
"14810","SERPINB3",32,84,116,0.724137931034483,0.275862068965517,1
"14811","SERPINB4",34,60,94,0.638297872340426,0.361702127659574,1
"14812","SERPINB5",14,34,48,0.708333333333333,0.291666666666667,1
"14813","SERPINB6",14,22,36,0.611111111111111,0.388888888888889,1
"14814","SERPINB7",29,61,90,0.677777777777778,0.322222222222222,1
"14815","SERPINB8",23,42,65,0.646153846153846,0.353846153846154,1
"14816","SERPINB9",16,28,44,0.636363636363636,0.363636363636364,1
"14817","SERPINC1",24,37,61,0.60655737704918,0.39344262295082,1
"14818","SERPIND1",22,27,49,0.551020408163265,0.448979591836735,1
"14819","SERPINE1",23,35,58,0.603448275862069,0.396551724137931,1
"14820","SERPINE2",23,26,49,0.530612244897959,0.469387755102041,1
"14821","SERPINE3",18,25,43,0.581395348837209,0.418604651162791,1
"14822","SERPINF1",20,21,41,0.51219512195122,0.48780487804878,1
"14823","SERPINF2",22,21,43,0.488372093023256,0.511627906976744,1
"14824","SERPING1",23,38,61,0.622950819672131,0.377049180327869,1
"14825","SERPINH1",17,18,35,0.514285714285714,0.485714285714286,1
"14826","SERPINI1",29,37,66,0.560606060606061,0.439393939393939,1
"14827","SERPINI2",43,70,113,0.619469026548673,0.380530973451327,1
"14828","SERTAD1",11,8,19,0.421052631578947,0.578947368421053,1
"14829","SERTAD2",10,30,40,0.75,0.25,1
"14830","SERTAD3",6,14,20,0.7,0.3,1
"14831","SERTAD4",19,34,53,0.641509433962264,0.358490566037736,1
"14832","SERTM1",4,19,23,0.826086956521739,0.173913043478261,1
"14833","SESN1",14,26,40,0.65,0.35,1
"14834","SESN2",23,29,52,0.557692307692308,0.442307692307692,1
"14835","SESN3",25,32,57,0.56140350877193,0.43859649122807,1
"14836","SESTD1",35,56,91,0.615384615384615,0.384615384615385,1
"14837","SET",10,14,24,0.583333333333333,0.416666666666667,1
"14838","SETBP1",104,177,281,0.629893238434164,0.370106761565836,1
"14839","SETD1A",64,102,166,0.614457831325301,0.385542168674699,1
"14840","SETD1B",2,8,10,0.8,0.2,1
"14841","SETD2",138,190,328,0.579268292682927,0.420731707317073,1
"14842","SETD3",27,30,57,0.526315789473684,0.473684210526316,1
"14843","SETD4",11,28,39,0.717948717948718,0.282051282051282,1
"14844","SETD5",54,77,131,0.587786259541985,0.412213740458015,1
"14845","SETD6",9,16,25,0.64,0.36,1
"14846","SETD7",9,23,32,0.71875,0.28125,1
"14847","SETD9",2,14,16,0.875,0.125,1
"14848","SETDB1",64,62,126,0.492063492063492,0.507936507936508,1
"14849","SETDB2",30,31,61,0.508196721311475,0.491803278688525,1
"14850","SETMAR",16,24,40,0.6,0.4,0.77
"14851","SETX",110,141,251,0.561752988047809,0.438247011952191,1
"14852","SEZ6",30,54,84,0.642857142857143,0.357142857142857,1
"14853","SEZ6L",73,147,220,0.668181818181818,0.331818181818182,1
"14854","SEZ6L2",43,75,118,0.635593220338983,0.364406779661017,1
"14855","SF1",35,55,90,0.611111111111111,0.388888888888889,1
"14856","SF3A1",29,32,61,0.524590163934426,0.475409836065574,1
"14857","SF3A2",14,14,28,0.5,0.5,1
"14858","SF3A3",10,32,42,0.761904761904762,0.238095238095238,1
"14859","SF3B1",73,117,190,0.615789473684211,0.384210526315789,1
"14860","SF3B2",38,52,90,0.577777777777778,0.422222222222222,1
"14861","SF3B3",43,56,99,0.565656565656566,0.434343434343434,1
"14862","SF3B4",22,26,48,0.541666666666667,0.458333333333333,1
"14863","SF3B5",2,4,6,0.666666666666667,0.333333333333333,1
"14864","SF3B6",1,7,8,0.875,0.125,1
"14865","SFI1",33,60,93,0.645161290322581,0.354838709677419,1
"14866","SFMBT1",31,29,60,0.483333333333333,0.516666666666667,1
"14867","SFMBT2",63,105,168,0.625,0.375,1
"14868","SFN",12,8,20,0.4,0.6,1
"14869","SFPQ",26,31,57,0.543859649122807,0.456140350877193,1
"14870","SFR1",5,6,11,0.545454545454545,0.454545454545455,1
"14871","SFRP1",8,17,25,0.68,0.32,1
"14872","SFRP2",7,32,39,0.82051282051282,0.179487179487179,1
"14873","SFRP4",24,45,69,0.652173913043478,0.347826086956522,1
"14874","SFRP5",12,5,17,0.294117647058824,0.705882352941177,1
"14875","SFSWAP",30,51,81,0.62962962962963,0.37037037037037,1
"14876","SFT2D1",4,7,11,0.636363636363636,0.363636363636364,1
"14877","SFT2D2",5,11,16,0.6875,0.3125,1
"14878","SFTA2",0,8,8,1,0,1
"14879","SFTA3",4,13,17,0.764705882352941,0.235294117647059,1
"14880","SFTPA1",9,21,30,0.7,0.3,1
"14881","SFTPA2",14,28,42,0.666666666666667,0.333333333333333,1
"14882","SFTPB",20,22,42,0.523809523809524,0.476190476190476,1
"14883","SFTPC",9,6,15,0.4,0.6,1
"14884","SFTPD",17,35,52,0.673076923076923,0.326923076923077,1
"14885","SFXN1",13,21,34,0.617647058823529,0.382352941176471,1
"14886","SFXN2",8,20,28,0.714285714285714,0.285714285714286,1
"14887","SFXN3",5,17,22,0.772727272727273,0.227272727272727,1
"14888","SFXN4",12,18,30,0.6,0.4,1
"14889","SFXN5",15,13,28,0.464285714285714,0.535714285714286,1
"14890","SGCA",15,29,44,0.659090909090909,0.340909090909091,1
"14891","SGCB",7,21,28,0.75,0.25,1
"14892","SGCD",21,23,44,0.522727272727273,0.477272727272727,1
"14893","SGCE",21,33,54,0.611111111111111,0.388888888888889,1
"14894","SGCG",16,23,39,0.58974358974359,0.41025641025641,1
"14895","SGCZ",52,67,119,0.563025210084034,0.436974789915966,1
"14896","SGF29",6,14,20,0.7,0.3,1
"14897","SGIP1",60,99,159,0.622641509433962,0.377358490566038,1
"14898","SGK1",30,43,73,0.589041095890411,0.410958904109589,1
"14899","SGK2",24,53,77,0.688311688311688,0.311688311688312,1
"14900","SGK3",8,32,40,0.8,0.2,1
"14901","SGMS1",24,47,71,0.661971830985915,0.338028169014085,1
"14902","SGMS2",10,23,33,0.696969696969697,0.303030303030303,1
"14903","SGO1",31,42,73,0.575342465753425,0.424657534246575,1
"14904","SGO2",53,68,121,0.56198347107438,0.43801652892562,1
"14905","SGPL1",10,31,41,0.75609756097561,0.24390243902439,1
"14906","SGPP1",12,29,41,0.707317073170732,0.292682926829268,1
"14907","SGPP2",11,22,33,0.666666666666667,0.333333333333333,1
"14908","SGSH",7,20,27,0.740740740740741,0.259259259259259,1
"14909","SGSM1",47,87,134,0.649253731343284,0.350746268656716,1
"14910","SGSM2",22,35,57,0.614035087719298,0.385964912280702,1
"14911","SGSM3",21,31,52,0.596153846153846,0.403846153846154,1
"14912","SGTA",6,14,20,0.7,0.3,1
"14913","SGTB",7,18,25,0.72,0.28,1
"14914","SH2B1",31,41,72,0.569444444444444,0.430555555555556,1
"14915","SH2B2",15,20,35,0.571428571428571,0.428571428571429,1
"14916","SH2B3",11,18,29,0.620689655172414,0.379310344827586,1
"14917","SH2D1A",16,9,25,0.36,0.64,1
"14918","SH2D1B",9,14,23,0.608695652173913,0.391304347826087,1
"14919","SH2D2A",14,29,43,0.674418604651163,0.325581395348837,1
"14920","SH2D3A",16,33,49,0.673469387755102,0.326530612244898,1
"14921","SH2D3C",29,56,85,0.658823529411765,0.341176470588235,1
"14922","SH2D4A",18,21,39,0.538461538461538,0.461538461538462,1
"14923","SH2D4B",14,27,41,0.658536585365854,0.341463414634146,1
"14924","SH2D5",10,24,34,0.705882352941177,0.294117647058824,1
"14925","SH2D6",2,17,19,0.894736842105263,0.105263157894737,1
"14926","SH2D7",6,20,26,0.769230769230769,0.230769230769231,1
"14927","SH3BGR",6,6,12,0.5,0.5,1
"14928","SH3BGRL",6,5,11,0.454545454545455,0.545454545454545,1
"14929","SH3BGRL2",4,11,15,0.733333333333333,0.266666666666667,1
"14930","SH3BGRL3",3,1,4,0.25,0.75,1
"14931","SH3BP1",5,5,10,0.5,0.5,1
"14932","SH3BP2",30,26,56,0.464285714285714,0.535714285714286,1
"14933","SH3BP4",43,69,112,0.616071428571429,0.383928571428571,1
"14934","SH3BP5",10,14,24,0.583333333333333,0.416666666666667,1
"14935","SH3BP5L",16,30,46,0.652173913043478,0.347826086956522,1
"14936","SH3D19",26,31,57,0.543859649122807,0.456140350877193,1
"14937","SH3D21",13,13,26,0.5,0.5,1
"14938","SH3GL1",12,22,34,0.647058823529412,0.352941176470588,1
"14939","SH3GL2",19,43,62,0.693548387096774,0.306451612903226,1
"14940","SH3GL3",29,47,76,0.618421052631579,0.381578947368421,1
"14941","SH3GLB1",8,17,25,0.68,0.32,1
"14942","SH3GLB2",13,12,25,0.48,0.52,1
"14943","SH3KBP1",49,32,81,0.395061728395062,0.604938271604938,1
"14944","SH3PXD2A",56,53,109,0.486238532110092,0.513761467889908,1
"14945","SH3PXD2B",28,50,78,0.641025641025641,0.358974358974359,1
"14946","SH3RF1",33,47,80,0.5875,0.4125,1
"14947","SH3RF2",33,81,114,0.710526315789474,0.289473684210526,1
"14948","SH3RF3",20,38,58,0.655172413793103,0.344827586206897,1
"14949","SH3TC1",53,60,113,0.530973451327434,0.469026548672566,1
"14950","SH3TC2",48,73,121,0.603305785123967,0.396694214876033,1
"14951","SH3YL1",13,19,32,0.59375,0.40625,1
"14952","SHANK1",94,134,228,0.587719298245614,0.412280701754386,0.44
"14953","SHANK2",71,145,216,0.671296296296296,0.328703703703704,0.21
"14954","SHANK3",21,60,81,0.740740740740741,0.259259259259259,0.14
"14955","SHARPIN",8,11,19,0.578947368421053,0.421052631578947,0.77
"14956","SHB",15,22,37,0.594594594594595,0.405405405405405,1
"14957","SHBG",12,29,41,0.707317073170732,0.292682926829268,1
"14958","SHC1",42,34,76,0.447368421052632,0.552631578947368,1
"14959","SHC2",13,26,39,0.666666666666667,0.333333333333333,1
"14960","SHC3",17,50,67,0.746268656716418,0.253731343283582,1
"14961","SHC4",23,37,60,0.616666666666667,0.383333333333333,1
"14962","SHCBP1",17,26,43,0.604651162790698,0.395348837209302,1
"14963","SHCBP1L",34,48,82,0.585365853658537,0.414634146341463,1
"14964","SHD",12,21,33,0.636363636363636,0.363636363636364,1
"14965","SHE",15,32,47,0.680851063829787,0.319148936170213,1
"14966","SHF",9,20,29,0.689655172413793,0.310344827586207,1
"14967","SHFL",6,10,16,0.625,0.375,1
"14968","SHH",13,26,39,0.666666666666667,0.333333333333333,1
"14969","SHISA2",13,19,32,0.59375,0.40625,1
"14970","SHISA3",11,15,26,0.576923076923077,0.423076923076923,1
"14971","SHISA4",6,7,13,0.538461538461538,0.461538461538462,1
"14972","SHISA5",7,9,16,0.5625,0.4375,1
"14973","SHISA6",0,4,4,1,0,1
"14974","SHISA7",0,1,1,1,0,1
"14975","SHISA9",0,1,1,1,0,1
"14976","SHISAL1",13,21,34,0.617647058823529,0.382352941176471,1
"14977","SHISAL2A",5,8,13,0.615384615384615,0.384615384615385,1
"14978","SHKBP1",30,35,65,0.538461538461538,0.461538461538462,1
"14979","SHLD1",7,17,24,0.708333333333333,0.291666666666667,1
"14980","SHLD2",24,24,48,0.5,0.5,1
"14981","SHLD2P1",0,1,1,1,0,1
"14982","SHMT1",14,18,32,0.5625,0.4375,1
"14983","SHMT2",26,17,43,0.395348837209302,0.604651162790698,1
"14984","SHOC1",43,81,124,0.653225806451613,0.346774193548387,1
"14985","SHOC2",15,32,47,0.680851063829787,0.319148936170213,1
"14986","SHOX",20,48,68,0.705882352941177,0.294117647058824,1
"14987","SHOX2",15,35,50,0.7,0.3,1
"14988","SHPK",17,12,29,0.413793103448276,0.586206896551724,1
"14989","SHPRH",72,125,197,0.634517766497462,0.365482233502538,1
"14990","SHQ1",18,23,41,0.560975609756098,0.439024390243902,1
"14991","SHROOM1",15,28,43,0.651162790697674,0.348837209302326,1
"14992","SHROOM2",77,40,117,0.341880341880342,0.658119658119658,1
"14993","SHROOM3",80,126,206,0.611650485436893,0.388349514563107,1
"14994","SHROOM4",90,60,150,0.4,0.6,1
"14995","SHTN1",16,34,50,0.68,0.32,1
"14996","SI",179,355,534,0.664794007490637,0.335205992509363,1
"14997","SIAE",14,18,32,0.5625,0.4375,1
"14998","SIAH1",5,14,19,0.736842105263158,0.263157894736842,1
"14999","SIAH1P1",2,3,5,0.6,0.4,1
"15000","SIAH2",11,29,40,0.725,0.275,1
"15001","SIAH3",13,32,45,0.711111111111111,0.288888888888889,1
"15002","SIDT1",43,51,94,0.542553191489362,0.457446808510638,1
"15003","SIDT2",30,32,62,0.516129032258065,0.483870967741935,1
"15004","SIGIRR",9,18,27,0.666666666666667,0.333333333333333,1
"15005","SIGLEC1",63,130,193,0.673575129533679,0.326424870466321,1
"15006","SIGLEC10",52,89,141,0.631205673758865,0.368794326241135,1
"15007","SIGLEC11",31,58,89,0.651685393258427,0.348314606741573,1
"15008","SIGLEC12",45,76,121,0.628099173553719,0.371900826446281,1
"15009","SIGLEC14",17,46,63,0.73015873015873,0.26984126984127,1
"15010","SIGLEC15",7,8,15,0.533333333333333,0.466666666666667,1
"15011","SIGLEC5",29,65,94,0.691489361702128,0.308510638297872,1
"15012","SIGLEC6",32,77,109,0.706422018348624,0.293577981651376,1
"15013","SIGLEC7",31,55,86,0.63953488372093,0.36046511627907,1
"15014","SIGLEC8",50,78,128,0.609375,0.390625,1
"15015","SIGLEC9",26,73,99,0.737373737373737,0.262626262626263,1
"15016","SIGLECL1",19,41,60,0.683333333333333,0.316666666666667,1
"15017","SIGMAR1",3,5,8,0.625,0.375,0.77
"15018","SIK2",24,45,69,0.652173913043478,0.347826086956522,1
"15019","SIK3",29,68,97,0.701030927835051,0.298969072164948,1
"15020","SIKE1",10,5,15,0.333333333333333,0.666666666666667,1
"15021","SIL1",18,13,31,0.419354838709677,0.580645161290323,1
"15022","SIM1",59,116,175,0.662857142857143,0.337142857142857,1
"15023","SIM2",22,25,47,0.531914893617021,0.468085106382979,1
"15024","SIMC1",26,40,66,0.606060606060606,0.393939393939394,1
"15025","SIN3A",50,93,143,0.65034965034965,0.34965034965035,1
"15026","SIN3B",35,47,82,0.573170731707317,0.426829268292683,1
"15027","SINHCAF",13,11,24,0.458333333333333,0.541666666666667,1
"15028","SIPA1",23,37,60,0.616666666666667,0.383333333333333,1
"15029","SIPA1L1",97,142,239,0.594142259414226,0.405857740585774,1
"15030","SIPA1L2",92,145,237,0.611814345991561,0.388185654008439,1
"15031","SIPA1L3",66,115,181,0.635359116022099,0.364640883977901,1
"15032","SIRPA",23,24,47,0.51063829787234,0.48936170212766,1
"15033","SIRPB1",37,67,104,0.644230769230769,0.355769230769231,1
"15034","SIRPB2",11,22,33,0.666666666666667,0.333333333333333,1
"15035","SIRPD",10,32,42,0.761904761904762,0.238095238095238,1
"15036","SIRPG",25,67,92,0.728260869565217,0.271739130434783,1
"15037","SIRT1",20,33,53,0.622641509433962,0.377358490566038,1
"15038","SIRT2",10,15,25,0.6,0.4,1
"15039","SIRT3",10,13,23,0.565217391304348,0.434782608695652,1
"15040","SIRT4",11,21,32,0.65625,0.34375,1
"15041","SIRT5",9,13,22,0.590909090909091,0.409090909090909,1
"15042","SIRT6",8,8,16,0.5,0.5,1
"15043","SIRT7",15,18,33,0.545454545454545,0.454545454545455,1
"15044","SIT1",13,5,18,0.277777777777778,0.722222222222222,1
"15045","SIVA1",3,7,10,0.7,0.3,1
"15046","SIX1",11,14,25,0.56,0.44,1
"15047","SIX2",16,21,37,0.567567567567568,0.432432432432432,1
"15048","SIX3",9,18,27,0.666666666666667,0.333333333333333,1
"15049","SIX4",27,56,83,0.674698795180723,0.325301204819277,1
"15050","SIX5",16,14,30,0.466666666666667,0.533333333333333,1
"15051","SIX6",12,25,37,0.675675675675676,0.324324324324324,1
"15052","SKA1",5,11,16,0.6875,0.3125,1
"15053","SKA2",3,3,6,0.5,0.5,1
"15054","SKA2P1",0,2,2,1,0,1
"15055","SKA3",20,21,41,0.51219512195122,0.48780487804878,1
"15056","SKAP1",31,38,69,0.550724637681159,0.449275362318841,1
"15057","SKAP2",9,35,44,0.795454545454545,0.204545454545455,1
"15058","SKI",17,14,31,0.451612903225806,0.548387096774194,1
"15059","SKIDA1",21,34,55,0.618181818181818,0.381818181818182,1
"15060","SKIL",17,40,57,0.701754385964912,0.298245614035088,1
"15061","SKIV2L",42,58,100,0.58,0.42,1
"15062","SKOR1",19,27,46,0.58695652173913,0.41304347826087,1
"15063","SKP1",8,8,16,0.5,0.5,1
"15064","SKP2",7,25,32,0.78125,0.21875,1
"15065","SLA",20,24,44,0.545454545454545,0.454545454545455,1
"15066","SLA2",8,16,24,0.666666666666667,0.333333333333333,1
"15067","SLAIN1",12,25,37,0.675675675675676,0.324324324324324,1
"15068","SLAIN2",14,27,41,0.658536585365854,0.341463414634146,1
"15069","SLAMF1",21,37,58,0.637931034482759,0.362068965517241,1
"15070","SLAMF6",25,37,62,0.596774193548387,0.403225806451613,1
"15071","SLAMF7",16,30,46,0.652173913043478,0.347826086956522,1
"15072","SLAMF8",16,39,55,0.709090909090909,0.290909090909091,1
"15073","SLAMF9",20,36,56,0.642857142857143,0.357142857142857,1
"15074","SLBP",9,7,16,0.4375,0.5625,1
"15075","SLC10A1",6,20,26,0.769230769230769,0.230769230769231,1
"15076","SLC10A2",38,63,101,0.623762376237624,0.376237623762376,1
"15077","SLC10A3",23,15,38,0.394736842105263,0.605263157894737,1
"15078","SLC10A4",21,16,37,0.432432432432432,0.567567567567568,1
"15079","SLC10A5",19,23,42,0.547619047619048,0.452380952380952,1
"15080","SLC10A6",14,34,48,0.708333333333333,0.291666666666667,1
"15081","SLC10A7",8,31,39,0.794871794871795,0.205128205128205,1
"15082","SLC11A1",27,39,66,0.590909090909091,0.409090909090909,1
"15083","SLC11A2",17,17,34,0.5,0.5,1
"15084","SLC12A1",46,119,165,0.721212121212121,0.278787878787879,1
"15085","SLC12A2",35,76,111,0.684684684684685,0.315315315315315,1
"15086","SLC12A3",39,63,102,0.617647058823529,0.382352941176471,1
"15087","SLC12A4",29,46,75,0.613333333333333,0.386666666666667,1
"15088","SLC12A5",78,148,226,0.654867256637168,0.345132743362832,1
"15089","SLC12A6",50,68,118,0.576271186440678,0.423728813559322,1
"15090","SLC12A7",50,76,126,0.603174603174603,0.396825396825397,1
"15091","SLC12A8",24,39,63,0.619047619047619,0.380952380952381,1
"15092","SLC12A9",42,55,97,0.56701030927835,0.43298969072165,1
"15093","SLC13A1",39,85,124,0.685483870967742,0.314516129032258,1
"15094","SLC13A2",25,39,64,0.609375,0.390625,1
"15095","SLC13A3",26,63,89,0.707865168539326,0.292134831460674,1
"15096","SLC13A4",20,51,71,0.71830985915493,0.28169014084507,1
"15097","SLC13A5",18,39,57,0.684210526315789,0.315789473684211,1
"15098","SLC14A1",18,44,62,0.709677419354839,0.290322580645161,1
"15099","SLC14A2",58,80,138,0.579710144927536,0.420289855072464,1
"15100","SLC15A1",23,61,84,0.726190476190476,0.273809523809524,1
"15101","SLC15A2",39,103,142,0.725352112676056,0.274647887323944,1
"15102","SLC15A3",13,22,35,0.628571428571429,0.371428571428571,1
"15103","SLC15A4",10,32,42,0.761904761904762,0.238095238095238,1
"15104","SLC16A1",32,35,67,0.522388059701492,0.477611940298507,1
"15105","SLC16A10",19,33,52,0.634615384615385,0.365384615384615,1
"15106","SLC16A11",10,3,13,0.230769230769231,0.769230769230769,1
"15107","SLC16A12",22,32,54,0.592592592592593,0.407407407407407,1
"15108","SLC16A13",13,16,29,0.551724137931034,0.448275862068966,1
"15109","SLC16A14",29,50,79,0.632911392405063,0.367088607594937,1
"15110","SLC16A2",19,15,34,0.441176470588235,0.558823529411765,1
"15111","SLC16A3",7,15,22,0.681818181818182,0.318181818181818,1
"15112","SLC16A4",10,20,30,0.666666666666667,0.333333333333333,1
"15113","SLC16A5",20,20,40,0.5,0.5,1
"15114","SLC16A6",22,34,56,0.607142857142857,0.392857142857143,1
"15115","SLC16A7",32,36,68,0.529411764705882,0.470588235294118,1
"15116","SLC16A8",5,15,20,0.75,0.25,1
"15117","SLC16A9",24,47,71,0.661971830985915,0.338028169014085,1
"15118","SLC17A1",24,46,70,0.657142857142857,0.342857142857143,1
"15119","SLC17A2",25,42,67,0.626865671641791,0.373134328358209,1
"15120","SLC17A3",30,53,83,0.63855421686747,0.36144578313253,1
"15121","SLC17A4",25,52,77,0.675324675324675,0.324675324675325,1
"15122","SLC17A5",20,31,51,0.607843137254902,0.392156862745098,1
"15123","SLC17A6",49,133,182,0.730769230769231,0.269230769230769,1
"15124","SLC17A7",24,38,62,0.612903225806452,0.387096774193548,1
"15125","SLC17A8",49,76,125,0.608,0.392,1
"15126","SLC17A9",22,35,57,0.614035087719298,0.385964912280702,1
"15127","SLC18A1",28,46,74,0.621621621621622,0.378378378378378,1
"15128","SLC18A2",26,45,71,0.633802816901408,0.366197183098592,1
"15129","SLC18A3",35,52,87,0.597701149425287,0.402298850574713,1
"15130","SLC18B1",9,25,34,0.735294117647059,0.264705882352941,1
"15131","SLC19A1",16,25,41,0.609756097560976,0.390243902439024,1
"15132","SLC19A2",21,27,48,0.5625,0.4375,1
"15133","SLC19A3",7,40,47,0.851063829787234,0.148936170212766,1
"15134","SLC1A1",25,34,59,0.576271186440678,0.423728813559322,1
"15135","SLC1A2",30,33,63,0.523809523809524,0.476190476190476,1
"15136","SLC1A3",31,55,86,0.63953488372093,0.36046511627907,1
"15137","SLC1A4",13,12,25,0.48,0.52,1
"15138","SLC1A5",11,23,34,0.676470588235294,0.323529411764706,1
"15139","SLC1A6",63,68,131,0.519083969465649,0.480916030534351,1
"15140","SLC1A7",17,34,51,0.666666666666667,0.333333333333333,1
"15141","SLC20A1",22,33,55,0.6,0.4,1
"15142","SLC20A2",16,34,50,0.68,0.32,1
"15143","SLC22A1",8,31,39,0.794871794871795,0.205128205128205,1
"15144","SLC22A10",20,67,87,0.770114942528736,0.229885057471264,1
"15145","SLC22A11",29,33,62,0.532258064516129,0.467741935483871,1
"15146","SLC22A12",23,46,69,0.666666666666667,0.333333333333333,1
"15147","SLC22A13",17,28,45,0.622222222222222,0.377777777777778,1
"15148","SLC22A14",22,43,65,0.661538461538462,0.338461538461538,1
"15149","SLC22A15",12,29,41,0.707317073170732,0.292682926829268,1
"15150","SLC22A16",37,68,105,0.647619047619048,0.352380952380952,1
"15151","SLC22A17",29,41,70,0.585714285714286,0.414285714285714,1
"15152","SLC22A18",8,8,16,0.5,0.5,1
"15153","SLC22A2",34,62,96,0.645833333333333,0.354166666666667,1
"15154","SLC22A20P",13,35,48,0.729166666666667,0.270833333333333,1
"15155","SLC22A23",17,24,41,0.585365853658537,0.414634146341463,1
"15156","SLC22A24",0,4,4,1,0,1
"15157","SLC22A25",22,63,85,0.741176470588235,0.258823529411765,1
"15158","SLC22A3",26,27,53,0.509433962264151,0.490566037735849,1
"15159","SLC22A4",15,25,40,0.625,0.375,1
"15160","SLC22A5",14,18,32,0.5625,0.4375,1
"15161","SLC22A6",35,58,93,0.623655913978495,0.376344086021505,1
"15162","SLC22A7",39,47,86,0.546511627906977,0.453488372093023,1
"15163","SLC22A8",35,50,85,0.588235294117647,0.411764705882353,1
"15164","SLC22A9",29,78,107,0.728971962616822,0.271028037383178,1
"15165","SLC23A1",21,31,52,0.596153846153846,0.403846153846154,1
"15166","SLC23A2",30,40,70,0.571428571428571,0.428571428571429,1
"15167","SLC23A3",12,33,45,0.733333333333333,0.266666666666667,1
"15168","SLC24A1",19,46,65,0.707692307692308,0.292307692307692,1
"15169","SLC24A2",48,72,120,0.6,0.4,1
"15170","SLC24A3",44,68,112,0.607142857142857,0.392857142857143,1
"15171","SLC24A4",34,52,86,0.604651162790698,0.395348837209302,1
"15172","SLC24A5",20,38,58,0.655172413793103,0.344827586206897,1
"15173","SLC25A1",7,7,14,0.5,0.5,1
"15174","SLC25A10",8,10,18,0.555555555555556,0.444444444444444,1
"15175","SLC25A11",9,18,27,0.666666666666667,0.333333333333333,1
"15176","SLC25A12",35,41,76,0.539473684210526,0.460526315789474,1
"15177","SLC25A13",19,62,81,0.765432098765432,0.234567901234568,1
"15178","SLC25A14",27,12,39,0.307692307692308,0.692307692307692,1
"15179","SLC25A15",3,11,14,0.785714285714286,0.214285714285714,1
"15180","SLC25A16",6,20,26,0.769230769230769,0.230769230769231,1
"15181","SLC25A17",13,20,33,0.606060606060606,0.393939393939394,1
"15182","SLC25A18",7,22,29,0.758620689655172,0.241379310344828,1
"15183","SLC25A19",8,18,26,0.692307692307692,0.307692307692308,1
"15184","SLC25A2",24,32,56,0.571428571428571,0.428571428571429,1
"15185","SLC25A20",3,15,18,0.833333333333333,0.166666666666667,1
"15186","SLC25A21",16,21,37,0.567567567567568,0.432432432432432,1
"15187","SLC25A22",6,15,21,0.714285714285714,0.285714285714286,1
"15188","SLC25A23",14,21,35,0.6,0.4,1
"15189","SLC25A24",16,23,39,0.58974358974359,0.41025641025641,1
"15190","SLC25A25",19,23,42,0.547619047619048,0.452380952380952,1
"15191","SLC25A26",8,4,12,0.333333333333333,0.666666666666667,1
"15192","SLC25A27",6,14,20,0.7,0.3,1
"15193","SLC25A28",13,11,24,0.458333333333333,0.541666666666667,1
"15194","SLC25A29",2,3,5,0.6,0.4,1
"15195","SLC25A3",17,21,38,0.552631578947368,0.447368421052632,1
"15196","SLC25A30",13,12,25,0.48,0.52,1
"15197","SLC25A31",22,33,55,0.6,0.4,1
"15198","SLC25A32",10,19,29,0.655172413793103,0.344827586206897,1
"15199","SLC25A33",4,14,18,0.777777777777778,0.222222222222222,1
"15200","SLC25A34",9,16,25,0.64,0.36,1
"15201","SLC25A35",5,10,15,0.666666666666667,0.333333333333333,1
"15202","SLC25A36",10,23,33,0.696969696969697,0.303030303030303,1
"15203","SLC25A37",16,17,33,0.515151515151515,0.484848484848485,1
"15204","SLC25A38",11,20,31,0.645161290322581,0.354838709677419,1
"15205","SLC25A39",9,23,32,0.71875,0.28125,1
"15206","SLC25A4",9,7,16,0.4375,0.5625,1
"15207","SLC25A40",10,25,35,0.714285714285714,0.285714285714286,1
"15208","SLC25A41",15,20,35,0.571428571428571,0.428571428571429,1
"15209","SLC25A42",10,21,31,0.67741935483871,0.32258064516129,1
"15210","SLC25A43",14,3,17,0.176470588235294,0.823529411764706,1
"15211","SLC25A44",9,10,19,0.526315789473684,0.473684210526316,1
"15212","SLC25A45",13,15,28,0.535714285714286,0.464285714285714,1
"15213","SLC25A46",10,30,40,0.75,0.25,1
"15214","SLC25A47",15,23,38,0.605263157894737,0.394736842105263,1
"15215","SLC25A48",12,14,26,0.538461538461538,0.461538461538462,1
"15216","SLC25A5",9,14,23,0.608695652173913,0.391304347826087,1
"15217","SLC25A51",10,13,23,0.565217391304348,0.434782608695652,1
"15218","SLC25A52",9,28,37,0.756756756756757,0.243243243243243,1
"15219","SLC25A53",16,17,33,0.515151515151515,0.484848484848485,1
"15220","SLC25A6",6,20,26,0.769230769230769,0.230769230769231,1
"15221","SLC26A1",10,22,32,0.6875,0.3125,1
"15222","SLC26A11",29,36,65,0.553846153846154,0.446153846153846,1
"15223","SLC26A2",36,24,60,0.4,0.6,1
"15224","SLC26A3",56,76,132,0.575757575757576,0.424242424242424,1
"15225","SLC26A4",34,65,99,0.656565656565657,0.343434343434343,1
"15226","SLC26A5",35,78,113,0.690265486725664,0.309734513274336,1
"15227","SLC26A6",16,29,45,0.644444444444444,0.355555555555556,1
"15228","SLC26A7",61,87,148,0.587837837837838,0.412162162162162,1
"15229","SLC26A8",37,74,111,0.666666666666667,0.333333333333333,1
"15230","SLC26A9",37,65,102,0.637254901960784,0.362745098039216,1
"15231","SLC27A1",34,29,63,0.46031746031746,0.53968253968254,1
"15232","SLC27A2",19,57,76,0.75,0.25,1
"15233","SLC27A3",29,30,59,0.508474576271186,0.491525423728814,1
"15234","SLC27A4",15,30,45,0.666666666666667,0.333333333333333,1
"15235","SLC27A5",32,42,74,0.567567567567568,0.432432432432432,1
"15236","SLC27A6",61,101,162,0.623456790123457,0.376543209876543,1
"15237","SLC28A1",22,53,75,0.706666666666667,0.293333333333333,1
"15238","SLC28A2",23,46,69,0.666666666666667,0.333333333333333,1
"15239","SLC28A3",34,34,68,0.5,0.5,1
"15240","SLC29A1",8,31,39,0.794871794871795,0.205128205128205,1
"15241","SLC29A2",19,23,42,0.547619047619048,0.452380952380952,1
"15242","SLC29A3",12,34,46,0.739130434782609,0.260869565217391,1
"15243","SLC29A4",25,40,65,0.615384615384615,0.384615384615385,1
"15244","SLC2A1",13,24,37,0.648648648648649,0.351351351351351,1
"15245","SLC2A10",30,47,77,0.61038961038961,0.38961038961039,1
"15246","SLC2A11",8,17,25,0.68,0.32,1
"15247","SLC2A12",18,40,58,0.689655172413793,0.310344827586207,1
"15248","SLC2A13",31,44,75,0.586666666666667,0.413333333333333,1
"15249","SLC2A14",33,59,92,0.641304347826087,0.358695652173913,1
"15250","SLC2A2",34,48,82,0.585365853658537,0.414634146341463,1
"15251","SLC2A3",21,46,67,0.686567164179104,0.313432835820896,1
"15252","SLC2A4",23,36,59,0.610169491525424,0.389830508474576,1
"15253","SLC2A4RG",8,12,20,0.6,0.4,1
"15254","SLC2A5",17,33,50,0.66,0.34,1
"15255","SLC2A6",17,24,41,0.585365853658537,0.414634146341463,1
"15256","SLC2A7",15,27,42,0.642857142857143,0.357142857142857,1
"15257","SLC2A8",9,11,20,0.55,0.45,1
"15258","SLC2A9",31,35,66,0.53030303030303,0.46969696969697,1
"15259","SLC30A1",21,20,41,0.48780487804878,0.51219512195122,1
"15260","SLC30A10",26,33,59,0.559322033898305,0.440677966101695,1
"15261","SLC30A2",6,17,23,0.739130434782609,0.260869565217391,1
"15262","SLC30A3",19,47,66,0.712121212121212,0.287878787878788,1
"15263","SLC30A4",5,28,33,0.848484848484849,0.151515151515152,1
"15264","SLC30A5",9,15,24,0.625,0.375,1
"15265","SLC30A6",17,31,48,0.645833333333333,0.354166666666667,1
"15266","SLC30A7",9,16,25,0.64,0.36,1
"15267","SLC30A8",38,66,104,0.634615384615385,0.365384615384615,1
"15268","SLC30A9",26,43,69,0.623188405797101,0.376811594202899,1
"15269","SLC31A1",2,7,9,0.777777777777778,0.222222222222222,1
"15270","SLC31A2",2,3,5,0.6,0.4,1
"15271","SLC32A1",40,69,109,0.63302752293578,0.36697247706422,1
"15272","SLC33A1",15,29,44,0.659090909090909,0.340909090909091,1
"15273","SLC34A1",31,40,71,0.563380281690141,0.436619718309859,1
"15274","SLC34A2",37,68,105,0.647619047619048,0.352380952380952,1
"15275","SLC34A3",11,30,41,0.731707317073171,0.268292682926829,1
"15276","SLC35A1",2,10,12,0.833333333333333,0.166666666666667,1
"15277","SLC35A2",15,7,22,0.318181818181818,0.681818181818182,1
"15278","SLC35A3",1,1,2,0.5,0.5,1
"15279","SLC35A4",14,13,27,0.481481481481481,0.518518518518518,1
"15280","SLC35A5",16,24,40,0.6,0.4,1
"15281","SLC35B1",11,23,34,0.676470588235294,0.323529411764706,1
"15282","SLC35B2",6,24,30,0.8,0.2,1
"15283","SLC35B3",12,15,27,0.555555555555556,0.444444444444444,1
"15284","SLC35B4",8,14,22,0.636363636363636,0.363636363636364,1
"15285","SLC35C1",12,8,20,0.4,0.6,1
"15286","SLC35C2",14,26,40,0.65,0.35,1
"15287","SLC35D1",10,11,21,0.523809523809524,0.476190476190476,1
"15288","SLC35D2",7,7,14,0.5,0.5,1
"15289","SLC35D3",14,21,35,0.6,0.4,1
"15290","SLC35E1",7,5,12,0.416666666666667,0.583333333333333,1
"15291","SLC35E2A",8,13,21,0.619047619047619,0.380952380952381,1
"15292","SLC35E2B",1,0,1,0,1,1
"15293","SLC35E3",9,15,24,0.625,0.375,1
"15294","SLC35E4",13,15,28,0.535714285714286,0.464285714285714,1
"15295","SLC35F1",21,50,71,0.704225352112676,0.295774647887324,1
"15296","SLC35F2",9,18,27,0.666666666666667,0.333333333333333,1
"15297","SLC35F3",28,62,90,0.688888888888889,0.311111111111111,1
"15298","SLC35F4",27,48,75,0.64,0.36,1
"15299","SLC35F5",20,26,46,0.565217391304348,0.434782608695652,1
"15300","SLC35F6",7,12,19,0.631578947368421,0.368421052631579,1
"15301","SLC35G1",12,14,26,0.538461538461538,0.461538461538462,1
"15302","SLC35G2",27,30,57,0.526315789473684,0.473684210526316,1
"15303","SLC35G3",32,34,66,0.515151515151515,0.484848484848485,1
"15304","SLC35G5",22,22,44,0.5,0.5,1
"15305","SLC35G6",7,11,18,0.611111111111111,0.388888888888889,1
"15306","SLC36A1",24,31,55,0.563636363636364,0.436363636363636,1
"15307","SLC36A2",18,34,52,0.653846153846154,0.346153846153846,1
"15308","SLC36A3",17,31,48,0.645833333333333,0.354166666666667,1
"15309","SLC36A4",17,30,47,0.638297872340426,0.361702127659574,1
"15310","SLC37A1",20,25,45,0.555555555555556,0.444444444444444,1
"15311","SLC37A2",6,31,37,0.837837837837838,0.162162162162162,1
"15312","SLC37A3",15,21,36,0.583333333333333,0.416666666666667,1
"15313","SLC37A4",7,16,23,0.695652173913043,0.304347826086957,1
"15314","SLC38A1",22,56,78,0.717948717948718,0.282051282051282,1
"15315","SLC38A10",34,55,89,0.617977528089888,0.382022471910112,1
"15316","SLC38A11",22,27,49,0.551020408163265,0.448979591836735,1
"15317","SLC38A2",9,30,39,0.769230769230769,0.230769230769231,1
"15318","SLC38A3",18,26,44,0.590909090909091,0.409090909090909,1
"15319","SLC38A4",35,64,99,0.646464646464647,0.353535353535354,1
"15320","SLC38A5",19,14,33,0.424242424242424,0.575757575757576,1
"15321","SLC38A6",20,26,46,0.565217391304348,0.434782608695652,1
"15322","SLC38A7",15,19,34,0.558823529411765,0.441176470588235,1
"15323","SLC38A8",26,32,58,0.551724137931034,0.448275862068966,1
"15324","SLC38A9",16,28,44,0.636363636363636,0.363636363636364,1
"15325","SLC39A1",7,18,25,0.72,0.28,1
"15326","SLC39A10",38,50,88,0.568181818181818,0.431818181818182,1
"15327","SLC39A11",12,23,35,0.657142857142857,0.342857142857143,1
"15328","SLC39A12",59,131,190,0.689473684210526,0.310526315789474,1
"15329","SLC39A13",9,14,23,0.608695652173913,0.391304347826087,1
"15330","SLC39A14",14,12,26,0.461538461538462,0.538461538461538,1
"15331","SLC39A2",7,23,30,0.766666666666667,0.233333333333333,1
"15332","SLC39A3",9,26,35,0.742857142857143,0.257142857142857,1
"15333","SLC39A4",21,26,47,0.553191489361702,0.446808510638298,1
"15334","SLC39A5",16,32,48,0.666666666666667,0.333333333333333,1
"15335","SLC39A6",27,38,65,0.584615384615385,0.415384615384615,1
"15336","SLC39A7",15,28,43,0.651162790697674,0.348837209302326,1
"15337","SLC39A8",12,21,33,0.636363636363636,0.363636363636364,1
"15338","SLC39A9",9,10,19,0.526315789473684,0.473684210526316,1
"15339","SLC3A1",23,44,67,0.656716417910448,0.343283582089552,1
"15340","SLC3A2",46,45,91,0.494505494505495,0.505494505494505,1
"15341","SLC40A1",14,28,42,0.666666666666667,0.333333333333333,1
"15342","SLC41A1",17,24,41,0.585365853658537,0.414634146341463,1
"15343","SLC41A2",13,31,44,0.704545454545455,0.295454545454545,1
"15344","SLC41A3",22,21,43,0.488372093023256,0.511627906976744,1
"15345","SLC43A1",13,24,37,0.648648648648649,0.351351351351351,1
"15346","SLC43A2",20,24,44,0.545454545454545,0.454545454545455,1
"15347","SLC43A3",22,28,50,0.56,0.44,1
"15348","SLC44A1",27,38,65,0.584615384615385,0.415384615384615,1
"15349","SLC44A2",28,44,72,0.611111111111111,0.388888888888889,1
"15350","SLC44A3",23,41,64,0.640625,0.359375,1
"15351","SLC44A4",42,28,70,0.4,0.6,1
"15352","SLC44A5",59,100,159,0.628930817610063,0.371069182389937,1
"15353","SLC45A1",34,49,83,0.590361445783133,0.409638554216867,1
"15354","SLC45A2",29,50,79,0.632911392405063,0.367088607594937,1
"15355","SLC45A3",23,22,45,0.488888888888889,0.511111111111111,1
"15356","SLC45A4",30,60,90,0.666666666666667,0.333333333333333,1
"15357","SLC46A1",8,19,27,0.703703703703704,0.296296296296296,1
"15358","SLC46A2",16,27,43,0.627906976744186,0.372093023255814,1
"15359","SLC46A3",27,34,61,0.557377049180328,0.442622950819672,1
"15360","SLC47A1",17,40,57,0.701754385964912,0.298245614035088,1
"15361","SLC47A2",15,25,40,0.625,0.375,1
"15362","SLC48A1",0,1,1,1,0,1
"15363","SLC49A3",17,26,43,0.604651162790698,0.395348837209302,1
"15364","SLC49A4",10,22,32,0.6875,0.3125,1
"15365","SLC4A1",56,76,132,0.575757575757576,0.424242424242424,1
"15366","SLC4A10",55,102,157,0.64968152866242,0.35031847133758,1
"15367","SLC4A11",37,63,100,0.63,0.37,1
"15368","SLC4A1AP",27,44,71,0.619718309859155,0.380281690140845,1
"15369","SLC4A2",39,57,96,0.59375,0.40625,1
"15370","SLC4A3",76,96,172,0.558139534883721,0.441860465116279,1
"15371","SLC4A4",53,85,138,0.615942028985507,0.384057971014493,1
"15372","SLC4A5",48,73,121,0.603305785123967,0.396694214876033,1
"15373","SLC4A7",51,80,131,0.610687022900763,0.389312977099237,1
"15374","SLC4A8",38,97,135,0.718518518518519,0.281481481481481,1
"15375","SLC4A9",22,36,58,0.620689655172414,0.379310344827586,1
"15376","SLC50A1",8,8,16,0.5,0.5,1
"15377","SLC51A",14,13,27,0.481481481481481,0.518518518518518,1
"15378","SLC51B",1,3,4,0.75,0.25,1
"15379","SLC52A1",16,19,35,0.542857142857143,0.457142857142857,1
"15380","SLC52A2",18,21,39,0.538461538461538,0.461538461538462,1
"15381","SLC52A3",9,30,39,0.769230769230769,0.230769230769231,1
"15382","SLC5A1",27,47,74,0.635135135135135,0.364864864864865,1
"15383","SLC5A10",14,35,49,0.714285714285714,0.285714285714286,1
"15384","SLC5A11",37,63,100,0.63,0.37,1
"15385","SLC5A12",36,68,104,0.653846153846154,0.346153846153846,1
"15386","SLC5A2",25,32,57,0.56140350877193,0.43859649122807,1
"15387","SLC5A3",16,36,52,0.692307692307692,0.307692307692308,1
"15388","SLC5A4",24,57,81,0.703703703703704,0.296296296296296,1
"15389","SLC5A5",20,41,61,0.672131147540984,0.327868852459016,1
"15390","SLC5A6",25,41,66,0.621212121212121,0.378787878787879,1
"15391","SLC5A7",39,102,141,0.723404255319149,0.276595744680851,1
"15392","SLC5A8",47,99,146,0.678082191780822,0.321917808219178,1
"15393","SLC5A9",32,41,73,0.561643835616438,0.438356164383562,1
"15394","SLC66A1",9,16,25,0.64,0.36,1
"15395","SLC66A1L",1,4,5,0.8,0.2,1
"15396","SLC66A2",11,12,23,0.521739130434783,0.478260869565217,1
"15397","SLC66A3",7,12,19,0.631578947368421,0.368421052631579,1
"15398","SLC6A1",28,67,95,0.705263157894737,0.294736842105263,1
"15399","SLC6A11",27,69,96,0.71875,0.28125,1
"15400","SLC6A12",25,55,80,0.6875,0.3125,1
"15401","SLC6A13",36,61,97,0.628865979381443,0.371134020618557,1
"15402","SLC6A14",43,44,87,0.505747126436782,0.494252873563218,1
"15403","SLC6A15",56,83,139,0.597122302158273,0.402877697841727,1
"15404","SLC6A16",26,40,66,0.606060606060606,0.393939393939394,1
"15405","SLC6A17",33,57,90,0.633333333333333,0.366666666666667,1
"15406","SLC6A18",33,51,84,0.607142857142857,0.392857142857143,1
"15407","SLC6A19",29,67,96,0.697916666666667,0.302083333333333,1
"15408","SLC6A2",35,51,86,0.593023255813954,0.406976744186047,1
"15409","SLC6A20",19,31,50,0.62,0.38,1
"15410","SLC6A3",37,72,109,0.660550458715596,0.339449541284404,1
"15411","SLC6A4",25,57,82,0.695121951219512,0.304878048780488,1
"15412","SLC6A5",40,93,133,0.699248120300752,0.300751879699248,1
"15413","SLC6A6",23,29,52,0.557692307692308,0.442307692307692,1
"15414","SLC6A7",30,32,62,0.516129032258065,0.483870967741935,1
"15415","SLC6A8",22,8,30,0.266666666666667,0.733333333333333,1
"15416","SLC6A9",22,36,58,0.620689655172414,0.379310344827586,1
"15417","SLC7A1",17,38,55,0.690909090909091,0.309090909090909,1
"15418","SLC7A10",15,40,55,0.727272727272727,0.272727272727273,1
"15419","SLC7A11",14,29,43,0.674418604651163,0.325581395348837,1
"15420","SLC7A13",47,65,112,0.580357142857143,0.419642857142857,1
"15421","SLC7A14",42,72,114,0.631578947368421,0.368421052631579,1
"15422","SLC7A2",36,50,86,0.581395348837209,0.418604651162791,1
"15423","SLC7A3",37,41,78,0.525641025641026,0.474358974358974,1
"15424","SLC7A4",20,36,56,0.642857142857143,0.357142857142857,1
"15425","SLC7A5",19,19,38,0.5,0.5,1
"15426","SLC7A6",12,17,29,0.586206896551724,0.413793103448276,1
"15427","SLC7A6OS",3,12,15,0.8,0.2,1
"15428","SLC7A7",21,26,47,0.553191489361702,0.446808510638298,1
"15429","SLC7A8",15,29,44,0.659090909090909,0.340909090909091,1
"15430","SLC7A9",25,32,57,0.56140350877193,0.43859649122807,1
"15431","SLC8A1",87,162,249,0.650602409638554,0.349397590361446,1
"15432","SLC8A2",44,73,117,0.623931623931624,0.376068376068376,1
"15433","SLC8A3",64,152,216,0.703703703703704,0.296296296296296,1
"15434","SLC8B1",25,31,56,0.553571428571429,0.446428571428571,1
"15435","SLC9A1",31,37,68,0.544117647058823,0.455882352941176,1
"15436","SLC9A2",61,95,156,0.608974358974359,0.391025641025641,1
"15437","SLC9A3",32,51,83,0.614457831325301,0.385542168674699,1
"15438","SLC9A3R1",4,7,11,0.636363636363636,0.363636363636364,1
"15439","SLC9A3R2",5,8,13,0.615384615384615,0.384615384615385,1
"15440","SLC9A4",65,120,185,0.648648648648649,0.351351351351351,1
"15441","SLC9A5",40,39,79,0.493670886075949,0.506329113924051,1
"15442","SLC9A6",41,17,58,0.293103448275862,0.706896551724138,1
"15443","SLC9A7",38,19,57,0.333333333333333,0.666666666666667,1
"15444","SLC9A8",20,28,48,0.583333333333333,0.416666666666667,1
"15445","SLC9A9",37,66,103,0.640776699029126,0.359223300970874,1
"15446","SLC9B1",20,41,61,0.672131147540984,0.327868852459016,1
"15447","SLC9B2",23,28,51,0.549019607843137,0.450980392156863,1
"15448","SLC9C1",67,113,180,0.627777777777778,0.372222222222222,1
"15449","SLC9C2",87,160,247,0.647773279352227,0.352226720647773,1
"15450","SLCO1A2",30,78,108,0.722222222222222,0.277777777777778,1
"15451","SLCO1B1",54,116,170,0.682352941176471,0.317647058823529,1
"15452","SLCO1B3",77,112,189,0.592592592592593,0.407407407407407,1
"15453","SLCO1B3-SLCO1B7",14,19,33,0.575757575757576,0.424242424242424,1
"15454","SLCO1C1",54,111,165,0.672727272727273,0.327272727272727,1
"15455","SLCO2A1",37,72,109,0.660550458715596,0.339449541284404,1
"15456","SLCO2B1",40,46,86,0.534883720930233,0.465116279069767,1
"15457","SLCO3A1",27,48,75,0.64,0.36,1
"15458","SLCO4A1",20,42,62,0.67741935483871,0.32258064516129,1
"15459","SLCO4C1",49,82,131,0.625954198473282,0.374045801526718,1
"15460","SLCO5A1",62,117,179,0.653631284916201,0.346368715083799,1
"15461","SLCO6A1",68,124,192,0.645833333333333,0.354166666666667,1
"15462","SLF1",17,32,49,0.653061224489796,0.346938775510204,1
"15463","SLF2",36,45,81,0.555555555555556,0.444444444444444,1
"15464","SLFN11",52,96,148,0.648648648648649,0.351351351351351,1
"15465","SLFN12",28,33,61,0.540983606557377,0.459016393442623,1
"15466","SLFN12L",0,6,6,1,0,1
"15467","SLFN13",35,81,116,0.698275862068966,0.301724137931034,1
"15468","SLFN14",1,6,7,0.857142857142857,0.142857142857143,1
"15469","SLFN5",42,46,88,0.522727272727273,0.477272727272727,1
"15470","SLFNL1",8,16,24,0.666666666666667,0.333333333333333,1
"15471","SLIRP",1,4,5,0.8,0.2,1
"15472","SLIT1",66,122,188,0.648936170212766,0.351063829787234,1
"15473","SLIT2",121,252,373,0.675603217158177,0.324396782841823,1
"15474","SLIT3",96,181,277,0.653429602888087,0.346570397111913,1
"15475","SLITRK1",92,163,255,0.63921568627451,0.36078431372549,1
"15476","SLITRK2",120,114,234,0.487179487179487,0.512820512820513,1
"15477","SLITRK3",83,170,253,0.671936758893281,0.328063241106719,1
"15478","SLITRK4",99,103,202,0.50990099009901,0.49009900990099,1
"15479","SLITRK5",81,122,203,0.600985221674877,0.399014778325123,1
"15480","SLITRK6",72,141,213,0.661971830985915,0.338028169014085,1
"15481","SLK",32,61,93,0.655913978494624,0.344086021505376,1
"15482","SLMAP",16,30,46,0.652173913043478,0.347826086956522,1
"15483","SLN",3,4,7,0.571428571428571,0.428571428571429,1
"15484","SLPI",12,10,22,0.454545454545455,0.545454545454545,1
"15485","SLTM",39,54,93,0.580645161290323,0.419354838709677,1
"15486","SLU7",23,40,63,0.634920634920635,0.365079365079365,1
"15487","SLURP1",5,8,13,0.615384615384615,0.384615384615385,1
"15488","SLX1A",0,2,2,1,0,1
"15489","SLX4",68,104,172,0.604651162790698,0.395348837209302,1
"15490","SLX4IP",14,39,53,0.735849056603774,0.264150943396226,1
"15491","SMAD1",21,32,53,0.60377358490566,0.39622641509434,1
"15492","SMAD2",23,55,78,0.705128205128205,0.294871794871795,1
"15493","SMAD3",42,35,77,0.454545454545455,0.545454545454545,1
"15494","SMAD4",104,116,220,0.527272727272727,0.472727272727273,1
"15495","SMAD5",8,13,21,0.619047619047619,0.380952380952381,1
"15496","SMAD6",11,16,27,0.592592592592593,0.407407407407407,1
"15497","SMAD7",15,16,31,0.516129032258065,0.483870967741935,1
"15498","SMAD9",16,54,70,0.771428571428571,0.228571428571429,1
"15499","SMAGP",2,5,7,0.714285714285714,0.285714285714286,1
"15500","SMAP1",12,18,30,0.6,0.4,1
"15501","SMAP2",22,23,45,0.511111111111111,0.488888888888889,1
"15502","SMARCA1",63,54,117,0.461538461538462,0.538461538461538,0.24
"15503","SMARCA2",74,109,183,0.595628415300546,0.404371584699454,0.24
"15504","SMARCA4",104,192,296,0.648648648648649,0.351351351351351,0.24
"15505","SMARCA5",28,41,69,0.594202898550725,0.405797101449275,0.24
"15506","SMARCAD1",45,77,122,0.631147540983607,0.368852459016393,0.24
"15507","SMARCAL1",51,42,93,0.451612903225806,0.548387096774194,0.24
"15508","SMARCB1",25,33,58,0.568965517241379,0.431034482758621,0.24
"15509","SMARCC1",35,56,91,0.615384615384615,0.384615384615385,0.24
"15510","SMARCC2",45,77,122,0.631147540983607,0.368852459016393,0.24
"15511","SMARCD1",16,22,38,0.578947368421053,0.421052631578947,0.24
"15512","SMARCD2",15,35,50,0.7,0.3,0.24
"15513","SMARCD3",12,21,33,0.636363636363636,0.363636363636364,0.24
"15514","SMARCE1",13,23,36,0.638888888888889,0.361111111111111,0.24
"15515","SMC1A",48,49,97,0.505154639175258,0.494845360824742,1
"15516","SMC1B",49,90,139,0.647482014388489,0.352517985611511,1
"15517","SMC2",50,73,123,0.59349593495935,0.40650406504065,1
"15518","SMC3",49,59,108,0.546296296296296,0.453703703703704,1
"15519","SMC4",49,94,143,0.657342657342657,0.342657342657343,1
"15520","SMC5",40,59,99,0.595959595959596,0.404040404040404,1
"15521","SMC6",31,61,92,0.66304347826087,0.33695652173913,1
"15522","SMCHD1",76,112,188,0.595744680851064,0.404255319148936,1
"15523","SMCO1",4,12,16,0.75,0.25,1
"15524","SMCO2",0,1,1,1,0,1
"15525","SMCO3",9,11,20,0.55,0.45,1
"15526","SMCO4",1,2,3,0.666666666666667,0.333333333333333,1
"15527","SMCP",5,5,10,0.5,0.5,1
"15528","SMCR8",29,39,68,0.573529411764706,0.426470588235294,1
"15529","SMDT1",1,4,5,0.8,0.2,1
"15530","SMG1",64,148,212,0.69811320754717,0.30188679245283,1
"15531","SMG5",39,72,111,0.648648648648649,0.351351351351351,1
"15532","SMG6",36,64,100,0.64,0.36,1
"15533","SMG7",36,66,102,0.647058823529412,0.352941176470588,1
"15534","SMG8",37,77,114,0.675438596491228,0.324561403508772,1
"15535","SMG9",16,15,31,0.483870967741935,0.516129032258065,1
"15536","SMIM10",0,1,1,1,0,1
"15537","SMIM14",1,2,3,0.666666666666667,0.333333333333333,1
"15538","SMIM15",3,4,7,0.571428571428571,0.428571428571429,1
"15539","SMIM19",4,8,12,0.666666666666667,0.333333333333333,1
"15540","SMIM2",0,2,2,1,0,1
"15541","SMIM21",6,12,18,0.666666666666667,0.333333333333333,1
"15542","SMIM29",2,7,9,0.777777777777778,0.222222222222222,1
"15543","SMIM7",4,3,7,0.428571428571429,0.571428571428571,1
"15544","SMIM8",4,8,12,0.666666666666667,0.333333333333333,1
"15545","SMN1",1,0,1,0,1,1
"15546","SMN2",0,1,1,1,0,1
"15547","SMNDC1",4,7,11,0.636363636363636,0.363636363636364,1
"15548","SMO",42,44,86,0.511627906976744,0.488372093023256,1
"15549","SMOC1",31,50,81,0.617283950617284,0.382716049382716,1
"15550","SMOC2",23,35,58,0.603448275862069,0.396551724137931,1
"15551","SMOX",25,36,61,0.590163934426229,0.409836065573771,1
"15552","SMPD1",20,28,48,0.583333333333333,0.416666666666667,1
"15553","SMPD2",16,17,33,0.515151515151515,0.484848484848485,1
"15554","SMPD3",22,40,62,0.645161290322581,0.354838709677419,1
"15555","SMPD4",26,50,76,0.657894736842105,0.342105263157895,1
"15556","SMPDL3A",9,17,26,0.653846153846154,0.346153846153846,1
"15557","SMPDL3B",16,25,41,0.609756097560976,0.390243902439024,1
"15558","SMPX",4,7,11,0.636363636363636,0.363636363636364,1
"15559","SMR3A",14,30,44,0.681818181818182,0.318181818181818,1
"15560","SMR3B",11,15,26,0.576923076923077,0.423076923076923,1
"15561","SMS",17,14,31,0.451612903225806,0.548387096774194,1
"15562","SMTN",47,50,97,0.515463917525773,0.484536082474227,1
"15563","SMTNL1",16,33,49,0.673469387755102,0.326530612244898,1
"15564","SMTNL2",6,19,25,0.76,0.24,1
"15565","SMU1",12,22,34,0.647058823529412,0.352941176470588,1
"15566","SMUG1",9,17,26,0.653846153846154,0.346153846153846,1
"15567","SMURF1",23,41,64,0.640625,0.359375,1
"15568","SMURF2",24,32,56,0.571428571428571,0.428571428571429,1
"15569","SMYD1",30,63,93,0.67741935483871,0.32258064516129,1
"15570","SMYD2",12,24,36,0.666666666666667,0.333333333333333,1
"15571","SMYD3",19,33,52,0.634615384615385,0.365384615384615,1
"15572","SMYD4",10,27,37,0.72972972972973,0.27027027027027,1
"15573","SMYD5",17,22,39,0.564102564102564,0.435897435897436,1
"15574","SNAI1",14,17,31,0.548387096774194,0.451612903225806,1
"15575","SNAI2",20,28,48,0.583333333333333,0.416666666666667,1
"15576","SNAI3",11,7,18,0.388888888888889,0.611111111111111,1
"15577","SNAP23",3,8,11,0.727272727272727,0.272727272727273,1
"15578","SNAP25",17,23,40,0.575,0.425,1
"15579","SNAP29",8,11,19,0.578947368421053,0.421052631578947,1
"15580","SNAP47",20,28,48,0.583333333333333,0.416666666666667,1
"15581","SNAP91",44,102,146,0.698630136986301,0.301369863013699,1
"15582","SNAPC1",20,15,35,0.428571428571429,0.571428571428571,0.39
"15583","SNAPC2",9,15,24,0.625,0.375,0.88
"15584","SNAPC3",11,11,22,0.5,0.5,0.39
"15585","SNAPC4",41,57,98,0.581632653061224,0.418367346938776,0.39
"15586","SNAPC5",4,1,5,0.2,0.8,0.39
"15587","SNAPIN",5,2,7,0.285714285714286,0.714285714285714,1
"15588","SNCA",4,11,15,0.733333333333333,0.266666666666667,1
"15589","SNCAIP",58,121,179,0.675977653631285,0.324022346368715,1
"15590","SNCB",3,20,23,0.869565217391304,0.130434782608696,1
"15591","SNCG",2,4,6,0.666666666666667,0.333333333333333,1
"15592","SND1",50,62,112,0.553571428571429,0.446428571428571,1
"15593","SNED1",31,55,86,0.63953488372093,0.36046511627907,1
"15594","SNF8",6,12,18,0.666666666666667,0.333333333333333,1
"15595","SNIP1",22,28,50,0.56,0.44,1
"15596","SNN",1,3,4,0.75,0.25,1
"15597","SNORA22",2,0,2,0,1,1
"15598","SNORA26",4,2,6,0.333333333333333,0.666666666666667,1
"15599","SNORA60",0,2,2,1,0,1
"15600","SNORA71A",0,1,1,1,0,1
"15601","SNORA71B",3,3,6,0.5,0.5,1
"15602","SNORA71C",1,3,4,0.75,0.25,1
"15603","SNORA71D",1,2,3,0.666666666666667,0.333333333333333,1
"15604","SNORA71E",5,2,7,0.285714285714286,0.714285714285714,1
"15605","SNORA9",1,2,3,0.666666666666667,0.333333333333333,1
"15606","SNORD108",1,4,5,0.8,0.2,1
"15607","SNORD109A",3,5,8,0.625,0.375,1
"15608","SNORD109B",2,1,3,0.333333333333333,0.666666666666667,1
"15609","SNORD113-1",0,1,1,1,0,1
"15610","SNORD113-2",0,1,1,1,0,1
"15611","SNORD113-3",4,1,5,0.2,0.8,1
"15612","SNORD113-4",1,5,6,0.833333333333333,0.166666666666667,1
"15613","SNORD113-5",3,4,7,0.571428571428571,0.428571428571429,1
"15614","SNORD113-6",2,4,6,0.666666666666667,0.333333333333333,1
"15615","SNORD113-7",1,1,2,0.5,0.5,1
"15616","SNORD113-9",0,4,4,1,0,1
"15617","SNORD114-1",3,1,4,0.25,0.75,1
"15618","SNORD114-11",1,2,3,0.666666666666667,0.333333333333333,1
"15619","SNORD114-12",2,3,5,0.6,0.4,1
"15620","SNORD114-13",2,0,2,0,1,1
"15621","SNORD114-14",0,8,8,1,0,1
"15622","SNORD114-15",3,6,9,0.666666666666667,0.333333333333333,1
"15623","SNORD114-16",2,1,3,0.333333333333333,0.666666666666667,1
"15624","SNORD114-17",1,1,2,0.5,0.5,1
"15625","SNORD114-18",0,3,3,1,0,1
"15626","SNORD114-19",2,4,6,0.666666666666667,0.333333333333333,1
"15627","SNORD114-2",3,4,7,0.571428571428571,0.428571428571429,1
"15628","SNORD114-20",0,8,8,1,0,1
"15629","SNORD114-21",2,4,6,0.666666666666667,0.333333333333333,1
"15630","SNORD114-22",1,3,4,0.75,0.25,1
"15631","SNORD114-23",1,3,4,0.75,0.25,1
"15632","SNORD114-24",1,4,5,0.8,0.2,1
"15633","SNORD114-25",3,2,5,0.4,0.6,1
"15634","SNORD114-26",0,8,8,1,0,1
"15635","SNORD114-27",0,2,2,1,0,1
"15636","SNORD114-28",3,1,4,0.25,0.75,1
"15637","SNORD114-29",1,2,3,0.666666666666667,0.333333333333333,1
"15638","SNORD114-3",4,2,6,0.333333333333333,0.666666666666667,1
"15639","SNORD114-30",2,2,4,0.5,0.5,1
"15640","SNORD114-31",1,3,4,0.75,0.25,1
"15641","SNORD114-4",1,2,3,0.666666666666667,0.333333333333333,1
"15642","SNORD114-5",0,3,3,1,0,1
"15643","SNORD114-6",2,3,5,0.6,0.4,1
"15644","SNORD114-7",0,1,1,1,0,1
"15645","SNORD114-9",1,0,1,0,1,1
"15646","SNORD115-1",0,3,3,1,0,1
"15647","SNORD115-10",5,11,16,0.6875,0.3125,1
"15648","SNORD115-11",0,7,7,1,0,1
"15649","SNORD115-12",3,4,7,0.571428571428571,0.428571428571429,1
"15650","SNORD115-13",2,9,11,0.818181818181818,0.181818181818182,1
"15651","SNORD115-14",4,8,12,0.666666666666667,0.333333333333333,1
"15652","SNORD115-15",3,9,12,0.75,0.25,1
"15653","SNORD115-16",4,4,8,0.5,0.5,1
"15654","SNORD115-17",3,2,5,0.4,0.6,1
"15655","SNORD115-18",6,5,11,0.454545454545455,0.545454545454545,1
"15656","SNORD115-19",3,10,13,0.769230769230769,0.230769230769231,1
"15657","SNORD115-2",5,8,13,0.615384615384615,0.384615384615385,1
"15658","SNORD115-20",4,9,13,0.692307692307692,0.307692307692308,1
"15659","SNORD115-21",8,11,19,0.578947368421053,0.421052631578947,1
"15660","SNORD115-22",6,5,11,0.454545454545455,0.545454545454545,1
"15661","SNORD115-23",7,6,13,0.461538461538462,0.538461538461538,1
"15662","SNORD115-25",2,3,5,0.6,0.4,1
"15663","SNORD115-26",2,8,10,0.8,0.2,1
"15664","SNORD115-29",3,8,11,0.727272727272727,0.272727272727273,1
"15665","SNORD115-3",3,10,13,0.769230769230769,0.230769230769231,1
"15666","SNORD115-30",6,5,11,0.454545454545455,0.545454545454545,1
"15667","SNORD115-31",2,6,8,0.75,0.25,1
"15668","SNORD115-32",5,7,12,0.583333333333333,0.416666666666667,1
"15669","SNORD115-33",6,4,10,0.4,0.6,1
"15670","SNORD115-34",3,4,7,0.571428571428571,0.428571428571429,1
"15671","SNORD115-35",3,9,12,0.75,0.25,1
"15672","SNORD115-36",3,3,6,0.5,0.5,1
"15673","SNORD115-37",0,2,2,1,0,1
"15674","SNORD115-38",1,4,5,0.8,0.2,1
"15675","SNORD115-39",3,4,7,0.571428571428571,0.428571428571429,1
"15676","SNORD115-4",2,8,10,0.8,0.2,1
"15677","SNORD115-40",5,9,14,0.642857142857143,0.357142857142857,1
"15678","SNORD115-41",3,6,9,0.666666666666667,0.333333333333333,1
"15679","SNORD115-42",2,7,9,0.777777777777778,0.222222222222222,1
"15680","SNORD115-43",5,13,18,0.722222222222222,0.277777777777778,1
"15681","SNORD115-44",6,2,8,0.25,0.75,1
"15682","SNORD115-48",1,4,5,0.8,0.2,1
"15683","SNORD115-5",1,7,8,0.875,0.125,1
"15684","SNORD115-6",1,2,3,0.666666666666667,0.333333333333333,1
"15685","SNORD115-7",6,8,14,0.571428571428571,0.428571428571429,1
"15686","SNORD115-8",3,13,16,0.8125,0.1875,1
"15687","SNORD115-9",2,3,5,0.6,0.4,1
"15688","SNORD116-1",5,6,11,0.545454545454545,0.454545454545455,1
"15689","SNORD116-10",0,1,1,1,0,1
"15690","SNORD116-11",3,8,11,0.727272727272727,0.272727272727273,1
"15691","SNORD116-12",5,10,15,0.666666666666667,0.333333333333333,1
"15692","SNORD116-13",3,5,8,0.625,0.375,1
"15693","SNORD116-14",6,6,12,0.5,0.5,1
"15694","SNORD116-15",4,6,10,0.6,0.4,1
"15695","SNORD116-16",3,8,11,0.727272727272727,0.272727272727273,1
"15696","SNORD116-17",1,6,7,0.857142857142857,0.142857142857143,1
"15697","SNORD116-18",6,6,12,0.5,0.5,1
"15698","SNORD116-19",5,6,11,0.545454545454545,0.454545454545455,1
"15699","SNORD116-2",9,7,16,0.4375,0.5625,1
"15700","SNORD116-20",1,10,11,0.909090909090909,0.0909090909090909,1
"15701","SNORD116-21",5,5,10,0.5,0.5,1
"15702","SNORD116-22",2,6,8,0.75,0.25,1
"15703","SNORD116-23",5,3,8,0.375,0.625,1
"15704","SNORD116-24",5,6,11,0.545454545454545,0.454545454545455,1
"15705","SNORD116-25",2,10,12,0.833333333333333,0.166666666666667,1
"15706","SNORD116-26",2,6,8,0.75,0.25,1
"15707","SNORD116-27",4,3,7,0.428571428571429,0.571428571428571,1
"15708","SNORD116-28",0,6,6,1,0,1
"15709","SNORD116-29",9,10,19,0.526315789473684,0.473684210526316,1
"15710","SNORD116-3",3,4,7,0.571428571428571,0.428571428571429,1
"15711","SNORD116-4",5,13,18,0.722222222222222,0.277777777777778,1
"15712","SNORD116-5",3,11,14,0.785714285714286,0.214285714285714,1
"15713","SNORD116-6",4,11,15,0.733333333333333,0.266666666666667,1
"15714","SNORD116-7",2,7,9,0.777777777777778,0.222222222222222,1
"15715","SNORD116-8",2,10,12,0.833333333333333,0.166666666666667,1
"15716","SNORD116-9",0,6,6,1,0,1
"15717","SNORD3B-1",2,5,7,0.714285714285714,0.285714285714286,1
"15718","SNORD3B-2",2,9,11,0.818181818181818,0.181818181818182,1
"15719","SNORD3C",0,1,1,1,0,1
"15720","SNORD3D",0,3,3,1,0,1
"15721","SNORD48",0,2,2,1,0,1
"15722","SNORD52",0,2,2,1,0,1
"15723","SNORD64",1,3,4,0.75,0.25,1
"15724","SNORD88C",1,1,2,0.5,0.5,1
"15725","SNORD93",0,2,2,1,0,1
"15726","SNPH",10,36,46,0.782608695652174,0.217391304347826,1
"15727","SNRK",23,30,53,0.566037735849057,0.433962264150943,1
"15728","SNRNP200",63,88,151,0.582781456953642,0.417218543046358,1
"15729","SNRNP25",2,6,8,0.75,0.25,1
"15730","SNRNP27",5,8,13,0.615384615384615,0.384615384615385,1
"15731","SNRNP35",7,19,26,0.730769230769231,0.269230769230769,1
"15732","SNRNP40",10,16,26,0.615384615384615,0.384615384615385,1
"15733","SNRNP48",15,25,40,0.625,0.375,1
"15734","SNRNP70",13,15,28,0.535714285714286,0.464285714285714,1
"15735","SNRPA",10,24,34,0.705882352941177,0.294117647058824,1
"15736","SNRPA1",10,12,22,0.545454545454545,0.454545454545455,1
"15737","SNRPB",10,22,32,0.6875,0.3125,1
"15738","SNRPB2",4,13,17,0.764705882352941,0.235294117647059,1
"15739","SNRPC",5,9,14,0.642857142857143,0.357142857142857,1
"15740","SNRPD1",3,4,7,0.571428571428571,0.428571428571429,1
"15741","SNRPD2",5,7,12,0.583333333333333,0.416666666666667,1
"15742","SNRPD3",4,10,14,0.714285714285714,0.285714285714286,1
"15743","SNRPE",3,9,12,0.75,0.25,1
"15744","SNRPF",0,2,2,1,0,1
"15745","SNRPG",2,1,3,0.333333333333333,0.666666666666667,1
"15746","SNRPN",26,53,79,0.670886075949367,0.329113924050633,1
"15747","SNTA1",9,18,27,0.666666666666667,0.333333333333333,1
"15748","SNTB1",18,29,47,0.617021276595745,0.382978723404255,1
"15749","SNTB2",6,19,25,0.76,0.24,1
"15750","SNTG1",69,114,183,0.622950819672131,0.377049180327869,1
"15751","SNTG2",33,83,116,0.71551724137931,0.28448275862069,1
"15752","SNTN",4,11,15,0.733333333333333,0.266666666666667,1
"15753","SNU13",7,5,12,0.416666666666667,0.583333333333333,1
"15754","SNUPN",7,12,19,0.631578947368421,0.368421052631579,1
"15755","SNURF",8,11,19,0.578947368421053,0.421052631578947,1
"15756","SNURFL",0,3,3,1,0,1
"15757","SNW1",18,36,54,0.666666666666667,0.333333333333333,1
"15758","SNX1",20,25,45,0.555555555555556,0.444444444444444,1
"15759","SNX10",13,14,27,0.518518518518518,0.481481481481481,1
"15760","SNX11",11,16,27,0.592592592592593,0.407407407407407,1
"15761","SNX12",10,6,16,0.375,0.625,1
"15762","SNX13",39,57,96,0.59375,0.40625,1
"15763","SNX14",32,47,79,0.594936708860759,0.40506329113924,1
"15764","SNX15",13,18,31,0.580645161290323,0.419354838709677,1
"15765","SNX16",13,27,40,0.675,0.325,1
"15766","SNX17",15,22,37,0.594594594594595,0.405405405405405,1
"15767","SNX18",23,21,44,0.477272727272727,0.522727272727273,1
"15768","SNX19",28,56,84,0.666666666666667,0.333333333333333,1
"15769","SNX2",14,24,38,0.631578947368421,0.368421052631579,1
"15770","SNX20",8,32,40,0.8,0.2,1
"15771","SNX21",8,10,18,0.555555555555556,0.444444444444444,1
"15772","SNX22",5,8,13,0.615384615384615,0.384615384615385,1
"15773","SNX24",11,13,24,0.541666666666667,0.458333333333333,1
"15774","SNX25",45,63,108,0.583333333333333,0.416666666666667,1
"15775","SNX27",18,32,50,0.64,0.36,1
"15776","SNX29",39,56,95,0.589473684210526,0.410526315789474,1
"15777","SNX29P1",0,2,2,1,0,1
"15778","SNX29P2",6,7,13,0.538461538461538,0.461538461538462,1
"15779","SNX3",0,9,9,1,0,1
"15780","SNX30",12,20,32,0.625,0.375,1
"15781","SNX31",23,36,59,0.610169491525424,0.389830508474576,1
"15782","SNX32",19,21,40,0.525,0.475,1
"15783","SNX33",22,29,51,0.568627450980392,0.431372549019608,1
"15784","SNX4",7,14,21,0.666666666666667,0.333333333333333,1
"15785","SNX5",12,12,24,0.5,0.5,1
"15786","SNX6",9,9,18,0.5,0.5,1
"15787","SNX7",16,28,44,0.636363636363636,0.363636363636364,1
"15788","SNX8",17,15,32,0.46875,0.53125,1
"15789","SNX9",19,29,48,0.604166666666667,0.395833333333333,1
"15790","SOAT1",20,31,51,0.607843137254902,0.392156862745098,1
"15791","SOAT2",9,25,34,0.735294117647059,0.264705882352941,1
"15792","SOBP",30,44,74,0.594594594594595,0.405405405405405,1
"15793","SOCS1",5,11,16,0.6875,0.3125,1
"15794","SOCS2",6,11,17,0.647058823529412,0.352941176470588,1
"15795","SOCS3",5,15,20,0.75,0.25,1
"15796","SOCS4",11,16,27,0.592592592592593,0.407407407407407,1
"15797","SOCS5",19,40,59,0.677966101694915,0.322033898305085,1
"15798","SOCS6",30,35,65,0.538461538461538,0.461538461538462,1
"15799","SOCS7",10,17,27,0.62962962962963,0.37037037037037,1
"15800","SOD1",3,5,8,0.625,0.375,1
"15801","SOD2",15,7,22,0.318181818181818,0.681818181818182,1
"15802","SOD3",1,4,5,0.8,0.2,1
"15803","SOGA1",38,57,95,0.6,0.4,1
"15804","SOGA3",48,107,155,0.690322580645161,0.309677419354839,1
"15805","SOHLH1",7,20,27,0.740740740740741,0.259259259259259,1
"15806","SOHLH2",35,48,83,0.578313253012048,0.421686746987952,1
"15807","SON",51,91,142,0.640845070422535,0.359154929577465,1
"15808","SORBS1",36,72,108,0.666666666666667,0.333333333333333,1
"15809","SORBS2",52,85,137,0.62043795620438,0.37956204379562,1
"15810","SORBS3",12,19,31,0.612903225806452,0.387096774193548,1
"15811","SORCS1",132,173,305,0.567213114754098,0.432786885245902,1
"15812","SORCS2",27,57,84,0.678571428571429,0.321428571428571,1
"15813","SORCS3",120,232,352,0.659090909090909,0.340909090909091,1
"15814","SORD",8,13,21,0.619047619047619,0.380952380952381,1
"15815","SORL1",99,194,293,0.662116040955631,0.337883959044369,1
"15816","SORT1",19,41,60,0.683333333333333,0.316666666666667,1
"15817","SOS1",50,93,143,0.65034965034965,0.34965034965035,1
"15818","SOS2",49,80,129,0.62015503875969,0.37984496124031,1
"15819","SOST",10,13,23,0.565217391304348,0.434782608695652,1
"15820","SOSTDC1",5,11,16,0.6875,0.3125,1
"15821","SOWAHA",3,7,10,0.7,0.3,1
"15822","SOWAHB",20,40,60,0.666666666666667,0.333333333333333,1
"15823","SOWAHC",11,9,20,0.45,0.55,1
"15824","SOWAHD",16,7,23,0.304347826086957,0.695652173913043,1
"15825","SOX1",13,11,24,0.458333333333333,0.541666666666667,1
"15826","SOX10",15,43,58,0.741379310344828,0.258620689655172,1
"15827","SOX11",19,27,46,0.58695652173913,0.41304347826087,1
"15828","SOX12",5,5,10,0.5,0.5,1
"15829","SOX13",25,28,53,0.528301886792453,0.471698113207547,1
"15830","SOX14",11,22,33,0.666666666666667,0.333333333333333,1
"15831","SOX15",4,8,12,0.666666666666667,0.333333333333333,1
"15832","SOX17",23,27,50,0.54,0.46,1
"15833","SOX18",2,7,9,0.777777777777778,0.222222222222222,1
"15834","SOX2",11,20,31,0.645161290322581,0.354838709677419,1
"15835","SOX21",9,9,18,0.5,0.5,1
"15836","SOX3",29,11,40,0.275,0.725,1
"15837","SOX30",25,44,69,0.63768115942029,0.36231884057971,1
"15838","SOX4",8,10,18,0.555555555555556,0.444444444444444,1
"15839","SOX5",52,97,149,0.651006711409396,0.348993288590604,1
"15840","SOX6",49,56,105,0.533333333333333,0.466666666666667,1
"15841","SOX7",36,50,86,0.581395348837209,0.418604651162791,1
"15842","SOX8",12,18,30,0.6,0.4,1
"15843","SOX9",73,71,144,0.493055555555556,0.506944444444444,1
"15844","SP1",22,34,56,0.607142857142857,0.392857142857143,1
"15845","SP100",40,80,120,0.666666666666667,0.333333333333333,1
"15846","SP110",27,27,54,0.5,0.5,1
"15847","SP140",78,120,198,0.606060606060606,0.393939393939394,1
"15848","SP140L",23,45,68,0.661764705882353,0.338235294117647,1
"15849","SP2",15,18,33,0.545454545454545,0.454545454545455,1
"15850","SP3",17,33,50,0.66,0.34,1
"15851","SP4",31,38,69,0.550724637681159,0.449275362318841,1
"15852","SP5",6,10,16,0.625,0.375,1
"15853","SP6",13,18,31,0.580645161290323,0.419354838709677,1
"15854","SP7",19,24,43,0.558139534883721,0.441860465116279,1
"15855","SP8",8,20,28,0.714285714285714,0.285714285714286,1
"15856","SPA17",5,11,16,0.6875,0.3125,1
"15857","SPACA1",17,42,59,0.711864406779661,0.288135593220339,1
"15858","SPACA3",17,28,45,0.622222222222222,0.377777777777778,1
"15859","SPACA4",6,5,11,0.454545454545455,0.545454545454545,1
"15860","SPACA5B",3,5,8,0.625,0.375,1
"15861","SPACA7",17,17,34,0.5,0.5,1
"15862","SPACA9",7,11,18,0.611111111111111,0.388888888888889,1
"15863","SPAG1",32,49,81,0.604938271604938,0.395061728395062,1
"15864","SPAG11A",5,2,7,0.285714285714286,0.714285714285714,1
"15865","SPAG11B",6,18,24,0.75,0.25,1
"15866","SPAG16",36,93,129,0.720930232558139,0.27906976744186,1
"15867","SPAG17",140,234,374,0.625668449197861,0.374331550802139,1
"15868","SPAG4",20,16,36,0.444444444444444,0.555555555555556,1
"15869","SPAG5",33,55,88,0.625,0.375,1
"15870","SPAG6",31,43,74,0.581081081081081,0.418918918918919,1
"15871","SPAG7",9,13,22,0.590909090909091,0.409090909090909,1
"15872","SPAG8",15,14,29,0.482758620689655,0.517241379310345,1
"15873","SPAG9",45,54,99,0.545454545454545,0.454545454545455,1
"15874","SPAM1",45,86,131,0.656488549618321,0.343511450381679,1
"15875","SPANXB1",23,43,66,0.651515151515151,0.348484848484849,1
"15876","SPANXC",5,10,15,0.666666666666667,0.333333333333333,1
"15877","SPANXD",17,24,41,0.585365853658537,0.414634146341463,1
"15878","SPANXN1",13,13,26,0.5,0.5,1
"15879","SPANXN2",29,36,65,0.553846153846154,0.446153846153846,1
"15880","SPANXN3",25,27,52,0.519230769230769,0.480769230769231,1
"15881","SPANXN4",1,6,7,0.857142857142857,0.142857142857143,1
"15882","SPANXN5",9,11,20,0.55,0.45,1
"15883","SPARC",17,25,42,0.595238095238095,0.404761904761905,0.24
"15884","SPARCL1",18,50,68,0.735294117647059,0.264705882352941,0.24
"15885","SPART",44,55,99,0.555555555555556,0.444444444444444,0.77
"15886","SPAST",25,30,55,0.545454545454545,0.454545454545455,1
"15887","SPATA1",8,19,27,0.703703703703704,0.296296296296296,1
"15888","SPATA12",4,8,12,0.666666666666667,0.333333333333333,1
"15889","SPATA13",17,21,38,0.552631578947368,0.447368421052632,1
"15890","SPATA16",40,92,132,0.696969696969697,0.303030303030303,1
"15891","SPATA17",42,48,90,0.533333333333333,0.466666666666667,1
"15892","SPATA18",32,58,90,0.644444444444444,0.355555555555556,1
"15893","SPATA19",20,29,49,0.591836734693878,0.408163265306122,1
"15894","SPATA2",23,25,48,0.520833333333333,0.479166666666667,1
"15895","SPATA20",25,44,69,0.63768115942029,0.36231884057971,1
"15896","SPATA21",14,23,37,0.621621621621622,0.378378378378378,1
"15897","SPATA22",18,35,53,0.660377358490566,0.339622641509434,1
"15898","SPATA25",9,11,20,0.55,0.45,1
"15899","SPATA2L",15,13,28,0.464285714285714,0.535714285714286,1
"15900","SPATA3",0,2,2,1,0,1
"15901","SPATA31A1",92,145,237,0.611814345991561,0.388185654008439,1
"15902","SPATA31A3",37,85,122,0.69672131147541,0.30327868852459,1
"15903","SPATA31A5",0,1,1,1,0,1
"15904","SPATA31A6",1,3,4,0.75,0.25,1
"15905","SPATA31A7",0,1,1,1,0,1
"15906","SPATA31C1",2,6,8,0.75,0.25,1
"15907","SPATA31D1",99,180,279,0.645161290322581,0.354838709677419,1
"15908","SPATA31D3",0,1,1,1,0,1
"15909","SPATA31D4",0,2,2,1,0,1
"15910","SPATA31E1",80,135,215,0.627906976744186,0.372093023255814,1
"15911","SPATA32",13,18,31,0.580645161290323,0.419354838709677,1
"15912","SPATA33",4,6,10,0.6,0.4,1
"15913","SPATA4",15,28,43,0.651162790697674,0.348837209302326,1
"15914","SPATA45",6,8,14,0.571428571428571,0.428571428571429,1
"15915","SPATA46",9,11,20,0.55,0.45,1
"15916","SPATA48",0,5,5,1,0,1
"15917","SPATA5",31,56,87,0.64367816091954,0.35632183908046,1
"15918","SPATA5L1",20,21,41,0.51219512195122,0.48780487804878,1
"15919","SPATA6",15,31,46,0.673913043478261,0.326086956521739,1
"15920","SPATA6L",16,13,29,0.448275862068966,0.551724137931034,1
"15921","SPATA7",19,37,56,0.660714285714286,0.339285714285714,1
"15922","SPATA8",25,41,66,0.621212121212121,0.378787878787879,1
"15923","SPATA9",11,22,33,0.666666666666667,0.333333333333333,1
"15924","SPATC1",24,44,68,0.647058823529412,0.352941176470588,1
"15925","SPATC1L",9,7,16,0.4375,0.5625,1
"15926","SPATS1",8,27,35,0.771428571428571,0.228571428571429,1
"15927","SPATS2",14,26,40,0.65,0.35,1
"15928","SPATS2L",12,24,36,0.666666666666667,0.333333333333333,1
"15929","SPC24",0,3,3,1,0,1
"15930","SPC25",5,10,15,0.666666666666667,0.333333333333333,1
"15931","SPCS1",4,7,11,0.636363636363636,0.363636363636364,1
"15932","SPCS2",0,6,6,1,0,1
"15933","SPCS3",3,7,10,0.7,0.3,1
"15934","SPDEF",11,26,37,0.702702702702703,0.297297297297297,1
"15935","SPDL1",22,37,59,0.627118644067797,0.372881355932203,1
"15936","SPDYA",13,16,29,0.551724137931034,0.448275862068966,1
"15937","SPDYC",16,25,41,0.609756097560976,0.390243902439024,1
"15938","SPDYE1",8,16,24,0.666666666666667,0.333333333333333,1
"15939","SPDYE2",1,0,1,0,1,1
"15940","SPDYE3",11,17,28,0.607142857142857,0.392857142857143,1
"15941","SPDYE4",0,1,1,1,0,1
"15942","SPDYE5",4,16,20,0.8,0.2,1
"15943","SPDYE6",0,4,4,1,0,1
"15944","SPECC1",60,70,130,0.538461538461538,0.461538461538462,1
"15945","SPECC1L",36,45,81,0.555555555555556,0.444444444444444,1
"15946","SPEF1",7,9,16,0.5625,0.4375,1
"15947","SPEF2",137,238,375,0.634666666666667,0.365333333333333,1
"15948","SPEG",118,221,339,0.651917404129793,0.348082595870207,1
"15949","SPEM1",15,27,42,0.642857142857143,0.357142857142857,1
"15950","SPEM2",27,41,68,0.602941176470588,0.397058823529412,1
"15951","SPEN",133,208,341,0.609970674486804,0.390029325513196,1
"15952","SPESP1",18,28,46,0.608695652173913,0.391304347826087,1
"15953","SPG11",55,136,191,0.712041884816754,0.287958115183246,1
"15954","SPG21",9,14,23,0.608695652173913,0.391304347826087,1
"15955","SPG7",38,34,72,0.472222222222222,0.527777777777778,1
"15956","SPHK1",15,13,28,0.464285714285714,0.535714285714286,1
"15957","SPHK2",26,29,55,0.527272727272727,0.472727272727273,1
"15958","SPHKAP",180,356,536,0.664179104477612,0.335820895522388,1
"15959","SPI1",13,28,41,0.682926829268293,0.317073170731707,1
"15960","SPIB",13,18,31,0.580645161290323,0.419354838709677,1
"15961","SPIC",12,28,40,0.7,0.3,1
"15962","SPICE1",25,50,75,0.666666666666667,0.333333333333333,1
"15963","SPIDR",34,56,90,0.622222222222222,0.377777777777778,1
"15964","SPIN1",9,13,22,0.590909090909091,0.409090909090909,1
"15965","SPIN2A",8,5,13,0.384615384615385,0.615384615384615,1
"15966","SPIN2B",11,1,12,0.0833333333333333,0.916666666666667,1
"15967","SPIN3",16,12,28,0.428571428571429,0.571428571428571,1
"15968","SPIN4",12,3,15,0.2,0.8,1
"15969","SPINDOC",12,22,34,0.647058823529412,0.352941176470588,1
"15970","SPINK1",1,6,7,0.857142857142857,0.142857142857143,1
"15971","SPINK13",7,13,20,0.65,0.35,1
"15972","SPINK14",2,8,10,0.8,0.2,1
"15973","SPINK2",2,8,10,0.8,0.2,1
"15974","SPINK4",6,8,14,0.571428571428571,0.428571428571429,1
"15975","SPINK5",62,93,155,0.6,0.4,1
"15976","SPINK6",6,7,13,0.538461538461538,0.461538461538462,1
"15977","SPINK7",4,9,13,0.692307692307692,0.307692307692308,1
"15978","SPINK8",2,2,4,0.5,0.5,1
"15979","SPINK9",4,7,11,0.636363636363636,0.363636363636364,1
"15980","SPINT1",15,26,41,0.634146341463415,0.365853658536585,1
"15981","SPINT2",12,21,33,0.636363636363636,0.363636363636364,1
"15982","SPINT4",3,6,9,0.666666666666667,0.333333333333333,1
"15983","SPIRE1",14,31,45,0.688888888888889,0.311111111111111,1
"15984","SPIRE2",20,31,51,0.607843137254902,0.392156862745098,1
"15985","SPN",12,34,46,0.739130434782609,0.260869565217391,1
"15986","SPNS1",16,32,48,0.666666666666667,0.333333333333333,1
"15987","SPNS2",20,19,39,0.487179487179487,0.512820512820513,1
"15988","SPNS3",23,34,57,0.596491228070175,0.403508771929825,1
"15989","SPO11",14,26,40,0.65,0.35,1
"15990","SPOCD1",48,72,120,0.6,0.4,1
"15991","SPOCK1",19,47,66,0.712121212121212,0.287878787878788,1
"15992","SPOCK2",12,16,28,0.571428571428571,0.428571428571429,1
"15993","SPOCK3",43,87,130,0.669230769230769,0.330769230769231,1
"15994","SPON1",30,64,94,0.680851063829787,0.319148936170213,1
"15995","SPON2",10,19,29,0.655172413793103,0.344827586206897,1
"15996","SPOP",14,23,37,0.621621621621622,0.378378378378378,1
"15997","SPOPL",19,38,57,0.666666666666667,0.333333333333333,1
"15998","SPOUT1",12,18,30,0.6,0.4,1
"15999","SPP1",16,23,39,0.58974358974359,0.41025641025641,1
"16000","SPP2",8,28,36,0.777777777777778,0.222222222222222,1
"16001","SPPL2A",14,30,44,0.681818181818182,0.318181818181818,1
"16002","SPPL2B",20,35,55,0.636363636363636,0.363636363636364,1
"16003","SPPL2C",32,53,85,0.623529411764706,0.376470588235294,1
"16004","SPPL3",13,22,35,0.628571428571429,0.371428571428571,1
"16005","SPR",6,14,20,0.7,0.3,1
"16006","SPRED1",38,32,70,0.457142857142857,0.542857142857143,1
"16007","SPRED2",24,34,58,0.586206896551724,0.413793103448276,1
"16008","SPRED3",7,16,23,0.695652173913043,0.304347826086957,1
"16009","SPRING1",6,7,13,0.538461538461538,0.461538461538462,1
"16010","SPRN",1,1,2,0.5,0.5,1
"16011","SPRR1A",8,12,20,0.6,0.4,1
"16012","SPRR1B",5,22,27,0.814814814814815,0.185185185185185,1
"16013","SPRR2A",2,9,11,0.818181818181818,0.181818181818182,1
"16014","SPRR2B",6,15,21,0.714285714285714,0.285714285714286,1
"16015","SPRR2D",4,13,17,0.764705882352941,0.235294117647059,1
"16016","SPRR2E",11,3,14,0.214285714285714,0.785714285714286,1
"16017","SPRR2F",4,6,10,0.6,0.4,1
"16018","SPRR2G",11,10,21,0.476190476190476,0.523809523809524,1
"16019","SPRR3",11,34,45,0.755555555555556,0.244444444444444,1
"16020","SPRR4",2,12,14,0.857142857142857,0.142857142857143,1
"16021","SPRTN",20,32,52,0.615384615384615,0.384615384615385,1
"16022","SPRY1",13,21,34,0.617647058823529,0.382352941176471,1
"16023","SPRY2",14,21,35,0.6,0.4,1
"16024","SPRY3",33,47,80,0.5875,0.4125,1
"16025","SPRY4",19,19,38,0.5,0.5,1
"16026","SPRYD3",11,18,29,0.620689655172414,0.379310344827586,1
"16027","SPRYD4",3,11,14,0.785714285714286,0.214285714285714,1
"16028","SPRYD7",9,9,18,0.5,0.5,1
"16029","SPSB1",11,19,30,0.633333333333333,0.366666666666667,1
"16030","SPSB2",3,15,18,0.833333333333333,0.166666666666667,1
"16031","SPSB3",12,13,25,0.52,0.48,1
"16032","SPSB4",12,17,29,0.586206896551724,0.413793103448276,1
"16033","SPTA1",337,518,855,0.605847953216374,0.394152046783626,1
"16034","SPTAN1",83,149,232,0.642241379310345,0.357758620689655,1
"16035","SPTB",90,147,237,0.620253164556962,0.379746835443038,1
"16036","SPTBN1",70,134,204,0.656862745098039,0.343137254901961,1
"16037","SPTBN2",76,116,192,0.604166666666667,0.395833333333333,1
"16038","SPTBN4",79,148,227,0.651982378854626,0.348017621145374,1
"16039","SPTBN5",72,105,177,0.593220338983051,0.406779661016949,1
"16040","SPTLC1",25,21,46,0.456521739130435,0.543478260869565,1
"16041","SPTLC2",15,33,48,0.6875,0.3125,1
"16042","SPTLC3",32,73,105,0.695238095238095,0.304761904761905,1
"16043","SPTSSA",0,7,7,1,0,1
"16044","SPTSSB",2,11,13,0.846153846153846,0.153846153846154,1
"16045","SPTY2D1",40,44,84,0.523809523809524,0.476190476190476,1
"16046","SPX",6,16,22,0.727272727272727,0.272727272727273,1
"16047","SPZ1",29,37,66,0.560606060606061,0.439393939393939,1
"16048","SQLE",17,24,41,0.585365853658537,0.414634146341463,1
"16049","SQOR",12,22,34,0.647058823529412,0.352941176470588,1
"16050","SQSTM1",16,29,45,0.644444444444444,0.355555555555556,1
"16051","SRA1",4,9,13,0.692307692307692,0.307692307692308,1
"16052","SRARP",3,10,13,0.769230769230769,0.230769230769231,0.77
"16053","SRBD1",33,50,83,0.602409638554217,0.397590361445783,1
"16054","SRC",18,25,43,0.581395348837209,0.418604651162791,1
"16055","SRCAP",126,223,349,0.638968481375358,0.361031518624642,1
"16056","SRCIN1",40,60,100,0.6,0.4,1
"16057","SRD5A1",7,11,18,0.611111111111111,0.388888888888889,1
"16058","SRD5A2",11,25,36,0.694444444444444,0.305555555555556,1
"16059","SRD5A3",10,12,22,0.545454545454545,0.454545454545455,1
"16060","SREBF1",26,37,63,0.587301587301587,0.412698412698413,1
"16061","SREBF2",39,50,89,0.561797752808989,0.438202247191011,1
"16062","SREK1",14,34,48,0.708333333333333,0.291666666666667,1
"16063","SREK1IP1",13,17,30,0.566666666666667,0.433333333333333,1
"16064","SRF",14,13,27,0.481481481481481,0.518518518518518,1
"16065","SRFBP1",22,32,54,0.592592592592593,0.407407407407407,1
"16066","SRGAP1",59,85,144,0.590277777777778,0.409722222222222,1
"16067","SRGAP2",17,54,71,0.76056338028169,0.23943661971831,1
"16068","SRGAP2D",0,3,3,1,0,1
"16069","SRGAP3",53,110,163,0.674846625766871,0.325153374233129,1
"16070","SRGN",5,8,13,0.615384615384615,0.384615384615385,1
"16071","SRI",4,7,11,0.636363636363636,0.363636363636364,1
"16072","SRL",15,49,64,0.765625,0.234375,1
"16073","SRM",6,8,14,0.571428571428571,0.428571428571429,1
"16074","SRMS",25,36,61,0.590163934426229,0.409836065573771,1
"16075","SRP14",1,4,5,0.8,0.2,1
"16076","SRP19",3,6,9,0.666666666666667,0.333333333333333,1
"16077","SRP54",17,20,37,0.540540540540541,0.459459459459459,1
"16078","SRP68",28,39,67,0.582089552238806,0.417910447761194,1
"16079","SRP72",16,47,63,0.746031746031746,0.253968253968254,1
"16080","SRP9",4,4,8,0.5,0.5,1
"16081","SRPK1",23,40,63,0.634920634920635,0.365079365079365,1
"16082","SRPK2",22,45,67,0.671641791044776,0.328358208955224,1
"16083","SRPK3",31,17,48,0.354166666666667,0.645833333333333,1
"16084","SRPRA",24,29,53,0.547169811320755,0.452830188679245,1
"16085","SRPRB",9,17,26,0.653846153846154,0.346153846153846,1
"16086","SRPX",26,21,47,0.446808510638298,0.553191489361702,1
"16087","SRPX2",31,25,56,0.446428571428571,0.553571428571429,1
"16088","SRR",16,12,28,0.428571428571429,0.571428571428571,1
"16089","SRRD",6,10,16,0.625,0.375,1
"16090","SRRM1",35,54,89,0.606741573033708,0.393258426966292,1
"16091","SRRM2",108,184,292,0.63013698630137,0.36986301369863,1
"16092","SRRM3",10,22,32,0.6875,0.3125,1
"16093","SRRM4",43,71,114,0.62280701754386,0.37719298245614,1
"16094","SRRM5",2,5,7,0.714285714285714,0.285714285714286,1
"16095","SRRT",33,59,92,0.641304347826087,0.358695652173913,1
"16096","SRSF1",8,23,31,0.741935483870968,0.258064516129032,1
"16097","SRSF10",9,16,25,0.64,0.36,1
"16098","SRSF11",18,33,51,0.647058823529412,0.352941176470588,1
"16099","SRSF12",14,8,22,0.363636363636364,0.636363636363636,1
"16100","SRSF2",11,22,33,0.666666666666667,0.333333333333333,1
"16101","SRSF3",9,8,17,0.470588235294118,0.529411764705882,1
"16102","SRSF4",19,18,37,0.486486486486487,0.513513513513513,1
"16103","SRSF5",17,21,38,0.552631578947368,0.447368421052632,1
"16104","SRSF6",22,33,55,0.6,0.4,1
"16105","SRSF7",14,23,37,0.621621621621622,0.378378378378378,1
"16106","SRSF8",3,12,15,0.8,0.2,1
"16107","SRSF9",4,8,12,0.666666666666667,0.333333333333333,1
"16108","SRXN1",3,4,7,0.571428571428571,0.428571428571429,1
"16109","SRY",0,9,9,1,0,1
"16110","SS18",17,22,39,0.564102564102564,0.435897435897436,1
"16111","SS18L1",14,18,32,0.5625,0.4375,1
"16112","SS18L2",1,1,2,0.5,0.5,1
"16113","SSB",17,14,31,0.451612903225806,0.548387096774194,1
"16114","SSBP1",7,14,21,0.666666666666667,0.333333333333333,1
"16115","SSBP2",17,19,36,0.527777777777778,0.472222222222222,1
"16116","SSBP3",13,17,30,0.566666666666667,0.433333333333333,1
"16117","SSBP4",8,19,27,0.703703703703704,0.296296296296296,1
"16118","SSC4D",11,20,31,0.645161290322581,0.354838709677419,1
"16119","SSC5D",1,7,8,0.875,0.125,1
"16120","SSH1",41,52,93,0.559139784946237,0.440860215053763,1
"16121","SSH2",48,86,134,0.641791044776119,0.358208955223881,1
"16122","SSH3",26,41,67,0.611940298507463,0.388059701492537,1
"16123","SSMEM1",18,21,39,0.538461538461538,0.461538461538462,1
"16124","SSNA1",3,2,5,0.4,0.6,1
"16125","SSPN",9,7,16,0.4375,0.5625,1
"16126","SSPOP",248,392,640,0.6125,0.3875,1
"16127","SSR1",9,9,18,0.5,0.5,1
"16128","SSR2",2,5,7,0.714285714285714,0.285714285714286,1
"16129","SSR3",5,12,17,0.705882352941177,0.294117647058824,1
"16130","SSR4",8,8,16,0.5,0.5,1
"16131","SSRP1",20,28,48,0.583333333333333,0.416666666666667,1
"16132","SST",6,8,14,0.571428571428571,0.428571428571429,1
"16133","SSTR1",24,47,71,0.661971830985915,0.338028169014085,1
"16134","SSTR2",18,21,39,0.538461538461538,0.461538461538462,1
"16135","SSTR3",21,47,68,0.691176470588235,0.308823529411765,1
"16136","SSTR4",38,54,92,0.58695652173913,0.41304347826087,1
"16137","SSTR5",12,23,35,0.657142857142857,0.342857142857143,1
"16138","SSU72",4,13,17,0.764705882352941,0.235294117647059,1
"16139","SSU72P8",17,28,45,0.622222222222222,0.377777777777778,1
"16140","SSUH2",16,30,46,0.652173913043478,0.347826086956522,1
"16141","SSX1",15,13,28,0.464285714285714,0.535714285714286,1
"16142","SSX2",3,5,8,0.625,0.375,1
"16143","SSX2IP",20,33,53,0.622641509433962,0.377358490566038,1
"16144","SSX3",15,17,32,0.53125,0.46875,1
"16145","SSX4",1,3,4,0.75,0.25,1
"16146","SSX4B",0,1,1,1,0,1
"16147","SSX5",16,17,33,0.515151515151515,0.484848484848485,1
"16148","SSX6P",15,17,32,0.53125,0.46875,1
"16149","SSX7",15,14,29,0.482758620689655,0.517241379310345,1
"16150","SSX9P",13,15,28,0.535714285714286,0.464285714285714,1
"16151","ST13",8,13,21,0.619047619047619,0.380952380952381,1
"16152","ST14",30,47,77,0.61038961038961,0.38961038961039,1
"16153","ST18",90,195,285,0.684210526315789,0.315789473684211,1
"16154","ST20",1,7,8,0.875,0.125,1
"16155","ST3GAL1",19,18,37,0.486486486486487,0.513513513513513,1
"16156","ST3GAL2",12,16,28,0.571428571428571,0.428571428571429,1
"16157","ST3GAL3",15,19,34,0.558823529411765,0.441176470588235,1
"16158","ST3GAL4",11,9,20,0.45,0.55,1
"16159","ST3GAL5",4,18,22,0.818181818181818,0.181818181818182,1
"16160","ST3GAL6",11,32,43,0.744186046511628,0.255813953488372,1
"16161","ST6GAL1",22,25,47,0.531914893617021,0.468085106382979,1
"16162","ST6GAL2",74,115,189,0.608465608465608,0.391534391534392,1
"16163","ST6GALNAC1",17,42,59,0.711864406779661,0.288135593220339,1
"16164","ST6GALNAC2",10,14,24,0.583333333333333,0.416666666666667,1
"16165","ST6GALNAC3",35,62,97,0.639175257731959,0.360824742268041,1
"16166","ST6GALNAC4",6,15,21,0.714285714285714,0.285714285714286,1
"16167","ST6GALNAC5",26,45,71,0.633802816901408,0.366197183098592,1
"16168","ST6GALNAC6",13,10,23,0.434782608695652,0.565217391304348,1
"16169","ST7",7,44,51,0.862745098039216,0.137254901960784,1
"16170","ST7L",18,19,37,0.513513513513513,0.486486486486487,1
"16171","ST8SIA1",24,30,54,0.555555555555556,0.444444444444444,1
"16172","ST8SIA2",31,31,62,0.5,0.5,1
"16173","ST8SIA3",34,48,82,0.585365853658537,0.414634146341463,1
"16174","ST8SIA4",33,50,83,0.602409638554217,0.397590361445783,1
"16175","ST8SIA5",25,52,77,0.675324675324675,0.324675324675325,1
"16176","ST8SIA6",44,43,87,0.494252873563218,0.505747126436782,1
"16177","STAB1",98,176,274,0.642335766423358,0.357664233576642,1
"16178","STAB2",131,252,383,0.657963446475196,0.342036553524804,1
"16179","STAC",28,61,89,0.685393258426966,0.314606741573034,1
"16180","STAC2",12,20,32,0.625,0.375,1
"16181","STAC3",13,20,33,0.606060606060606,0.393939393939394,1
"16182","STAG1",62,97,159,0.610062893081761,0.389937106918239,1
"16183","STAG2",97,104,201,0.517412935323383,0.482587064676617,1
"16184","STAG3",49,64,113,0.566371681415929,0.433628318584071,1
"16185","STAG3L2",3,7,10,0.7,0.3,1
"16186","STAG3L3",2,0,2,0,1,1
"16187","STAG3L4",8,13,21,0.619047619047619,0.380952380952381,1
"16188","STAM",22,28,50,0.56,0.44,1
"16189","STAM2",21,25,46,0.543478260869565,0.456521739130435,1
"16190","STAMBP",15,16,31,0.516129032258065,0.483870967741935,0.45
"16191","STAMBPL1",27,34,61,0.557377049180328,0.442622950819672,0.45
"16192","STAP1",18,27,45,0.6,0.4,1
"16193","STAP2",14,14,28,0.5,0.5,1
"16194","STAR",16,21,37,0.567567567567568,0.432432432432432,0.77
"16195","STARD10",7,19,26,0.730769230769231,0.269230769230769,0.77
"16196","STARD13",44,78,122,0.639344262295082,0.360655737704918,0.77
"16197","STARD3",15,18,33,0.545454545454545,0.454545454545455,0.77
"16198","STARD3NL",9,22,31,0.709677419354839,0.290322580645161,0.77
"16199","STARD4",9,25,34,0.735294117647059,0.264705882352941,0.77
"16200","STARD5",5,8,13,0.615384615384615,0.384615384615385,0.77
"16201","STARD6",18,26,44,0.590909090909091,0.409090909090909,0.77
"16202","STARD7",14,18,32,0.5625,0.4375,0.77
"16203","STARD7-AS1",6,9,15,0.6,0.4,0.77
"16204","STARD8",56,42,98,0.428571428571429,0.571428571428571,0.77
"16205","STAT1",44,67,111,0.603603603603604,0.396396396396396,1
"16206","STAT2",27,51,78,0.653846153846154,0.346153846153846,1
"16207","STAT3",24,45,69,0.652173913043478,0.347826086956522,1
"16208","STAT4",40,73,113,0.646017699115044,0.353982300884956,1
"16209","STAT5A",16,32,48,0.666666666666667,0.333333333333333,1
"16210","STAT5B",38,52,90,0.577777777777778,0.422222222222222,1
"16211","STAT6",30,41,71,0.577464788732394,0.422535211267606,1
"16212","STATH",4,3,7,0.428571428571429,0.571428571428571,1
"16213","STAU1",16,39,55,0.709090909090909,0.290909090909091,1
"16214","STAU2",35,36,71,0.507042253521127,0.492957746478873,1
"16215","STBD1",11,16,27,0.592592592592593,0.407407407407407,1
"16216","STC1",11,25,36,0.694444444444444,0.305555555555556,1
"16217","STC2",16,37,53,0.69811320754717,0.30188679245283,1
"16218","STEAP1",15,24,39,0.615384615384615,0.384615384615385,1
"16219","STEAP1B",1,1,2,0.5,0.5,1
"16220","STEAP2",20,35,55,0.636363636363636,0.363636363636364,1
"16221","STEAP3",22,24,46,0.521739130434783,0.478260869565217,1
"16222","STEAP4",25,59,84,0.702380952380952,0.297619047619048,1
"16223","STH",2,9,11,0.818181818181818,0.181818181818182,1
"16224","STIL",35,69,104,0.663461538461538,0.336538461538462,1
"16225","STIM1",21,36,57,0.631578947368421,0.368421052631579,1
"16226","STIM2",20,41,61,0.672131147540984,0.327868852459016,1
"16227","STIMATE",5,11,16,0.6875,0.3125,1
"16228","STIMATE-MUSTN1",0,1,1,1,0,1
"16229","STING1",10,18,28,0.642857142857143,0.357142857142857,1
"16230","STIP1",26,28,54,0.518518518518518,0.481481481481481,1
"16231","STK10",33,51,84,0.607142857142857,0.392857142857143,1
"16232","STK11",41,60,101,0.594059405940594,0.405940594059406,1
"16233","STK11IP",21,48,69,0.695652173913043,0.304347826086957,1
"16234","STK16",10,17,27,0.62962962962963,0.37037037037037,1
"16235","STK17A",10,15,25,0.6,0.4,1
"16236","STK17B",20,20,40,0.5,0.5,1
"16237","STK19",14,28,42,0.666666666666667,0.333333333333333,1
"16238","STK24",19,29,48,0.604166666666667,0.395833333333333,1
"16239","STK25",14,14,28,0.5,0.5,1
"16240","STK26",31,14,45,0.311111111111111,0.688888888888889,1
"16241","STK3",11,36,47,0.765957446808511,0.234042553191489,1
"16242","STK31",62,161,223,0.721973094170404,0.278026905829596,1
"16243","STK32A",12,19,31,0.612903225806452,0.387096774193548,1
"16244","STK32B",27,42,69,0.608695652173913,0.391304347826087,1
"16245","STK32C",11,23,34,0.676470588235294,0.323529411764706,1
"16246","STK33",33,44,77,0.571428571428571,0.428571428571429,1
"16247","STK35",9,18,27,0.666666666666667,0.333333333333333,1
"16248","STK36",38,77,115,0.669565217391304,0.330434782608696,1
"16249","STK38",15,23,38,0.605263157894737,0.394736842105263,1
"16250","STK38L",13,21,34,0.617647058823529,0.382352941176471,1
"16251","STK39",13,33,46,0.717391304347826,0.282608695652174,1
"16252","STK4",12,32,44,0.727272727272727,0.272727272727273,1
"16253","STK40",14,23,37,0.621621621621622,0.378378378378378,1
"16254","STKLD1",28,39,67,0.582089552238806,0.417910447761194,1
"16255","STMN1",8,8,16,0.5,0.5,1
"16256","STMN2",6,21,27,0.777777777777778,0.222222222222222,1
"16257","STMN3",3,11,14,0.785714285714286,0.214285714285714,1
"16258","STMN4",10,22,32,0.6875,0.3125,1
"16259","STMP1",0,1,1,1,0,1
"16260","STN1",13,17,30,0.566666666666667,0.433333333333333,1
"16261","STOM",9,10,19,0.526315789473684,0.473684210526316,1
"16262","STOML1",9,18,27,0.666666666666667,0.333333333333333,1
"16263","STOML2",16,17,33,0.515151515151515,0.484848484848485,1
"16264","STOML3",19,36,55,0.654545454545455,0.345454545454545,1
"16265","STON1",41,79,120,0.658333333333333,0.341666666666667,1
"16266","STON1-GTF2A1L",36,81,117,0.692307692307692,0.307692307692308,1
"16267","STON2",42,61,103,0.592233009708738,0.407766990291262,1
"16268","STOX1",35,54,89,0.606741573033708,0.393258426966292,1
"16269","STOX2",27,49,76,0.644736842105263,0.355263157894737,1
"16270","STPG1",9,18,27,0.666666666666667,0.333333333333333,1
"16271","STPG2",31,62,93,0.666666666666667,0.333333333333333,1
"16272","STPG3",4,13,17,0.764705882352941,0.235294117647059,1
"16273","STPG4",7,11,18,0.611111111111111,0.388888888888889,1
"16274","STRA6",22,31,53,0.584905660377358,0.415094339622642,1
"16275","STRA8",15,30,45,0.666666666666667,0.333333333333333,1
"16276","STRADA",21,16,37,0.432432432432432,0.567567567567568,1
"16277","STRADB",11,22,33,0.666666666666667,0.333333333333333,1
"16278","STRAP",8,25,33,0.757575757575758,0.242424242424242,1
"16279","STRBP",11,33,44,0.75,0.25,1
"16280","STRC",28,37,65,0.569230769230769,0.430769230769231,1
"16281","STRIP1",29,33,62,0.532258064516129,0.467741935483871,1
"16282","STRIP2",40,59,99,0.595959595959596,0.404040404040404,1
"16283","STRN",34,38,72,0.527777777777778,0.472222222222222,1
"16284","STRN3",25,37,62,0.596774193548387,0.403225806451613,1
"16285","STRN4",29,30,59,0.508474576271186,0.491525423728814,1
"16286","STS",40,34,74,0.459459459459459,0.540540540540541,1
"16287","STT3A",27,33,60,0.55,0.45,1
"16288","STT3B",14,33,47,0.702127659574468,0.297872340425532,1
"16289","STUB1",11,12,23,0.521739130434783,0.478260869565217,1
"16290","STUM",4,6,10,0.6,0.4,1
"16291","STX10",9,6,15,0.4,0.6,1
"16292","STX11",17,28,45,0.622222222222222,0.377777777777778,1
"16293","STX12",8,12,20,0.6,0.4,1
"16294","STX16",11,22,33,0.666666666666667,0.333333333333333,1
"16295","STX17",4,14,18,0.777777777777778,0.222222222222222,1
"16296","STX18",10,12,22,0.545454545454545,0.454545454545455,1
"16297","STX19",11,21,32,0.65625,0.34375,1
"16298","STX1A",6,18,24,0.75,0.25,1
"16299","STX1B",14,15,29,0.517241379310345,0.482758620689655,1
"16300","STX2",14,25,39,0.641025641025641,0.358974358974359,1
"16301","STX3",9,15,24,0.625,0.375,1
"16302","STX4",14,16,30,0.533333333333333,0.466666666666667,1
"16303","STX5",8,23,31,0.741935483870968,0.258064516129032,1
"16304","STX6",8,12,20,0.6,0.4,1
"16305","STX7",9,20,29,0.689655172413793,0.310344827586207,1
"16306","STX8",8,16,24,0.666666666666667,0.333333333333333,1
"16307","STXBP1",18,37,55,0.672727272727273,0.327272727272727,1
"16308","STXBP2",12,32,44,0.727272727272727,0.272727272727273,1
"16309","STXBP3",19,23,42,0.547619047619048,0.452380952380952,1
"16310","STXBP4",16,34,50,0.68,0.32,1
"16311","STXBP5",40,56,96,0.583333333333333,0.416666666666667,1
"16312","STXBP5L",95,200,295,0.677966101694915,0.322033898305085,1
"16313","STXBP6",9,13,22,0.590909090909091,0.409090909090909,1
"16314","STYK1",26,38,64,0.59375,0.40625,1
"16315","STYX",6,11,17,0.647058823529412,0.352941176470588,1
"16316","STYXL1",13,25,38,0.657894736842105,0.342105263157895,1
"16317","STYXL2",102,155,257,0.603112840466926,0.396887159533074,1
"16318","SUB1",1,6,7,0.857142857142857,0.142857142857143,1
"16319","SUCLA2",24,21,45,0.466666666666667,0.533333333333333,1
"16320","SUCLG1",12,15,27,0.555555555555556,0.444444444444444,1
"16321","SUCLG2",12,11,23,0.478260869565217,0.521739130434783,1
"16322","SUCNR1",17,30,47,0.638297872340426,0.361702127659574,1
"16323","SUCO",40,88,128,0.6875,0.3125,1
"16324","SUDS3",7,14,21,0.666666666666667,0.333333333333333,1
"16325","SUFU",13,35,48,0.729166666666667,0.270833333333333,1
"16326","SUGCT",26,34,60,0.566666666666667,0.433333333333333,1
"16327","SUGP1",34,41,75,0.546666666666667,0.453333333333333,1
"16328","SUGP2",40,52,92,0.565217391304348,0.434782608695652,1
"16329","SUGT1",10,18,28,0.642857142857143,0.357142857142857,1
"16330","SUGT1P4-STRA6LP",8,8,16,0.5,0.5,1
"16331","SULF1",71,136,207,0.657004830917874,0.342995169082126,1
"16332","SULF2",36,72,108,0.666666666666667,0.333333333333333,1
"16333","SULT1A1",14,28,42,0.666666666666667,0.333333333333333,1
"16334","SULT1A2",15,18,33,0.545454545454545,0.454545454545455,1
"16335","SULT1B1",24,42,66,0.636363636363636,0.363636363636364,1
"16336","SULT1C2",13,36,49,0.73469387755102,0.26530612244898,1
"16337","SULT1C3",29,37,66,0.560606060606061,0.439393939393939,1
"16338","SULT1C4",16,33,49,0.673469387755102,0.326530612244898,1
"16339","SULT1E1",17,46,63,0.73015873015873,0.26984126984127,1
"16340","SULT2A1",18,30,48,0.625,0.375,1
"16341","SULT2B1",16,16,32,0.5,0.5,1
"16342","SULT4A1",9,21,30,0.7,0.3,1
"16343","SULT6B1",26,29,55,0.527272727272727,0.472727272727273,1
"16344","SUMF1",9,14,23,0.608695652173913,0.391304347826087,1
"16345","SUMF2",6,12,18,0.666666666666667,0.333333333333333,1
"16346","SUMO1",3,6,9,0.666666666666667,0.333333333333333,1
"16347","SUMO2",2,2,4,0.5,0.5,1
"16348","SUMO2P21",0,1,1,1,0,1
"16349","SUMO3",1,3,4,0.75,0.25,1
"16350","SUMO4",2,1,3,0.333333333333333,0.666666666666667,1
"16351","SUN1",32,49,81,0.604938271604938,0.395061728395062,1
"16352","SUN2",16,20,36,0.555555555555556,0.444444444444444,1
"16353","SUN3",22,35,57,0.614035087719298,0.385964912280702,1
"16354","SUN5",21,44,65,0.676923076923077,0.323076923076923,1
"16355","SUOX",24,22,46,0.478260869565217,0.521739130434783,1
"16356","SUPT16H",31,77,108,0.712962962962963,0.287037037037037,1
"16357","SUPT20H",32,51,83,0.614457831325301,0.385542168674699,1
"16358","SUPT20HL1",48,31,79,0.392405063291139,0.607594936708861,1
"16359","SUPT20HL2",35,37,72,0.513888888888889,0.486111111111111,1
"16360","SUPT3H",18,25,43,0.581395348837209,0.418604651162791,1
"16361","SUPT4H1",2,4,6,0.666666666666667,0.333333333333333,1
"16362","SUPT5H",47,60,107,0.560747663551402,0.439252336448598,1
"16363","SUPT6H",80,97,177,0.548022598870056,0.451977401129944,1
"16364","SUPT7L",13,19,32,0.59375,0.40625,1
"16365","SUPV3L1",17,21,38,0.552631578947368,0.447368421052632,1
"16366","SURF1",4,5,9,0.555555555555556,0.444444444444444,1
"16367","SURF2",6,15,21,0.714285714285714,0.285714285714286,1
"16368","SURF4",4,15,19,0.789473684210526,0.210526315789474,1
"16369","SURF6",12,12,24,0.5,0.5,1
"16370","SUSD1",36,34,70,0.485714285714286,0.514285714285714,1
"16371","SUSD2",27,38,65,0.584615384615385,0.415384615384615,1
"16372","SUSD3",10,13,23,0.565217391304348,0.434782608695652,1
"16373","SUSD4",18,44,62,0.709677419354839,0.290322580645161,1
"16374","SUSD5",27,23,50,0.46,0.54,1
"16375","SUSD6",11,15,26,0.576923076923077,0.423076923076923,1
"16376","SUV39H1",19,10,29,0.344827586206897,0.655172413793103,1
"16377","SUV39H2",9,22,31,0.709677419354839,0.290322580645161,1
"16378","SUZ12",16,31,47,0.659574468085106,0.340425531914894,1
"16379","SV2A",42,68,110,0.618181818181818,0.381818181818182,1
"16380","SV2B",29,66,95,0.694736842105263,0.305263157894737,1
"16381","SV2C",59,78,137,0.569343065693431,0.430656934306569,1
"16382","SVBP",3,3,6,0.5,0.5,1
"16383","SVEP1",149,307,456,0.673245614035088,0.326754385964912,1
"16384","SVIL",80,154,234,0.658119658119658,0.341880341880342,1
"16385","SVIP",2,7,9,0.777777777777778,0.222222222222222,1
"16386","SVOP",11,20,31,0.645161290322581,0.354838709677419,1
"16387","SVOPL",22,37,59,0.627118644067797,0.372881355932203,1
"16388","SWAP70",17,22,39,0.564102564102564,0.435897435897436,1
"16389","SWI5",5,7,12,0.583333333333333,0.416666666666667,1
"16390","SWSAP1",4,11,15,0.733333333333333,0.266666666666667,1
"16391","SWT1",37,72,109,0.660550458715596,0.339449541284404,1
"16392","SYAP1",8,8,16,0.5,0.5,1
"16393","SYBU",25,58,83,0.698795180722892,0.301204819277108,1
"16394","SYCE1",13,33,46,0.717391304347826,0.282608695652174,1
"16395","SYCE1L",0,1,1,1,0,1
"16396","SYCE2",7,13,20,0.65,0.35,1
"16397","SYCN",2,7,9,0.777777777777778,0.222222222222222,1
"16398","SYCP1",63,137,200,0.685,0.315,1
"16399","SYCP2",79,121,200,0.605,0.395,1
"16400","SYCP2L",51,86,137,0.627737226277372,0.372262773722628,1
"16401","SYCP3",16,13,29,0.448275862068966,0.551724137931034,1
"16402","SYDE1",17,20,37,0.540540540540541,0.459459459459459,1
"16403","SYDE2",25,53,78,0.67948717948718,0.320512820512821,1
"16404","SYF2",8,16,24,0.666666666666667,0.333333333333333,1
"16405","SYK",25,53,78,0.67948717948718,0.320512820512821,1
"16406","SYMPK",53,58,111,0.522522522522523,0.477477477477477,1
"16407","SYN1",22,17,39,0.435897435897436,0.564102564102564,1
"16408","SYN2",22,20,42,0.476190476190476,0.523809523809524,1
"16409","SYN3",33,53,86,0.616279069767442,0.383720930232558,1
"16410","SYNC",7,10,17,0.588235294117647,0.411764705882353,1
"16411","SYNCRIP",38,37,75,0.493333333333333,0.506666666666667,1
"16412","SYNDIG1",21,47,68,0.691176470588235,0.308823529411765,1
"16413","SYNDIG1L",12,28,40,0.7,0.3,1
"16414","SYNE1",485,881,1366,0.644948755490483,0.355051244509517,1
"16415","SYNE2",212,378,590,0.640677966101695,0.359322033898305,1
"16416","SYNE3",34,65,99,0.656565656565657,0.343434343434343,1
"16417","SYNE4",7,21,28,0.75,0.25,1
"16418","SYNGAP1",49,65,114,0.570175438596491,0.429824561403509,1
"16419","SYNGR1",3,17,20,0.85,0.15,1
"16420","SYNGR2",6,13,19,0.684210526315789,0.315789473684211,1
"16421","SYNGR3",4,7,11,0.636363636363636,0.363636363636364,1
"16422","SYNGR4",7,21,28,0.75,0.25,1
"16423","SYNJ1",50,92,142,0.647887323943662,0.352112676056338,1
"16424","SYNJ2",81,66,147,0.448979591836735,0.551020408163265,1
"16425","SYNJ2BP",3,12,15,0.8,0.2,1
"16426","SYNM",39,61,100,0.61,0.39,1
"16427","SYNPO",18,36,54,0.666666666666667,0.333333333333333,1
"16428","SYNPO2",75,140,215,0.651162790697674,0.348837209302326,1
"16429","SYNPO2L",40,32,72,0.444444444444444,0.555555555555556,1
"16430","SYNPR",3,17,20,0.85,0.15,1
"16431","SYNRG",46,62,108,0.574074074074074,0.425925925925926,1
"16432","SYP",15,4,19,0.210526315789474,0.789473684210526,1
"16433","SYPL1",8,11,19,0.578947368421053,0.421052631578947,1
"16434","SYPL2",13,21,34,0.617647058823529,0.382352941176471,1
"16435","SYS1",8,11,19,0.578947368421053,0.421052631578947,1
"16436","SYT1",47,59,106,0.556603773584906,0.443396226415094,1
"16437","SYT10",52,85,137,0.62043795620438,0.37956204379562,1
"16438","SYT11",24,24,48,0.5,0.5,1
"16439","SYT12",14,35,49,0.714285714285714,0.285714285714286,1
"16440","SYT13",17,32,49,0.653061224489796,0.346938775510204,1
"16441","SYT14",23,40,63,0.634920634920635,0.365079365079365,1
"16442","SYT15",11,16,27,0.592592592592593,0.407407407407407,1
"16443","SYT16",49,88,137,0.642335766423358,0.357664233576642,1
"16444","SYT17",16,40,56,0.714285714285714,0.285714285714286,1
"16445","SYT2",17,28,45,0.622222222222222,0.377777777777778,1
"16446","SYT3",33,56,89,0.629213483146067,0.370786516853933,1
"16447","SYT4",35,61,96,0.635416666666667,0.364583333333333,1
"16448","SYT5",22,33,55,0.6,0.4,1
"16449","SYT6",24,42,66,0.636363636363636,0.363636363636364,1
"16450","SYT7",25,35,60,0.583333333333333,0.416666666666667,1
"16451","SYT8",11,22,33,0.666666666666667,0.333333333333333,1
"16452","SYT9",38,55,93,0.591397849462366,0.408602150537634,1
"16453","SYTL1",17,27,44,0.613636363636364,0.386363636363636,1
"16454","SYTL2",36,75,111,0.675675675675676,0.324324324324324,1
"16455","SYTL3",18,27,45,0.6,0.4,1
"16456","SYTL4",48,27,75,0.36,0.64,1
"16457","SYTL5",40,49,89,0.550561797752809,0.449438202247191,1
"16458","SYVN1",23,25,48,0.520833333333333,0.479166666666667,1
"16459","SZRD1",2,4,6,0.666666666666667,0.333333333333333,1
"16460","SZT2",102,163,265,0.615094339622641,0.384905660377359,1
"16461","TAAR1",18,32,50,0.64,0.36,0.77
"16462","TAAR2",13,44,57,0.771929824561403,0.228070175438596,0.73696
"16463","TAAR5",18,40,58,0.689655172413793,0.310344827586207,0.77
"16464","TAAR6",25,46,71,0.647887323943662,0.352112676056338,0.77
"16465","TAAR8",11,26,37,0.702702702702703,0.297297297297297,0.77
"16466","TAAR9",17,32,49,0.653061224489796,0.346938775510204,0.77
"16467","TAB1",19,33,52,0.634615384615385,0.365384615384615,1
"16468","TAB2",23,36,59,0.610169491525424,0.389830508474576,1
"16469","TAB3",54,20,74,0.27027027027027,0.72972972972973,1
"16470","TAC1",9,18,27,0.666666666666667,0.333333333333333,1
"16471","TAC3",4,11,15,0.733333333333333,0.266666666666667,1
"16472","TAC4",5,12,17,0.705882352941177,0.294117647058824,1
"16473","TACC1",24,35,59,0.593220338983051,0.406779661016949,1
"16474","TACC2",118,206,324,0.635802469135803,0.364197530864198,1
"16475","TACC3",29,35,64,0.546875,0.453125,1
"16476","TACO1",4,3,7,0.428571428571429,0.571428571428571,0.58
"16477","TACR1",15,35,50,0.7,0.3,0.37
"16478","TACR2",10,17,27,0.62962962962963,0.37037037037037,0.37
"16479","TACR3",55,81,136,0.595588235294118,0.404411764705882,0.37
"16480","TACSTD2",7,14,21,0.666666666666667,0.333333333333333,1
"16481","TADA1",9,13,22,0.590909090909091,0.409090909090909,1
"16482","TADA2A",14,24,38,0.631578947368421,0.368421052631579,0.36
"16483","TADA2B",19,17,36,0.472222222222222,0.527777777777778,0.36
"16484","TADA3",17,21,38,0.552631578947368,0.447368421052632,1
"16485","TAF1",103,79,182,0.434065934065934,0.565934065934066,1
"16486","TAF10",2,4,6,0.666666666666667,0.333333333333333,1
"16487","TAF11",6,13,19,0.684210526315789,0.315789473684211,1
"16488","TAF12",2,3,5,0.6,0.4,1
"16489","TAF13",6,6,12,0.5,0.5,1
"16490","TAF15",28,38,66,0.575757575757576,0.424242424242424,1
"16491","TAF1A",15,21,36,0.583333333333333,0.416666666666667,1
"16492","TAF1B",16,31,47,0.659574468085106,0.340425531914894,1
"16493","TAF1C",27,44,71,0.619718309859155,0.380281690140845,1
"16494","TAF1D",16,19,35,0.542857142857143,0.457142857142857,1
"16495","TAF1L",158,268,426,0.629107981220657,0.370892018779343,1
"16496","TAF2",47,71,118,0.601694915254237,0.398305084745763,1
"16497","TAF3",32,77,109,0.706422018348624,0.293577981651376,1
"16498","TAF4",42,59,101,0.584158415841584,0.415841584158416,1
"16499","TAF4B",25,39,64,0.609375,0.390625,1
"16500","TAF5",16,26,42,0.619047619047619,0.380952380952381,1
"16501","TAF5L",20,32,52,0.615384615384615,0.384615384615385,1
"16502","TAF6",14,34,48,0.708333333333333,0.291666666666667,1
"16503","TAF6L",21,27,48,0.5625,0.4375,1
"16504","TAF7",13,15,28,0.535714285714286,0.464285714285714,1
"16505","TAF7L",35,36,71,0.507042253521127,0.492957746478873,1
"16506","TAF8",7,18,25,0.72,0.28,1
"16507","TAF9",4,14,18,0.777777777777778,0.222222222222222,1
"16508","TAF9B",18,9,27,0.333333333333333,0.666666666666667,1
"16509","TAFA1",14,25,39,0.641025641025641,0.358974358974359,1
"16510","TAFA2",14,38,52,0.730769230769231,0.269230769230769,1
"16511","TAFA3",6,7,13,0.538461538461538,0.461538461538462,1
"16512","TAFA4",13,16,29,0.551724137931034,0.448275862068966,1
"16513","TAFA5",10,14,24,0.583333333333333,0.416666666666667,1
"16514","TAGAP",31,53,84,0.630952380952381,0.369047619047619,0.9
"16515","TAGLN",6,9,15,0.6,0.4,0.62
"16516","TAGLN2",7,14,21,0.666666666666667,0.333333333333333,0.62
"16517","TAGLN3",8,14,22,0.636363636363636,0.363636363636364,0.62
"16518","TAL1",17,30,47,0.638297872340426,0.361702127659574,1
"16519","TAL2",4,10,14,0.714285714285714,0.285714285714286,1
"16520","TALDO1",13,14,27,0.518518518518518,0.481481481481481,1
"16521","TAMALIN",10,6,16,0.375,0.625,1
"16522","TAMM41",5,8,13,0.615384615384615,0.384615384615385,1
"16523","TANC1",74,89,163,0.54601226993865,0.45398773006135,1
"16524","TANC2",63,101,164,0.615853658536585,0.384146341463415,1
"16525","TANGO2",10,2,12,0.166666666666667,0.833333333333333,0.11
"16526","TANGO6",23,51,74,0.689189189189189,0.310810810810811,0.11
"16527","TANK",11,18,29,0.620689655172414,0.379310344827586,1
"16528","TAOK1",42,62,104,0.596153846153846,0.403846153846154,1
"16529","TAOK2",45,87,132,0.659090909090909,0.340909090909091,1
"16530","TAOK3",33,66,99,0.666666666666667,0.333333333333333,1
"16531","TAP1",19,39,58,0.672413793103448,0.327586206896552,1
"16532","TAP2",26,45,71,0.633802816901408,0.366197183098592,1
"16533","TAPBP",21,23,44,0.522727272727273,0.477272727272727,1
"16534","TAPBPL",7,16,23,0.695652173913043,0.304347826086957,1
"16535","TAPT1",12,24,36,0.666666666666667,0.333333333333333,1
"16536","TARBP1",38,67,105,0.638095238095238,0.361904761904762,0.77
"16537","TARBP2",18,21,39,0.538461538461538,0.461538461538462,0.77
"16538","TARDBP",10,22,32,0.6875,0.3125,0.77
"16539","TARS1",28,53,81,0.654320987654321,0.345679012345679,0.77
"16540","TARS2",34,50,84,0.595238095238095,0.404761904761905,0.77
"16541","TARS3",21,38,59,0.644067796610169,0.355932203389831,0.77
"16542","TAS1R1",28,48,76,0.631578947368421,0.368421052631579,1
"16543","TAS1R2",59,85,144,0.590277777777778,0.409722222222222,1
"16544","TAS1R3",27,44,71,0.619718309859155,0.380281690140845,1
"16545","TAS2R1",35,44,79,0.556962025316456,0.443037974683544,1
"16546","TAS2R10",11,32,43,0.744186046511628,0.255813953488372,1
"16547","TAS2R13",13,16,29,0.551724137931034,0.448275862068966,1
"16548","TAS2R14",21,26,47,0.553191489361702,0.446808510638298,1
"16549","TAS2R16",30,36,66,0.545454545454545,0.454545454545455,1
"16550","TAS2R19",15,15,30,0.5,0.5,1
"16551","TAS2R20",7,25,32,0.78125,0.21875,1
"16552","TAS2R3",12,16,28,0.571428571428571,0.428571428571429,1
"16553","TAS2R30",16,14,30,0.466666666666667,0.533333333333333,1
"16554","TAS2R31",8,16,24,0.666666666666667,0.333333333333333,1
"16555","TAS2R38",27,37,64,0.578125,0.421875,1
"16556","TAS2R39",14,38,52,0.730769230769231,0.269230769230769,1
"16557","TAS2R4",9,15,24,0.625,0.375,1
"16558","TAS2R40",16,28,44,0.636363636363636,0.363636363636364,1
"16559","TAS2R41",29,51,80,0.6375,0.3625,1
"16560","TAS2R42",15,15,30,0.5,0.5,1
"16561","TAS2R43",3,10,13,0.769230769230769,0.230769230769231,1
"16562","TAS2R46",9,13,22,0.590909090909091,0.409090909090909,1
"16563","TAS2R5",5,18,23,0.782608695652174,0.217391304347826,1
"16564","TAS2R50",10,22,32,0.6875,0.3125,1
"16565","TAS2R60",26,56,82,0.682926829268293,0.317073170731707,1
"16566","TAS2R7",8,27,35,0.771428571428571,0.228571428571429,1
"16567","TAS2R8",5,28,33,0.848484848484849,0.151515151515152,1
"16568","TAS2R9",11,32,43,0.744186046511628,0.255813953488372,1
"16569","TASOR",38,52,90,0.577777777777778,0.422222222222222,1
"16570","TASOR2",71,85,156,0.544871794871795,0.455128205128205,1
"16571","TASP1",17,35,52,0.673076923076923,0.326923076923077,1
"16572","TAT",27,47,74,0.635135135135135,0.364864864864865,1
"16573","TATDN1",12,13,25,0.52,0.48,1
"16574","TATDN2",17,34,51,0.666666666666667,0.333333333333333,1
"16575","TATDN3",7,15,22,0.681818181818182,0.318181818181818,1
"16576","TAX1BP1",22,45,67,0.671641791044776,0.328358208955224,1
"16577","TAX1BP3",4,2,6,0.333333333333333,0.666666666666667,1
"16578","TAZ",20,10,30,0.333333333333333,0.666666666666667,1
"16579","TBATA",14,30,44,0.681818181818182,0.318181818181818,1
"16580","TBC1D1",28,84,112,0.75,0.25,1
"16581","TBC1D10A",15,41,56,0.732142857142857,0.267857142857143,1
"16582","TBC1D10B",15,15,30,0.5,0.5,1
"16583","TBC1D10C",29,20,49,0.408163265306122,0.591836734693878,1
"16584","TBC1D12",23,24,47,0.51063829787234,0.48936170212766,1
"16585","TBC1D13",14,21,35,0.6,0.4,1
"16586","TBC1D14",26,39,65,0.6,0.4,1
"16587","TBC1D15",27,43,70,0.614285714285714,0.385714285714286,1
"16588","TBC1D16",18,44,62,0.709677419354839,0.290322580645161,1
"16589","TBC1D17",24,33,57,0.578947368421053,0.421052631578947,1
"16590","TBC1D19",24,31,55,0.563636363636364,0.436363636363636,1
"16591","TBC1D2",32,31,63,0.492063492063492,0.507936507936508,1
"16592","TBC1D20",16,22,38,0.578947368421053,0.421052631578947,1
"16593","TBC1D21",8,31,39,0.794871794871795,0.205128205128205,1
"16594","TBC1D22A",21,40,61,0.655737704918033,0.344262295081967,1
"16595","TBC1D22B",21,24,45,0.533333333333333,0.466666666666667,1
"16596","TBC1D23",38,37,75,0.493333333333333,0.506666666666667,1
"16597","TBC1D24",17,18,35,0.514285714285714,0.485714285714286,1
"16598","TBC1D25",47,21,68,0.308823529411765,0.691176470588235,1
"16599","TBC1D26",6,13,19,0.684210526315789,0.315789473684211,1
"16600","TBC1D28",15,10,25,0.4,0.6,1
"16601","TBC1D29P",11,9,20,0.45,0.55,1
"16602","TBC1D2B",18,42,60,0.7,0.3,1
"16603","TBC1D31",30,58,88,0.659090909090909,0.340909090909091,1
"16604","TBC1D32",50,93,143,0.65034965034965,0.34965034965035,1
"16605","TBC1D3B",12,21,33,0.636363636363636,0.363636363636364,1
"16606","TBC1D3F",5,17,22,0.772727272727273,0.227272727272727,1
"16607","TBC1D3I",0,2,2,1,0,1
"16608","TBC1D3L",1,5,6,0.833333333333333,0.166666666666667,1
"16609","TBC1D4",50,66,116,0.568965517241379,0.431034482758621,1
"16610","TBC1D5",27,58,85,0.682352941176471,0.317647058823529,1
"16611","TBC1D7",13,16,29,0.551724137931034,0.448275862068966,1
"16612","TBC1D8",32,49,81,0.604938271604938,0.395061728395062,1
"16613","TBC1D8B",71,48,119,0.403361344537815,0.596638655462185,1
"16614","TBC1D9",49,90,139,0.647482014388489,0.352517985611511,1
"16615","TBC1D9B",51,58,109,0.532110091743119,0.467889908256881,1
"16616","TBCA",10,1,11,0.0909090909090909,0.909090909090909,1
"16617","TBCB",8,8,16,0.5,0.5,1
"16618","TBCC",7,20,27,0.740740740740741,0.259259259259259,1
"16619","TBCCD1",16,36,52,0.692307692307692,0.307692307692308,1
"16620","TBCD",33,58,91,0.637362637362637,0.362637362637363,1
"16621","TBCE",14,23,37,0.621621621621622,0.378378378378378,1
"16622","TBCEL",15,22,37,0.594594594594595,0.405405405405405,1
"16623","TBCK",29,54,83,0.650602409638554,0.349397590361446,1
"16624","TBK1",29,39,68,0.573529411764706,0.426470588235294,1
"16625","TBKBP1",13,19,32,0.59375,0.40625,1
"16626","TBL1X",40,19,59,0.322033898305085,0.677966101694915,1
"16627","TBL1XR1",28,39,67,0.582089552238806,0.417910447761194,1
"16628","TBL1Y",1,31,32,0.96875,0.03125,1
"16629","TBL2",15,27,42,0.642857142857143,0.357142857142857,1
"16630","TBL3",19,34,53,0.641509433962264,0.358490566037736,1
"16631","TBP",8,13,21,0.619047619047619,0.380952380952381,1
"16632","TBPL1",4,13,17,0.764705882352941,0.235294117647059,1
"16633","TBPL2",19,20,39,0.512820512820513,0.487179487179487,1
"16634","TBR1",34,32,66,0.484848484848485,0.515151515151515,1
"16635","TBRG1",3,6,9,0.666666666666667,0.333333333333333,1
"16636","TBRG4",18,31,49,0.63265306122449,0.36734693877551,1
"16637","TBX1",10,14,24,0.583333333333333,0.416666666666667,1
"16638","TBX10",13,34,47,0.723404255319149,0.276595744680851,1
"16639","TBX15",38,74,112,0.660714285714286,0.339285714285714,1
"16640","TBX18",46,84,130,0.646153846153846,0.353846153846154,1
"16641","TBX19",32,36,68,0.529411764705882,0.470588235294118,1
"16642","TBX2",16,37,53,0.69811320754717,0.30188679245283,1
"16643","TBX20",27,50,77,0.649350649350649,0.350649350649351,1
"16644","TBX21",14,41,55,0.745454545454545,0.254545454545455,1
"16645","TBX22",47,78,125,0.624,0.376,1
"16646","TBX3",30,67,97,0.690721649484536,0.309278350515464,1
"16647","TBX4",35,66,101,0.653465346534653,0.346534653465347,1
"16648","TBX5",51,82,133,0.616541353383459,0.383458646616541,1
"16649","TBX6",17,14,31,0.451612903225806,0.548387096774194,1
"16650","TBXA2R",11,18,29,0.620689655172414,0.379310344827586,1
"16651","TBXAS1",24,50,74,0.675675675675676,0.324324324324324,1
"16652","TBXT",39,51,90,0.566666666666667,0.433333333333333,1
"16653","TC2N",24,38,62,0.612903225806452,0.387096774193548,1
"16654","TCAF1",14,21,35,0.6,0.4,1
"16655","TCAF2",10,23,33,0.696969696969697,0.303030303030303,1
"16656","TCAIM",19,29,48,0.604166666666667,0.395833333333333,1
"16657","TCAP",4,6,10,0.6,0.4,1
"16658","TCEA1",8,15,23,0.652173913043478,0.347826086956522,1
"16659","TCEA2",21,22,43,0.511627906976744,0.488372093023256,1
"16660","TCEA3",10,16,26,0.615384615384615,0.384615384615385,1
"16661","TCEAL1",13,2,15,0.133333333333333,0.866666666666667,1
"16662","TCEAL2",12,17,29,0.586206896551724,0.413793103448276,1
"16663","TCEAL3",13,9,22,0.409090909090909,0.590909090909091,1
"16664","TCEAL4",12,8,20,0.4,0.6,1
"16665","TCEAL5",20,19,39,0.487179487179487,0.512820512820513,1
"16666","TCEAL6",27,25,52,0.480769230769231,0.519230769230769,1
"16667","TCEAL7",6,2,8,0.25,0.75,1
"16668","TCEAL8",3,4,7,0.571428571428571,0.428571428571429,1
"16669","TCEAL9",7,5,12,0.416666666666667,0.583333333333333,1
"16670","TCEANC",13,12,25,0.48,0.52,1
"16671","TCEANC2",4,11,15,0.733333333333333,0.266666666666667,1
"16672","TCERG1",68,93,161,0.577639751552795,0.422360248447205,1
"16673","TCERG1L",26,39,65,0.6,0.4,1
"16674","TCF12",43,65,108,0.601851851851852,0.398148148148148,1
"16675","TCF15",0,3,3,1,0,1
"16676","TCF19",12,17,29,0.586206896551724,0.413793103448276,1
"16677","TCF20",81,91,172,0.529069767441861,0.47093023255814,1
"16678","TCF21",7,25,32,0.78125,0.21875,1
"16679","TCF23",19,23,42,0.547619047619048,0.452380952380952,1
"16680","TCF25",32,35,67,0.522388059701492,0.477611940298507,1
"16681","TCF3",16,28,44,0.636363636363636,0.363636363636364,1
"16682","TCF4",49,70,119,0.588235294117647,0.411764705882353,1
"16683","TCF7",15,26,41,0.634146341463415,0.365853658536585,1
"16684","TCF7L1",17,24,41,0.585365853658537,0.414634146341463,1
"16685","TCF7L2",55,78,133,0.586466165413534,0.413533834586466,1
"16686","TCFL5",9,30,39,0.769230769230769,0.230769230769231,1
"16687","TCHH",111,184,295,0.623728813559322,0.376271186440678,1
"16688","TCHHL1",56,122,178,0.685393258426966,0.314606741573034,1
"16689","TCHP",15,31,46,0.673913043478261,0.326086956521739,1
"16690","TCIM",4,14,18,0.777777777777778,0.222222222222222,1
"16691","TCIRG1",16,32,48,0.666666666666667,0.333333333333333,1
"16692","TCL1A",9,20,29,0.689655172413793,0.310344827586207,1
"16693","TCL1B",10,16,26,0.615384615384615,0.384615384615385,1
"16694","TCN1",24,35,59,0.593220338983051,0.406779661016949,1
"16695","TCN2",20,33,53,0.622641509433962,0.377358490566038,1
"16696","TCOF1",33,54,87,0.620689655172414,0.379310344827586,1
"16697","TCP1",14,18,32,0.5625,0.4375,1
"16698","TCP10L",1,4,5,0.8,0.2,1
"16699","TCP10L3",16,16,32,0.5,0.5,1
"16700","TCP11",13,37,50,0.74,0.26,1
"16701","TCP11L1",14,24,38,0.631578947368421,0.368421052631579,1
"16702","TCP11L2",28,27,55,0.490909090909091,0.509090909090909,1
"16703","TCTA",1,9,10,0.9,0.1,1
"16704","TCTE1",27,46,73,0.63013698630137,0.36986301369863,1
"16705","TCTE3",4,10,14,0.714285714285714,0.285714285714286,1
"16706","TCTEX1D1",11,24,35,0.685714285714286,0.314285714285714,1
"16707","TCTEX1D2",5,14,19,0.736842105263158,0.263157894736842,1
"16708","TCTEX1D4",2,2,4,0.5,0.5,1
"16709","TCTN1",12,23,35,0.657142857142857,0.342857142857143,1
"16710","TCTN2",26,43,69,0.623188405797101,0.376811594202899,1
"16711","TCTN3",10,16,26,0.615384615384615,0.384615384615385,1
"16712","TDG",15,35,50,0.7,0.3,1
"16713","TDGF1",14,14,28,0.5,0.5,1
"16714","TDO2",21,41,62,0.661290322580645,0.338709677419355,1
"16715","TDP1",14,35,49,0.714285714285714,0.285714285714286,1
"16716","TDP2",13,28,41,0.682926829268293,0.317073170731707,1
"16717","TDRD1",47,108,155,0.696774193548387,0.303225806451613,1
"16718","TDRD10",15,40,55,0.727272727272727,0.272727272727273,1
"16719","TDRD12",0,4,4,1,0,1
"16720","TDRD15",3,13,16,0.8125,0.1875,1
"16721","TDRD3",35,58,93,0.623655913978495,0.376344086021505,1
"16722","TDRD5",61,147,208,0.706730769230769,0.293269230769231,1
"16723","TDRD6",76,153,229,0.668122270742358,0.331877729257642,1
"16724","TDRD7",35,47,82,0.573170731707317,0.426829268292683,1
"16725","TDRD9",22,61,83,0.734939759036145,0.265060240963855,1
"16726","TDRKH",18,33,51,0.647058823529412,0.352941176470588,1
"16727","TDRP",8,17,25,0.68,0.32,1
"16728","TEAD1",20,13,33,0.393939393939394,0.606060606060606,1
"16729","TEAD2",41,68,109,0.623853211009174,0.376146788990826,1
"16730","TEAD3",11,18,29,0.620689655172414,0.379310344827586,1
"16731","TEAD4",26,28,54,0.518518518518518,0.481481481481481,1
"16732","TEC",36,52,88,0.590909090909091,0.409090909090909,1
"16733","TECPR1",19,53,72,0.736111111111111,0.263888888888889,1
"16734","TECPR2",41,78,119,0.65546218487395,0.34453781512605,1
"16735","TECR",13,16,29,0.551724137931034,0.448275862068966,1
"16736","TECRL",47,85,132,0.643939393939394,0.356060606060606,1
"16737","TECTA",123,189,312,0.605769230769231,0.394230769230769,1
"16738","TECTB",20,29,49,0.591836734693878,0.408163265306122,1
"16739","TEDC1",5,8,13,0.615384615384615,0.384615384615385,1
"16740","TEDC2",8,13,21,0.619047619047619,0.380952380952381,1
"16741","TEDDM1",8,13,21,0.619047619047619,0.380952380952381,1
"16742","TEF",15,8,23,0.347826086956522,0.652173913043478,1
"16743","TEFM",13,17,30,0.566666666666667,0.433333333333333,1
"16744","TEK",52,98,150,0.653333333333333,0.346666666666667,1
"16745","TEKT1",24,36,60,0.6,0.4,1
"16746","TEKT2",11,16,27,0.592592592592593,0.407407407407407,1
"16747","TEKT3",21,45,66,0.681818181818182,0.318181818181818,1
"16748","TEKT4",30,34,64,0.53125,0.46875,1
"16749","TEKT5",25,40,65,0.615384615384615,0.384615384615385,1
"16750","TELO2",28,34,62,0.548387096774194,0.451612903225806,1
"16751","TENM1",285,237,522,0.454022988505747,0.545977011494253,1
"16752","TENM2",136,195,331,0.589123867069486,0.410876132930514,1
"16753","TENM3",165,329,494,0.665991902834008,0.334008097165992,1
"16754","TENM4",109,195,304,0.641447368421053,0.358552631578947,1
"16755","TENT2",20,32,52,0.615384615384615,0.384615384615385,1
"16756","TENT4A",41,41,82,0.5,0.5,1
"16757","TENT4B",19,21,40,0.525,0.475,1
"16758","TENT5A",12,19,31,0.612903225806452,0.387096774193548,1
"16759","TENT5B",7,20,27,0.740740740740741,0.259259259259259,1
"16760","TENT5C",16,29,45,0.644444444444444,0.355555555555556,1
"16761","TENT5D",49,36,85,0.423529411764706,0.576470588235294,1
"16762","TEP1",89,148,237,0.624472573839662,0.375527426160338,1
"16763","TEPP",13,10,23,0.434782608695652,0.565217391304348,1
"16764","TEPSIN",14,21,35,0.6,0.4,1
"16765","TERB1",0,3,3,1,0,1
"16766","TERB2",11,17,28,0.607142857142857,0.392857142857143,1
"16767","TERF1",12,31,43,0.720930232558139,0.27906976744186,1
"16768","TERF2",16,21,37,0.567567567567568,0.432432432432432,1
"16769","TERF2IP",9,15,24,0.625,0.375,1
"16770","TERT",38,31,69,0.449275362318841,0.550724637681159,1
"16771","TES",10,11,21,0.523809523809524,0.476190476190476,1
"16772","TESC",3,14,17,0.823529411764706,0.176470588235294,1
"16773","TESK1",20,23,43,0.534883720930233,0.465116279069767,1
"16774","TESK2",19,36,55,0.654545454545455,0.345454545454545,1
"16775","TESMIN",14,45,59,0.76271186440678,0.23728813559322,1
"16776","TESPA1",40,60,100,0.6,0.4,1
"16777","TET1",114,146,260,0.561538461538462,0.438461538461538,1
"16778","TET2",38,86,124,0.693548387096774,0.306451612903226,1
"16779","TET3",68,88,156,0.564102564102564,0.435897435897436,1
"16780","TEX10",39,45,84,0.535714285714286,0.464285714285714,1
"16781","TEX101",15,20,35,0.571428571428571,0.428571428571429,1
"16782","TEX11",61,42,103,0.407766990291262,0.592233009708738,1
"16783","TEX12",2,5,7,0.714285714285714,0.285714285714286,1
"16784","TEX13A",44,46,90,0.511111111111111,0.488888888888889,1
"16785","TEX13B",31,28,59,0.474576271186441,0.525423728813559,1
"16786","TEX14",47,103,150,0.686666666666667,0.313333333333333,1
"16787","TEX15",126,248,374,0.663101604278075,0.336898395721925,1
"16788","TEX19",7,16,23,0.695652173913043,0.304347826086957,1
"16789","TEX2",40,76,116,0.655172413793103,0.344827586206897,1
"16790","TEX26",11,29,40,0.725,0.275,1
"16791","TEX261",0,1,1,1,0,1
"16792","TEX264",6,15,21,0.714285714285714,0.285714285714286,1
"16793","TEX29",7,14,21,0.666666666666667,0.333333333333333,1
"16794","TEX30",11,17,28,0.607142857142857,0.392857142857143,1
"16795","TEX33",6,17,23,0.739130434782609,0.260869565217391,1
"16796","TEX35",17,27,44,0.613636363636364,0.386363636363636,1
"16797","TEX36",0,1,1,1,0,1
"16798","TEX37",21,13,34,0.382352941176471,0.617647058823529,1
"16799","TEX43",5,9,14,0.642857142857143,0.357142857142857,1
"16800","TEX44",11,30,41,0.731707317073171,0.268292682926829,1
"16801","TEX45",11,19,30,0.633333333333333,0.366666666666667,1
"16802","TEX47",32,35,67,0.522388059701492,0.477611940298507,1
"16803","TEX55",31,61,92,0.66304347826087,0.33695652173913,1
"16804","TEX9",9,22,31,0.709677419354839,0.290322580645161,1
"16805","TF",47,68,115,0.591304347826087,0.408695652173913,1
"16806","TFAM",11,11,22,0.5,0.5,1
"16807","TFAP2A",24,29,53,0.547169811320755,0.452830188679245,1
"16808","TFAP2B",36,51,87,0.586206896551724,0.413793103448276,1
"16809","TFAP2C",19,38,57,0.666666666666667,0.333333333333333,1
"16810","TFAP2D",53,81,134,0.604477611940298,0.395522388059701,1
"16811","TFAP2E",7,8,15,0.533333333333333,0.466666666666667,1
"16812","TFAP4",9,25,34,0.735294117647059,0.264705882352941,1
"16813","TFB1M",16,24,40,0.6,0.4,1
"16814","TFB2M",10,26,36,0.722222222222222,0.277777777777778,1
"16815","TFCP2",27,23,50,0.46,0.54,1
"16816","TFCP2L1",22,27,49,0.551020408163265,0.448979591836735,1
"16817","TFDP1",17,30,47,0.638297872340426,0.361702127659574,1
"16818","TFDP2",16,21,37,0.567567567567568,0.432432432432432,1
"16819","TFDP3",26,18,44,0.409090909090909,0.590909090909091,1
"16820","TFE3",42,29,71,0.408450704225352,0.591549295774648,1
"16821","TFEB",14,32,46,0.695652173913043,0.304347826086957,1
"16822","TFEC",32,55,87,0.632183908045977,0.367816091954023,1
"16823","TFF1",5,6,11,0.545454545454545,0.454545454545455,1
"16824","TFF2",5,5,10,0.5,0.5,1
"16825","TFF3",2,4,6,0.666666666666667,0.333333333333333,1
"16826","TFG",15,25,40,0.625,0.375,1
"16827","TFIP11",21,36,57,0.631578947368421,0.368421052631579,1
"16828","TFPI",17,29,46,0.630434782608696,0.369565217391304,1
"16829","TFPI2",18,24,42,0.571428571428571,0.428571428571429,1
"16830","TFPT",8,23,31,0.741935483870968,0.258064516129032,1
"16831","TFR2",22,32,54,0.592592592592593,0.407407407407407,1
"16832","TFRC",20,38,58,0.655172413793103,0.344827586206897,1
"16833","TG",171,275,446,0.616591928251121,0.383408071748879,1
"16834","TGDS",10,22,32,0.6875,0.3125,1
"16835","TGFA",8,7,15,0.466666666666667,0.533333333333333,1
"16836","TGFB1",13,15,28,0.535714285714286,0.464285714285714,1
"16837","TGFB1I1",16,32,48,0.666666666666667,0.333333333333333,1
"16838","TGFB2",24,39,63,0.619047619047619,0.380952380952381,1
"16839","TGFB3",10,16,26,0.615384615384615,0.384615384615385,1
"16840","TGFBI",22,34,56,0.607142857142857,0.392857142857143,1
"16841","TGFBR1",24,45,69,0.652173913043478,0.347826086956522,1
"16842","TGFBR2",49,70,119,0.588235294117647,0.411764705882353,1
"16843","TGFBR3",43,66,109,0.605504587155963,0.394495412844037,1
"16844","TGFBRAP1",41,61,102,0.598039215686274,0.401960784313726,1
"16845","TGIF1",14,27,41,0.658536585365854,0.341463414634146,1
"16846","TGIF2",7,18,25,0.72,0.28,1
"16847","TGIF2LX",41,58,99,0.585858585858586,0.414141414141414,1
"16848","TGIF2LY",0,17,17,1,0,1
"16849","TGM1",24,50,74,0.675675675675676,0.324324324324324,1
"16850","TGM2",21,49,70,0.7,0.3,1
"16851","TGM3",0,1,1,1,0,1
"16852","TGM4",41,78,119,0.65546218487395,0.34453781512605,1
"16853","TGM5",36,63,99,0.636363636363636,0.363636363636364,1
"16854","TGM6",61,74,135,0.548148148148148,0.451851851851852,1
"16855","TGM7",40,53,93,0.56989247311828,0.43010752688172,1
"16856","TGOLN2",18,20,38,0.526315789473684,0.473684210526316,1
"16857","TGS1",25,40,65,0.615384615384615,0.384615384615385,1
"16858","TH",16,27,43,0.627906976744186,0.372093023255814,1
"16859","THADA",41,94,135,0.696296296296296,0.303703703703704,1
"16860","THAP1",3,12,15,0.8,0.2,1
"16861","THAP10",3,16,19,0.842105263157895,0.157894736842105,1
"16862","THAP11",7,16,23,0.695652173913043,0.304347826086957,1
"16863","THAP12",31,55,86,0.63953488372093,0.36046511627907,1
"16864","THAP2",8,12,20,0.6,0.4,1
"16865","THAP3",7,12,19,0.631578947368421,0.368421052631579,1
"16866","THAP4",23,25,48,0.520833333333333,0.479166666666667,1
"16867","THAP5",8,14,22,0.636363636363636,0.363636363636364,1
"16868","THAP6",8,15,23,0.652173913043478,0.347826086956522,1
"16869","THAP7",5,8,13,0.615384615384615,0.384615384615385,1
"16870","THAP8",7,5,12,0.416666666666667,0.583333333333333,1
"16871","THAP9",31,30,61,0.491803278688525,0.508196721311475,1
"16872","THBD",16,16,32,0.5,0.5,1
"16873","THBS1",49,95,144,0.659722222222222,0.340277777777778,1
"16874","THBS2",78,117,195,0.6,0.4,1
"16875","THBS3",28,55,83,0.662650602409639,0.337349397590361,1
"16876","THBS4",32,60,92,0.652173913043478,0.347826086956522,1
"16877","THEG",27,32,59,0.542372881355932,0.457627118644068,1
"16878","THEM4",4,10,14,0.714285714285714,0.285714285714286,1
"16879","THEM5",7,19,26,0.730769230769231,0.269230769230769,1
"16880","THEMIS",67,127,194,0.654639175257732,0.345360824742268,1
"16881","THEMIS2",21,17,38,0.447368421052632,0.552631578947368,1
"16882","THG1L",12,15,27,0.555555555555556,0.444444444444444,1
"16883","THNSL1",24,34,58,0.586206896551724,0.413793103448276,1
"16884","THNSL2",20,27,47,0.574468085106383,0.425531914893617,1
"16885","THOC1",23,27,50,0.54,0.46,1
"16886","THOC2",140,59,199,0.296482412060302,0.703517587939699,1
"16887","THOC3",4,14,18,0.777777777777778,0.222222222222222,1
"16888","THOC5",22,42,64,0.65625,0.34375,1
"16889","THOC6",15,11,26,0.423076923076923,0.576923076923077,1
"16890","THOC7",5,9,14,0.642857142857143,0.357142857142857,1
"16891","THOP1",18,34,52,0.653846153846154,0.346153846153846,1
"16892","THPO",21,29,50,0.58,0.42,1
"16893","THRA",15,26,41,0.634146341463415,0.365853658536585,1
"16894","THRAP3",48,74,122,0.60655737704918,0.39344262295082,1
"16895","THRB",34,37,71,0.52112676056338,0.47887323943662,1
"16896","THRSP",6,11,17,0.647058823529412,0.352941176470588,1
"16897","THSD1",44,48,92,0.521739130434783,0.478260869565217,1
"16898","THSD4",41,89,130,0.684615384615385,0.315384615384615,1
"16899","THSD7A",114,210,324,0.648148148148148,0.351851851851852,1
"16900","THSD7B",149,370,519,0.712909441233141,0.287090558766859,1
"16901","THTPA",7,5,12,0.416666666666667,0.583333333333333,1
"16902","THUMPD1",6,13,19,0.684210526315789,0.315789473684211,1
"16903","THUMPD2",12,20,32,0.625,0.375,1
"16904","THUMPD3",13,17,30,0.566666666666667,0.433333333333333,1
"16905","THY1",5,14,19,0.736842105263158,0.263157894736842,1
"16906","THYN1",13,17,30,0.566666666666667,0.433333333333333,1
"16907","TIA1",16,17,33,0.515151515151515,0.484848484848485,1
"16908","TIAF1",6,10,16,0.625,0.375,1
"16909","TIAL1",17,22,39,0.564102564102564,0.435897435897436,1
"16910","TIAM1",106,176,282,0.624113475177305,0.375886524822695,1
"16911","TIAM2",77,124,201,0.616915422885572,0.383084577114428,1
"16912","TICAM1",24,47,71,0.661971830985915,0.338028169014085,1
"16913","TICAM2",0,1,1,1,0,1
"16914","TICRR",43,87,130,0.669230769230769,0.330769230769231,1
"16915","TIE1",66,97,163,0.595092024539877,0.404907975460123,1
"16916","TIFA",5,4,9,0.444444444444444,0.555555555555556,1
"16917","TIFAB",6,17,23,0.739130434782609,0.260869565217391,1
"16918","TIGAR",7,18,25,0.72,0.28,0.77
"16919","TIGD1",0,2,2,1,0,1
"16920","TIGD2",19,34,53,0.641509433962264,0.358490566037736,1
"16921","TIGD3",21,37,58,0.637931034482759,0.362068965517241,1
"16922","TIGD4",18,44,62,0.709677419354839,0.290322580645161,1
"16923","TIGD5",15,18,33,0.545454545454545,0.454545454545455,1
"16924","TIGD6",9,15,24,0.625,0.375,1
"16925","TIGD7",20,33,53,0.622641509433962,0.377358490566038,1
"16926","TIGIT",16,25,41,0.609756097560976,0.390243902439024,1
"16927","TIMD4",31,65,96,0.677083333333333,0.322916666666667,1
"16928","TIMELESS",46,74,120,0.616666666666667,0.383333333333333,1
"16929","TIMM10",3,0,3,0,1,1
"16930","TIMM10B",4,3,7,0.428571428571429,0.571428571428571,1
"16931","TIMM13",0,3,3,1,0,1
"16932","TIMM17A",3,16,19,0.842105263157895,0.157894736842105,1
"16933","TIMM17B",16,2,18,0.111111111111111,0.888888888888889,1
"16934","TIMM21",8,9,17,0.529411764705882,0.470588235294118,1
"16935","TIMM22",3,9,12,0.75,0.25,1
"16936","TIMM23",8,6,14,0.428571428571429,0.571428571428571,1
"16937","TIMM29",3,3,6,0.5,0.5,1
"16938","TIMM44",20,20,40,0.5,0.5,1
"16939","TIMM50",15,16,31,0.516129032258065,0.483870967741935,1
"16940","TIMM8A",6,4,10,0.4,0.6,1
"16941","TIMM8B",4,4,8,0.5,0.5,1
"16942","TIMM9",1,3,4,0.75,0.25,1
"16943","TIMMDC1",7,18,25,0.72,0.28,1
"16944","TIMP1",8,7,15,0.466666666666667,0.533333333333333,1
"16945","TIMP2",5,15,20,0.75,0.25,1
"16946","TIMP3",21,30,51,0.588235294117647,0.411764705882353,1
"16947","TIMP4",2,22,24,0.916666666666667,0.0833333333333333,1
"16948","TINAG",50,68,118,0.576271186440678,0.423728813559322,1
"16949","TINAGL1",17,25,42,0.595238095238095,0.404761904761905,0.62
"16950","TINF2",19,16,35,0.457142857142857,0.542857142857143,1
"16951","TIPARP",22,34,56,0.607142857142857,0.392857142857143,0.77
"16952","TIPIN",10,8,18,0.444444444444444,0.555555555555556,1
"16953","TIPRL",6,14,20,0.7,0.3,1
"16954","TIRAP",9,3,12,0.25,0.75,1
"16955","TJAP1",14,30,44,0.681818181818182,0.318181818181818,1
"16956","TJP1",55,110,165,0.666666666666667,0.333333333333333,1
"16957","TJP2",40,51,91,0.56043956043956,0.43956043956044,1
"16958","TJP3",36,54,90,0.6,0.4,1
"16959","TK1",6,7,13,0.538461538461538,0.461538461538462,1
"16960","TK2",9,7,16,0.4375,0.5625,1
"16961","TKFC",24,29,53,0.547169811320755,0.452830188679245,1
"16962","TKT",15,27,42,0.642857142857143,0.357142857142857,1
"16963","TKTL1",43,26,69,0.376811594202899,0.623188405797101,1
"16964","TKTL2",76,100,176,0.568181818181818,0.431818181818182,1
"16965","TLCD1",8,11,19,0.578947368421053,0.421052631578947,1
"16966","TLCD3A",7,6,13,0.461538461538462,0.538461538461538,1
"16967","TLCD3B",16,22,38,0.578947368421053,0.421052631578947,1
"16968","TLCD4",5,17,22,0.772727272727273,0.227272727272727,1
"16969","TLCD4-RWDD3",1,0,1,0,1,1
"16970","TLCD5",3,4,7,0.571428571428571,0.428571428571429,1
"16971","TLDC2",7,22,29,0.758620689655172,0.241379310344828,1
"16972","TLE1",40,34,74,0.459459459459459,0.540540540540541,1
"16973","TLE2",26,32,58,0.551724137931034,0.448275862068966,1
"16974","TLE3",24,33,57,0.578947368421053,0.421052631578947,1
"16975","TLE4",47,85,132,0.643939393939394,0.356060606060606,1
"16976","TLE5",0,11,11,1,0,1
"16977","TLE6",21,27,48,0.5625,0.4375,1
"16978","TLK1",21,49,70,0.7,0.3,1
"16979","TLK2",23,57,80,0.7125,0.2875,1
"16980","TLL1",112,185,297,0.622895622895623,0.377104377104377,1
"16981","TLL2",54,102,156,0.653846153846154,0.346153846153846,1
"16982","TLN1",79,114,193,0.590673575129534,0.409326424870466,1
"16983","TLN2",95,148,243,0.609053497942387,0.390946502057613,1
"16984","TLNRD1",6,10,16,0.625,0.375,1
"16985","TLR1",35,41,76,0.539473684210526,0.460526315789474,1
"16986","TLR10",31,67,98,0.683673469387755,0.316326530612245,1
"16987","TLR2",30,55,85,0.647058823529412,0.352941176470588,1
"16988","TLR3",31,68,99,0.686868686868687,0.313131313131313,1
"16989","TLR4",87,177,264,0.670454545454545,0.329545454545455,1
"16990","TLR5",37,75,112,0.669642857142857,0.330357142857143,1
"16991","TLR6",35,39,74,0.527027027027027,0.472972972972973,1
"16992","TLR7",60,64,124,0.516129032258065,0.483870967741935,1
"16993","TLR8",62,62,124,0.5,0.5,1
"16994","TLR9",44,57,101,0.564356435643564,0.435643564356436,1
"16995","TLX1",13,14,27,0.518518518518518,0.481481481481481,1
"16996","TLX1NB",4,5,9,0.555555555555556,0.444444444444444,1
"16997","TLX2",10,5,15,0.333333333333333,0.666666666666667,1
"16998","TLX3",14,22,36,0.611111111111111,0.388888888888889,1
"16999","TM2D1",11,7,18,0.388888888888889,0.611111111111111,1
"17000","TM2D2",8,12,20,0.6,0.4,1
"17001","TM2D3",7,11,18,0.611111111111111,0.388888888888889,1
"17002","TM4SF1",15,16,31,0.516129032258065,0.483870967741935,1
"17003","TM4SF18",7,9,16,0.5625,0.4375,1
"17004","TM4SF19",6,21,27,0.777777777777778,0.222222222222222,1
"17005","TM4SF20",12,5,17,0.294117647058824,0.705882352941177,1
"17006","TM4SF4",10,26,36,0.722222222222222,0.277777777777778,1
"17007","TM4SF5",7,19,26,0.730769230769231,0.269230769230769,1
"17008","TM6SF1",16,31,47,0.659574468085106,0.340425531914894,1
"17009","TM6SF2",12,24,36,0.666666666666667,0.333333333333333,1
"17010","TM7SF2",11,18,29,0.620689655172414,0.379310344827586,1
"17011","TM7SF3",27,40,67,0.597014925373134,0.402985074626866,1
"17012","TM9SF1",0,1,1,1,0,1
"17013","TM9SF2",30,34,64,0.53125,0.46875,1
"17014","TM9SF3",33,45,78,0.576923076923077,0.423076923076923,1
"17015","TM9SF4",26,44,70,0.628571428571429,0.371428571428571,1
"17016","TMA16",11,19,30,0.633333333333333,0.366666666666667,1
"17017","TMA7",0,2,2,1,0,1
"17018","TMBIM1",6,8,14,0.571428571428571,0.428571428571429,1
"17019","TMBIM4",15,18,33,0.545454545454545,0.454545454545455,1
"17020","TMBIM6",3,12,15,0.8,0.2,1
"17021","TMC1",31,63,94,0.670212765957447,0.329787234042553,1
"17022","TMC2",52,78,130,0.6,0.4,1
"17023","TMC3",48,63,111,0.567567567567568,0.432432432432432,1
"17024","TMC4",29,43,72,0.597222222222222,0.402777777777778,1
"17025","TMC5",60,110,170,0.647058823529412,0.352941176470588,1
"17026","TMC6",16,32,48,0.666666666666667,0.333333333333333,1
"17027","TMC7",27,57,84,0.678571428571429,0.321428571428571,1
"17028","TMC8",22,15,37,0.405405405405405,0.594594594594595,1
"17029","TMCC1",26,50,76,0.657894736842105,0.342105263157895,1
"17030","TMCC2",25,34,59,0.576271186440678,0.423728813559322,1
"17031","TMCC3",28,47,75,0.626666666666667,0.373333333333333,1
"17032","TMCO1",6,12,18,0.666666666666667,0.333333333333333,1
"17033","TMCO2",9,8,17,0.470588235294118,0.529411764705882,1
"17034","TMCO3",25,40,65,0.615384615384615,0.384615384615385,1
"17035","TMCO4",32,38,70,0.542857142857143,0.457142857142857,1
"17036","TMCO5A",16,30,46,0.652173913043478,0.347826086956522,1
"17037","TMCO6",16,21,37,0.567567567567568,0.432432432432432,1
"17038","TMED1",9,13,22,0.590909090909091,0.409090909090909,1
"17039","TMED10",12,9,21,0.428571428571429,0.571428571428571,1
"17040","TMED2",7,9,16,0.5625,0.4375,1
"17041","TMED3",5,9,14,0.642857142857143,0.357142857142857,1
"17042","TMED4",7,6,13,0.461538461538462,0.538461538461538,1
"17043","TMED5",5,10,15,0.666666666666667,0.333333333333333,1
"17044","TMED6",4,13,17,0.764705882352941,0.235294117647059,1
"17045","TMED7",4,9,13,0.692307692307692,0.307692307692308,1
"17046","TMED7-TICAM2",5,9,14,0.642857142857143,0.357142857142857,1
"17047","TMED8",9,22,31,0.709677419354839,0.290322580645161,1
"17048","TMED9",3,7,10,0.7,0.3,1
"17049","TMEFF1",19,23,42,0.547619047619048,0.452380952380952,1
"17050","TMEFF2",23,43,66,0.651515151515151,0.348484848484849,1
"17051","TMEM100",12,18,30,0.6,0.4,1
"17052","TMEM101",5,10,15,0.666666666666667,0.333333333333333,1
"17053","TMEM102",6,16,22,0.727272727272727,0.272727272727273,1
"17054","TMEM104",26,23,49,0.469387755102041,0.530612244897959,1
"17055","TMEM105",7,17,24,0.708333333333333,0.291666666666667,1
"17056","TMEM106A",8,6,14,0.428571428571429,0.571428571428571,1
"17057","TMEM106B",10,15,25,0.6,0.4,1
"17058","TMEM106C",8,14,22,0.636363636363636,0.363636363636364,1
"17059","TMEM107",4,8,12,0.666666666666667,0.333333333333333,1
"17060","TMEM108",23,53,76,0.697368421052632,0.302631578947368,1
"17061","TMEM109",11,20,31,0.645161290322581,0.354838709677419,1
"17062","TMEM11",3,13,16,0.8125,0.1875,1
"17063","TMEM115",3,11,14,0.785714285714286,0.214285714285714,1
"17064","TMEM116",4,12,16,0.75,0.25,1
"17065","TMEM117",27,35,62,0.564516129032258,0.435483870967742,1
"17066","TMEM119",13,33,46,0.717391304347826,0.282608695652174,1
"17067","TMEM120A",9,9,18,0.5,0.5,1
"17068","TMEM120B",6,12,18,0.666666666666667,0.333333333333333,1
"17069","TMEM121",7,1,8,0.125,0.875,1
"17070","TMEM121B",8,19,27,0.703703703703704,0.296296296296296,1
"17071","TMEM123",2,11,13,0.846153846153846,0.153846153846154,1
"17072","TMEM125",6,7,13,0.538461538461538,0.461538461538462,1
"17073","TMEM126A",3,5,8,0.625,0.375,1
"17074","TMEM126B",5,4,9,0.444444444444444,0.555555555555556,1
"17075","TMEM127",7,6,13,0.461538461538462,0.538461538461538,1
"17076","TMEM128",4,7,11,0.636363636363636,0.363636363636364,1
"17077","TMEM129",2,4,6,0.666666666666667,0.333333333333333,1
"17078","TMEM130",27,26,53,0.490566037735849,0.509433962264151,1
"17079","TMEM131",54,93,147,0.63265306122449,0.36734693877551,1
"17080","TMEM131L",51,78,129,0.604651162790698,0.395348837209302,1
"17081","TMEM132A",34,82,116,0.706896551724138,0.293103448275862,1
"17082","TMEM132B",90,198,288,0.6875,0.3125,1
"17083","TMEM132C",1,1,2,0.5,0.5,1
"17084","TMEM132D",139,224,363,0.617079889807163,0.382920110192837,1
"17085","TMEM132E",58,80,138,0.579710144927536,0.420289855072464,1
"17086","TMEM134",5,1,6,0.166666666666667,0.833333333333333,1
"17087","TMEM135",25,33,58,0.568965517241379,0.431034482758621,1
"17088","TMEM138",4,11,15,0.733333333333333,0.266666666666667,1
"17089","TMEM139",7,15,22,0.681818181818182,0.318181818181818,1
"17090","TMEM140",11,9,20,0.45,0.55,1
"17091","TMEM141",3,4,7,0.571428571428571,0.428571428571429,1
"17092","TMEM143",9,18,27,0.666666666666667,0.333333333333333,1
"17093","TMEM144",15,21,36,0.583333333333333,0.416666666666667,1
"17094","TMEM145",18,37,55,0.672727272727273,0.327272727272727,1
"17095","TMEM147",6,8,14,0.571428571428571,0.428571428571429,1
"17096","TMEM14A",4,1,5,0.2,0.8,1
"17097","TMEM14B",5,7,12,0.583333333333333,0.416666666666667,1
"17098","TMEM14C",1,6,7,0.857142857142857,0.142857142857143,1
"17099","TMEM150A",9,5,14,0.357142857142857,0.642857142857143,1
"17100","TMEM150B",9,8,17,0.470588235294118,0.529411764705882,1
"17101","TMEM150C",9,14,23,0.608695652173913,0.391304347826087,1
"17102","TMEM151A",9,27,36,0.75,0.25,1
"17103","TMEM151B",0,1,1,1,0,1
"17104","TMEM154",10,15,25,0.6,0.4,1
"17105","TMEM155",6,7,13,0.538461538461538,0.461538461538462,1
"17106","TMEM156",15,25,40,0.625,0.375,1
"17107","TMEM158",2,1,3,0.333333333333333,0.666666666666667,1
"17108","TMEM159",9,6,15,0.4,0.6,1
"17109","TMEM160",1,1,2,0.5,0.5,1
"17110","TMEM161A",10,21,31,0.67741935483871,0.32258064516129,1
"17111","TMEM161B",24,25,49,0.510204081632653,0.489795918367347,1
"17112","TMEM163",9,18,27,0.666666666666667,0.333333333333333,1
"17113","TMEM164",17,8,25,0.32,0.68,1
"17114","TMEM165",7,18,25,0.72,0.28,1
"17115","TMEM167A",2,7,9,0.777777777777778,0.222222222222222,1
"17116","TMEM167B",1,1,2,0.5,0.5,1
"17117","TMEM168",40,56,96,0.583333333333333,0.416666666666667,1
"17118","TMEM169",13,28,41,0.682926829268293,0.317073170731707,1
"17119","TMEM17",7,8,15,0.533333333333333,0.466666666666667,1
"17120","TMEM170A",3,4,7,0.571428571428571,0.428571428571429,1
"17121","TMEM170B",8,6,14,0.428571428571429,0.571428571428571,1
"17122","TMEM171",13,17,30,0.566666666666667,0.433333333333333,1
"17123","TMEM174",14,18,32,0.5625,0.4375,1
"17124","TMEM175",23,35,58,0.603448275862069,0.396551724137931,1
"17125","TMEM176A",8,29,37,0.783783783783784,0.216216216216216,1
"17126","TMEM176B",16,30,46,0.652173913043478,0.347826086956522,1
"17127","TMEM177",15,26,41,0.634146341463415,0.365853658536585,1
"17128","TMEM178A",16,24,40,0.6,0.4,1
"17129","TMEM179",2,8,10,0.8,0.2,1
"17130","TMEM179B",9,7,16,0.4375,0.5625,1
"17131","TMEM18",7,13,20,0.65,0.35,1
"17132","TMEM181",13,21,34,0.617647058823529,0.382352941176471,1
"17133","TMEM182",13,17,30,0.566666666666667,0.433333333333333,1
"17134","TMEM183A",15,11,26,0.423076923076923,0.576923076923077,1
"17135","TMEM183B",32,37,69,0.536231884057971,0.463768115942029,1
"17136","TMEM184A",23,19,42,0.452380952380952,0.547619047619048,1
"17137","TMEM184B",13,13,26,0.5,0.5,1
"17138","TMEM184C",7,26,33,0.787878787878788,0.212121212121212,1
"17139","TMEM185A",29,19,48,0.395833333333333,0.604166666666667,1
"17140","TMEM186",7,12,19,0.631578947368421,0.368421052631579,1
"17141","TMEM187",13,8,21,0.380952380952381,0.619047619047619,1
"17142","TMEM19",10,19,29,0.655172413793103,0.344827586206897,1
"17143","TMEM190",9,16,25,0.64,0.36,1
"17144","TMEM192",10,11,21,0.523809523809524,0.476190476190476,1
"17145","TMEM196",11,16,27,0.592592592592593,0.407407407407407,1
"17146","TMEM198",21,27,48,0.5625,0.4375,1
"17147","TMEM199",1,17,18,0.944444444444444,0.0555555555555556,1
"17148","TMEM200A",61,119,180,0.661111111111111,0.338888888888889,1
"17149","TMEM200B",8,3,11,0.272727272727273,0.727272727272727,1
"17150","TMEM200C",28,39,67,0.582089552238806,0.417910447761194,1
"17151","TMEM201",9,18,27,0.666666666666667,0.333333333333333,1
"17152","TMEM202",13,39,52,0.75,0.25,1
"17153","TMEM203",5,5,10,0.5,0.5,1
"17154","TMEM204",8,3,11,0.272727272727273,0.727272727272727,1
"17155","TMEM205",4,9,13,0.692307692307692,0.307692307692308,1
"17156","TMEM207",4,19,23,0.826086956521739,0.173913043478261,1
"17157","TMEM208",5,7,12,0.583333333333333,0.416666666666667,1
"17158","TMEM209",13,20,33,0.606060606060606,0.393939393939394,1
"17159","TMEM211",4,11,15,0.733333333333333,0.266666666666667,1
"17160","TMEM213",3,6,9,0.666666666666667,0.333333333333333,1
"17161","TMEM214",14,29,43,0.674418604651163,0.325581395348837,1
"17162","TMEM215",16,16,32,0.5,0.5,1
"17163","TMEM216",3,3,6,0.5,0.5,1
"17164","TMEM217",18,9,27,0.333333333333333,0.666666666666667,1
"17165","TMEM218",8,5,13,0.384615384615385,0.615384615384615,1
"17166","TMEM219",4,10,14,0.714285714285714,0.285714285714286,1
"17167","TMEM220",3,4,7,0.571428571428571,0.428571428571429,1
"17168","TMEM222",8,12,20,0.6,0.4,1
"17169","TMEM223",4,6,10,0.6,0.4,1
"17170","TMEM225",18,45,63,0.714285714285714,0.285714285714286,1
"17171","TMEM229B",4,12,16,0.75,0.25,1
"17172","TMEM230",5,7,12,0.583333333333333,0.416666666666667,1
"17173","TMEM231",1,6,7,0.857142857142857,0.142857142857143,1
"17174","TMEM232",1,1,2,0.5,0.5,1
"17175","TMEM233",0,1,1,1,0,1
"17176","TMEM234",3,2,5,0.4,0.6,1
"17177","TMEM236",23,32,55,0.581818181818182,0.418181818181818,1
"17178","TMEM237",13,14,27,0.518518518518518,0.481481481481481,1
"17179","TMEM241",9,19,28,0.678571428571429,0.321428571428571,1
"17180","TMEM242",7,8,15,0.533333333333333,0.466666666666667,1
"17181","TMEM243",4,3,7,0.428571428571429,0.571428571428571,1
"17182","TMEM244",7,18,25,0.72,0.28,1
"17183","TMEM245",19,22,41,0.536585365853659,0.463414634146341,1
"17184","TMEM247",0,1,1,1,0,1
"17185","TMEM248",9,26,35,0.742857142857143,0.257142857142857,1
"17186","TMEM25",14,13,27,0.481481481481481,0.518518518518518,1
"17187","TMEM250",2,5,7,0.714285714285714,0.285714285714286,1
"17188","TMEM251",7,5,12,0.416666666666667,0.583333333333333,1
"17189","TMEM252",4,23,27,0.851851851851852,0.148148148148148,1
"17190","TMEM254",1,6,7,0.857142857142857,0.142857142857143,1
"17191","TMEM255A",26,21,47,0.446808510638298,0.553191489361702,1
"17192","TMEM255B",17,35,52,0.673076923076923,0.326923076923077,1
"17193","TMEM256",4,2,6,0.333333333333333,0.666666666666667,1
"17194","TMEM258",4,6,10,0.6,0.4,1
"17195","TMEM259",13,12,25,0.48,0.52,1
"17196","TMEM26",21,33,54,0.611111111111111,0.388888888888889,1
"17197","TMEM260",26,35,61,0.573770491803279,0.426229508196721,1
"17198","TMEM263",1,3,4,0.75,0.25,1
"17199","TMEM266",20,42,62,0.67741935483871,0.32258064516129,1
"17200","TMEM267",9,13,22,0.590909090909091,0.409090909090909,1
"17201","TMEM268",6,9,15,0.6,0.4,1
"17202","TMEM269",0,2,2,1,0,1
"17203","TMEM270",10,17,27,0.62962962962963,0.37037037037037,1
"17204","TMEM273",4,12,16,0.75,0.25,1
"17205","TMEM30A",11,24,35,0.685714285714286,0.314285714285714,1
"17206","TMEM30B",2,7,9,0.777777777777778,0.222222222222222,1
"17207","TMEM31",7,7,14,0.5,0.5,1
"17208","TMEM33",9,9,18,0.5,0.5,1
"17209","TMEM35A",16,7,23,0.304347826086957,0.695652173913043,1
"17210","TMEM37",9,14,23,0.608695652173913,0.391304347826087,1
"17211","TMEM38A",16,23,39,0.58974358974359,0.41025641025641,1
"17212","TMEM38B",17,25,42,0.595238095238095,0.404761904761905,1
"17213","TMEM39A",26,18,44,0.409090909090909,0.590909090909091,1
"17214","TMEM39B",9,14,23,0.608695652173913,0.391304347826087,1
"17215","TMEM40",5,16,21,0.761904761904762,0.238095238095238,1
"17216","TMEM41A",13,18,31,0.580645161290323,0.419354838709677,1
"17217","TMEM41B",4,13,17,0.764705882352941,0.235294117647059,1
"17218","TMEM42",1,2,3,0.666666666666667,0.333333333333333,1
"17219","TMEM43",13,14,27,0.518518518518518,0.481481481481481,1
"17220","TMEM44",9,20,29,0.689655172413793,0.310344827586207,1
"17221","TMEM45A",5,17,22,0.772727272727273,0.227272727272727,1
"17222","TMEM45B",9,17,26,0.653846153846154,0.346153846153846,1
"17223","TMEM47",18,3,21,0.142857142857143,0.857142857142857,1
"17224","TMEM50A",8,10,18,0.555555555555556,0.444444444444444,1
"17225","TMEM50B",4,7,11,0.636363636363636,0.363636363636364,1
"17226","TMEM51",16,20,36,0.555555555555556,0.444444444444444,1
"17227","TMEM52",7,9,16,0.5625,0.4375,1
"17228","TMEM52B",10,25,35,0.714285714285714,0.285714285714286,1
"17229","TMEM53",10,15,25,0.6,0.4,1
"17230","TMEM54",10,5,15,0.333333333333333,0.666666666666667,1
"17231","TMEM59",4,17,21,0.80952380952381,0.19047619047619,1
"17232","TMEM59L",9,22,31,0.709677419354839,0.290322580645161,1
"17233","TMEM60",17,17,34,0.5,0.5,1
"17234","TMEM61",13,13,26,0.5,0.5,1
"17235","TMEM62",13,26,39,0.666666666666667,0.333333333333333,1
"17236","TMEM63A",20,36,56,0.642857142857143,0.357142857142857,1
"17237","TMEM63B",23,40,63,0.634920634920635,0.365079365079365,1
"17238","TMEM63C",26,52,78,0.666666666666667,0.333333333333333,1
"17239","TMEM64",11,15,26,0.576923076923077,0.423076923076923,1
"17240","TMEM65",4,12,16,0.75,0.25,1
"17241","TMEM67",28,60,88,0.681818181818182,0.318181818181818,1
"17242","TMEM68",3,12,15,0.8,0.2,1
"17243","TMEM69",1,11,12,0.916666666666667,0.0833333333333333,1
"17244","TMEM70",5,9,14,0.642857142857143,0.357142857142857,1
"17245","TMEM71",17,27,44,0.613636363636364,0.386363636363636,1
"17246","TMEM72",13,22,35,0.628571428571429,0.371428571428571,1
"17247","TMEM74",36,46,82,0.560975609756098,0.439024390243902,1
"17248","TMEM74B",5,21,26,0.807692307692308,0.192307692307692,1
"17249","TMEM78",0,1,1,1,0,1
"17250","TMEM79",15,27,42,0.642857142857143,0.357142857142857,1
"17251","TMEM80",3,4,7,0.571428571428571,0.428571428571429,1
"17252","TMEM81",8,21,29,0.724137931034483,0.275862068965517,1
"17253","TMEM82",8,14,22,0.636363636363636,0.363636363636364,1
"17254","TMEM86A",8,7,15,0.466666666666667,0.533333333333333,1
"17255","TMEM86B",3,3,6,0.5,0.5,1
"17256","TMEM87A",13,22,35,0.628571428571429,0.371428571428571,1
"17257","TMEM87B",18,24,42,0.571428571428571,0.428571428571429,1
"17258","TMEM88",4,8,12,0.666666666666667,0.333333333333333,1
"17259","TMEM89",7,10,17,0.588235294117647,0.411764705882353,1
"17260","TMEM8B",20,22,42,0.523809523809524,0.476190476190476,1
"17261","TMEM9",2,11,13,0.846153846153846,0.153846153846154,1
"17262","TMEM91",4,3,7,0.428571428571429,0.571428571428571,1
"17263","TMEM92",9,13,22,0.590909090909091,0.409090909090909,1
"17264","TMEM94",42,75,117,0.641025641025641,0.358974358974359,1
"17265","TMEM95",7,7,14,0.5,0.5,1
"17266","TMEM97",14,8,22,0.363636363636364,0.636363636363636,1
"17267","TMEM98",7,13,20,0.65,0.35,1
"17268","TMEM99",17,11,28,0.392857142857143,0.607142857142857,1
"17269","TMEM9B",2,5,7,0.714285714285714,0.285714285714286,1
"17270","TMF1",27,60,87,0.689655172413793,0.310344827586207,1
"17271","TMIE",0,7,7,1,0,1
"17272","TMIGD1",15,18,33,0.545454545454545,0.454545454545455,1
"17273","TMIGD2",14,25,39,0.641025641025641,0.358974358974359,1
"17274","TMIGD3",6,22,28,0.785714285714286,0.214285714285714,1
"17275","TMLHE",20,15,35,0.428571428571429,0.571428571428571,1
"17276","TMOD1",12,20,32,0.625,0.375,1
"17277","TMOD2",14,16,30,0.533333333333333,0.466666666666667,1
"17278","TMOD3",11,17,28,0.607142857142857,0.392857142857143,1
"17279","TMOD4",12,11,23,0.478260869565217,0.521739130434783,1
"17280","TMPO",40,57,97,0.587628865979381,0.412371134020619,1
"17281","TMPPE",10,18,28,0.642857142857143,0.357142857142857,1
"17282","TMPRSS11A",30,49,79,0.620253164556962,0.379746835443038,1
"17283","TMPRSS11B",22,63,85,0.741176470588235,0.258823529411765,1
"17284","TMPRSS11BNL",1,1,2,0.5,0.5,1
"17285","TMPRSS11D",21,45,66,0.681818181818182,0.318181818181818,1
"17286","TMPRSS11E",28,53,81,0.654320987654321,0.345679012345679,1
"17287","TMPRSS11F",39,55,94,0.585106382978723,0.414893617021277,1
"17288","TMPRSS12",20,26,46,0.565217391304348,0.434782608695652,1
"17289","TMPRSS13",21,28,49,0.571428571428571,0.428571428571429,1
"17290","TMPRSS15",79,145,224,0.647321428571429,0.352678571428571,1
"17291","TMPRSS2",16,26,42,0.619047619047619,0.380952380952381,1
"17292","TMPRSS3",24,32,56,0.571428571428571,0.428571428571429,1
"17293","TMPRSS4",10,24,34,0.705882352941177,0.294117647058824,1
"17294","TMPRSS5",4,13,17,0.764705882352941,0.235294117647059,1
"17295","TMPRSS6",35,54,89,0.606741573033708,0.393258426966292,1
"17296","TMPRSS7",33,45,78,0.576923076923077,0.423076923076923,1
"17297","TMPRSS9",30,49,79,0.620253164556962,0.379746835443038,1
"17298","TMSB10",2,2,4,0.5,0.5,1
"17299","TMSB15A",4,4,8,0.5,0.5,1
"17300","TMSB4X",12,1,13,0.0769230769230769,0.923076923076923,1
"17301","TMSB4Y",0,2,2,1,0,1
"17302","TMTC1",68,68,136,0.5,0.5,1
"17303","TMTC2",50,62,112,0.553571428571429,0.446428571428571,1
"17304","TMTC3",39,61,100,0.61,0.39,1
"17305","TMTC4",30,40,70,0.571428571428571,0.428571428571429,1
"17306","TMUB1",6,6,12,0.5,0.5,1
"17307","TMUB2",10,13,23,0.565217391304348,0.434782608695652,1
"17308","TMX1",6,13,19,0.684210526315789,0.315789473684211,1
"17309","TMX2",12,14,26,0.538461538461538,0.461538461538462,1
"17310","TMX3",17,34,51,0.666666666666667,0.333333333333333,1
"17311","TMX4",11,24,35,0.685714285714286,0.314285714285714,1
"17312","TNC",123,151,274,0.551094890510949,0.448905109489051,1
"17313","TNF",8,15,23,0.652173913043478,0.347826086956522,1
"17314","TNFAIP1",16,10,26,0.384615384615385,0.615384615384615,1
"17315","TNFAIP2",13,16,29,0.551724137931034,0.448275862068966,1
"17316","TNFAIP3",31,43,74,0.581081081081081,0.418918918918919,1
"17317","TNFAIP6",7,33,40,0.825,0.175,1
"17318","TNFAIP8",7,5,12,0.416666666666667,0.583333333333333,1
"17319","TNFAIP8L1",0,4,4,1,0,1
"17320","TNFAIP8L2",11,12,23,0.521739130434783,0.478260869565217,1
"17321","TNFAIP8L3",13,18,31,0.580645161290323,0.419354838709677,1
"17322","TNFRSF10A",17,26,43,0.604651162790698,0.395348837209302,1
"17323","TNFRSF10B",10,30,40,0.75,0.25,1
"17324","TNFRSF10C",4,12,16,0.75,0.25,1
"17325","TNFRSF10D",8,16,24,0.666666666666667,0.333333333333333,1
"17326","TNFRSF11A",17,45,62,0.725806451612903,0.274193548387097,1
"17327","TNFRSF11B",14,45,59,0.76271186440678,0.23728813559322,1
"17328","TNFRSF12A",3,4,7,0.571428571428571,0.428571428571429,1
"17329","TNFRSF13B",17,30,47,0.638297872340426,0.361702127659574,1
"17330","TNFRSF13C",8,6,14,0.428571428571429,0.571428571428571,1
"17331","TNFRSF14",6,15,21,0.714285714285714,0.285714285714286,1
"17332","TNFRSF17",11,10,21,0.476190476190476,0.523809523809524,1
"17333","TNFRSF18",7,10,17,0.588235294117647,0.411764705882353,1
"17334","TNFRSF19",19,33,52,0.634615384615385,0.365384615384615,1
"17335","TNFRSF1A",15,19,34,0.558823529411765,0.441176470588235,1
"17336","TNFRSF1B",8,19,27,0.703703703703704,0.296296296296296,1
"17337","TNFRSF21",28,38,66,0.575757575757576,0.424242424242424,1
"17338","TNFRSF25",12,20,32,0.625,0.375,1
"17339","TNFRSF4",7,15,22,0.681818181818182,0.318181818181818,1
"17340","TNFRSF6B",8,7,15,0.466666666666667,0.533333333333333,1
"17341","TNFRSF8",30,53,83,0.63855421686747,0.36144578313253,1
"17342","TNFRSF9",16,29,45,0.644444444444444,0.355555555555556,1
"17343","TNFSF10",15,21,36,0.583333333333333,0.416666666666667,1
"17344","TNFSF11",14,23,37,0.621621621621622,0.378378378378378,1
"17345","TNFSF12",4,1,5,0.2,0.8,1
"17346","TNFSF12-TNFSF13",2,2,4,0.5,0.5,1
"17347","TNFSF13",7,5,12,0.416666666666667,0.583333333333333,1
"17348","TNFSF13B",8,28,36,0.777777777777778,0.222222222222222,1
"17349","TNFSF14",11,25,36,0.694444444444444,0.305555555555556,1
"17350","TNFSF15",7,27,34,0.794117647058823,0.205882352941176,1
"17351","TNFSF18",9,22,31,0.709677419354839,0.290322580645161,1
"17352","TNFSF4",4,18,22,0.818181818181818,0.181818181818182,1
"17353","TNFSF8",16,15,31,0.483870967741935,0.516129032258065,1
"17354","TNFSF9",5,10,15,0.666666666666667,0.333333333333333,1
"17355","TNIK",73,117,190,0.615789473684211,0.384210526315789,1
"17356","TNIP1",23,28,51,0.549019607843137,0.450980392156863,1
"17357","TNIP2",13,17,30,0.566666666666667,0.433333333333333,1
"17358","TNIP3",32,51,83,0.614457831325301,0.385542168674699,1
"17359","TNK1",13,19,32,0.59375,0.40625,1
"17360","TNK2",36,47,83,0.566265060240964,0.433734939759036,1
"17361","TNKS",43,70,113,0.619469026548673,0.380530973451327,1
"17362","TNKS1BP1",57,94,151,0.622516556291391,0.377483443708609,1
"17363","TNKS2",60,73,133,0.548872180451128,0.451127819548872,1
"17364","TNMD",16,16,32,0.5,0.5,1
"17365","TNN",146,217,363,0.597796143250689,0.402203856749311,1
"17366","TNNC1",11,5,16,0.3125,0.6875,1
"17367","TNNC2",4,14,18,0.777777777777778,0.222222222222222,1
"17368","TNNI1",10,15,25,0.6,0.4,1
"17369","TNNI2",13,23,36,0.638888888888889,0.361111111111111,1
"17370","TNNI3",9,18,27,0.666666666666667,0.333333333333333,1
"17371","TNNI3K",31,56,87,0.64367816091954,0.35632183908046,1
"17372","TNNT1",16,26,42,0.619047619047619,0.380952380952381,1
"17373","TNNT2",11,31,42,0.738095238095238,0.261904761904762,1
"17374","TNNT3",20,26,46,0.565217391304348,0.434782608695652,1
"17375","TNP1",2,10,12,0.833333333333333,0.166666666666667,1
"17376","TNP2",5,8,13,0.615384615384615,0.384615384615385,1
"17377","TNPO1",41,48,89,0.539325842696629,0.460674157303371,1
"17378","TNPO2",35,34,69,0.492753623188406,0.507246376811594,1
"17379","TNPO3",28,50,78,0.641025641025641,0.358974358974359,1
"17380","TNR",192,304,496,0.612903225806452,0.387096774193548,1
"17381","TNRC18",56,93,149,0.624161073825503,0.375838926174497,1
"17382","TNRC6A",73,128,201,0.63681592039801,0.36318407960199,1
"17383","TNRC6B",59,107,166,0.644578313253012,0.355421686746988,1
"17384","TNRC6C",66,76,142,0.535211267605634,0.464788732394366,1
"17385","TNS1",77,117,194,0.603092783505155,0.396907216494845,1
"17386","TNS2",46,57,103,0.553398058252427,0.446601941747573,1
"17387","TNS3",72,100,172,0.581395348837209,0.418604651162791,1
"17388","TNS4",41,43,84,0.511904761904762,0.488095238095238,1
"17389","TNXB",178,317,495,0.64040404040404,0.35959595959596,1
"17390","TOB1",12,18,30,0.6,0.4,1
"17391","TOB2",11,14,25,0.56,0.44,1
"17392","TOE1",5,21,26,0.807692307692308,0.192307692307692,1
"17393","TOGARAM1",69,107,176,0.607954545454545,0.392045454545455,0.77
"17394","TOGARAM2",41,79,120,0.658333333333333,0.341666666666667,0.77
"17395","TOLLIP",7,16,23,0.695652173913043,0.304347826086957,1
"17396","TOM1",12,34,46,0.739130434782609,0.260869565217391,1
"17397","TOM1L1",13,23,36,0.638888888888889,0.361111111111111,1
"17398","TOM1L2",15,22,37,0.594594594594595,0.405405405405405,1
"17399","TOMM20",2,4,6,0.666666666666667,0.333333333333333,1
"17400","TOMM20L",4,4,8,0.5,0.5,1
"17401","TOMM22",6,9,15,0.6,0.4,1
"17402","TOMM34",10,12,22,0.545454545454545,0.454545454545455,1
"17403","TOMM40",2,12,14,0.857142857142857,0.142857142857143,1
"17404","TOMM40L",4,16,20,0.8,0.2,1
"17405","TOMM5",1,3,4,0.75,0.25,1
"17406","TOMM6",0,1,1,1,0,1
"17407","TOMM7",1,3,4,0.75,0.25,1
"17408","TOMM70",15,27,42,0.642857142857143,0.357142857142857,1
"17409","TONSL",36,51,87,0.586206896551724,0.413793103448276,1
"17410","TOP1",41,49,90,0.544444444444444,0.455555555555556,1
"17411","TOP1MT",24,32,56,0.571428571428571,0.428571428571429,1
"17412","TOP2A",55,71,126,0.563492063492063,0.436507936507937,1
"17413","TOP2B",43,59,102,0.57843137254902,0.42156862745098,1
"17414","TOP3A",42,47,89,0.528089887640449,0.471910112359551,1
"17415","TOP3B",28,38,66,0.575757575757576,0.424242424242424,1
"17416","TOPAZ1",0,8,8,1,0,1
"17417","TOPBP1",52,51,103,0.495145631067961,0.504854368932039,1
"17418","TOPORS",51,60,111,0.540540540540541,0.459459459459459,1
"17419","TOR1A",11,14,25,0.56,0.44,1
"17420","TOR1AIP1",19,36,55,0.654545454545455,0.345454545454545,1
"17421","TOR1AIP2",17,31,48,0.645833333333333,0.354166666666667,1
"17422","TOR1B",10,12,22,0.545454545454545,0.454545454545455,1
"17423","TOR2A",8,5,13,0.384615384615385,0.615384615384615,1
"17424","TOR3A",13,14,27,0.518518518518518,0.481481481481481,1
"17425","TOR4A",10,9,19,0.473684210526316,0.526315789473684,1
"17426","TOX",31,66,97,0.680412371134021,0.319587628865979,1
"17427","TOX2",41,69,110,0.627272727272727,0.372727272727273,1
"17428","TOX3",28,38,66,0.575757575757576,0.424242424242424,1
"17429","TOX4",17,35,52,0.673076923076923,0.326923076923077,1
"17430","TP53",1083,1887,2970,0.635353535353535,0.364646464646465,1
"17431","TP53AIP1",1,3,4,0.75,0.25,1
"17432","TP53BP1",76,125,201,0.621890547263682,0.378109452736318,1
"17433","TP53BP2",49,56,105,0.533333333333333,0.466666666666667,1
"17434","TP53I11",10,16,26,0.615384615384615,0.384615384615385,1
"17435","TP53I13",13,15,28,0.535714285714286,0.464285714285714,1
"17436","TP53I3",8,13,21,0.619047619047619,0.380952380952381,1
"17437","TP53INP1",6,17,23,0.739130434782609,0.260869565217391,1
"17438","TP53INP2",6,8,14,0.571428571428571,0.428571428571429,1
"17439","TP53RK",5,10,15,0.666666666666667,0.333333333333333,1
"17440","TP53TG5",11,27,38,0.710526315789474,0.289473684210526,1
"17441","TP63",63,125,188,0.664893617021277,0.335106382978723,1
"17442","TP73",22,32,54,0.592592592592593,0.407407407407407,1
"17443","TP73-AS1",15,11,26,0.423076923076923,0.576923076923077,1
"17444","TPBG",14,27,41,0.658536585365854,0.341463414634146,1
"17445","TPCN1",32,36,68,0.529411764705882,0.470588235294118,1
"17446","TPCN2",20,23,43,0.534883720930233,0.465116279069767,1
"17447","TPD52",10,18,28,0.642857142857143,0.357142857142857,1
"17448","TPD52L1",11,15,26,0.576923076923077,0.423076923076923,1
"17449","TPD52L2",4,14,18,0.777777777777778,0.222222222222222,1
"17450","TPD52L3",6,16,22,0.727272727272727,0.272727272727273,1
"17451","TPGS1",2,2,4,0.5,0.5,1
"17452","TPGS2",9,12,21,0.571428571428571,0.428571428571429,1
"17453","TPH1",23,33,56,0.589285714285714,0.410714285714286,1
"17454","TPH2",29,76,105,0.723809523809524,0.276190476190476,1
"17455","TPI1",11,14,25,0.56,0.44,1
"17456","TPK1",21,29,50,0.58,0.42,1
"17457","TPM1",13,13,26,0.5,0.5,1
"17458","TPM2",11,15,26,0.576923076923077,0.423076923076923,1
"17459","TPM3",12,17,29,0.586206896551724,0.413793103448276,1
"17460","TPM4",3,9,12,0.75,0.25,1
"17461","TPMT",2,15,17,0.882352941176471,0.117647058823529,1
"17462","TPO",102,169,271,0.623616236162362,0.376383763837638,1
"17463","TPP1",18,26,44,0.590909090909091,0.409090909090909,1
"17464","TPP2",45,77,122,0.631147540983607,0.368852459016393,1
"17465","TPPP",12,9,21,0.428571428571429,0.571428571428571,1
"17466","TPPP2",7,21,28,0.75,0.25,1
"17467","TPPP3",7,10,17,0.588235294117647,0.411764705882353,1
"17468","TPR",84,135,219,0.616438356164384,0.383561643835616,1
"17469","TPRA1",9,13,22,0.590909090909091,0.409090909090909,1
"17470","TPRG1",14,30,44,0.681818181818182,0.318181818181818,1
"17471","TPRG1L",6,13,19,0.684210526315789,0.315789473684211,1
"17472","TPRKB",6,11,17,0.647058823529412,0.352941176470588,1
"17473","TPRN",8,16,24,0.666666666666667,0.333333333333333,1
"17474","TPRX1",13,24,37,0.648648648648649,0.351351351351351,1
"17475","TPSAB1",5,8,13,0.615384615384615,0.384615384615385,1
"17476","TPSB2",3,11,14,0.785714285714286,0.214285714285714,1
"17477","TPSD1",14,24,38,0.631578947368421,0.368421052631579,1
"17478","TPSG1",5,18,23,0.782608695652174,0.217391304347826,1
"17479","TPST1",10,25,35,0.714285714285714,0.285714285714286,1
"17480","TPST2",7,20,27,0.740740740740741,0.259259259259259,1
"17481","TPT1",4,8,12,0.666666666666667,0.333333333333333,1
"17482","TPTE",144,230,374,0.614973262032086,0.385026737967914,1
"17483","TPTE2",43,88,131,0.67175572519084,0.32824427480916,1
"17484","TPX2",25,62,87,0.71264367816092,0.28735632183908,1
"17485","TRA2A",17,23,40,0.575,0.425,1
"17486","TRA2B",19,22,41,0.536585365853659,0.463414634146341,1
"17487","TRABD",6,21,27,0.777777777777778,0.222222222222222,1
"17488","TRABD2A",15,38,53,0.716981132075472,0.283018867924528,1
"17489","TRAC",3,6,9,0.666666666666667,0.333333333333333,1
"17490","TRADD",7,10,17,0.588235294117647,0.411764705882353,1
"17491","TRAF1",17,18,35,0.514285714285714,0.485714285714286,1
"17492","TRAF2",17,28,45,0.622222222222222,0.377777777777778,1
"17493","TRAF3",22,33,55,0.6,0.4,1
"17494","TRAF3IP1",20,29,49,0.591836734693878,0.408163265306122,1
"17495","TRAF3IP2",17,33,50,0.66,0.34,1
"17496","TRAF3IP3",22,54,76,0.710526315789474,0.289473684210526,1
"17497","TRAF4",11,15,26,0.576923076923077,0.423076923076923,1
"17498","TRAF5",11,36,47,0.765957446808511,0.234042553191489,1
"17499","TRAF6",22,21,43,0.488372093023256,0.511627906976744,1
"17500","TRAF7",26,28,54,0.518518518518518,0.481481481481481,1
"17501","TRAFD1",14,17,31,0.548387096774194,0.451612903225806,1
"17502","TRAIP",14,28,42,0.666666666666667,0.333333333333333,1
"17503","TRAJ1",0,1,1,1,0,1
"17504","TRAJ10",1,1,2,0.5,0.5,1
"17505","TRAJ12",0,2,2,1,0,1
"17506","TRAJ18",1,1,2,0.5,0.5,1
"17507","TRAJ19",0,1,1,1,0,1
"17508","TRAJ2",0,1,1,1,0,1
"17509","TRAJ22",0,2,2,1,0,1
"17510","TRAJ23",3,5,8,0.625,0.375,1
"17511","TRAJ26",1,0,1,0,1,1
"17512","TRAJ27",0,2,2,1,0,1
"17513","TRAJ28",0,1,1,1,0,1
"17514","TRAJ29",0,1,1,1,0,1
"17515","TRAJ30",0,2,2,1,0,1
"17516","TRAJ31",2,2,4,0.5,0.5,1
"17517","TRAJ35",1,0,1,0,1,1
"17518","TRAJ36",0,1,1,1,0,1
"17519","TRAJ37",1,1,2,0.5,0.5,1
"17520","TRAJ38",0,1,1,1,0,1
"17521","TRAJ42",1,2,3,0.666666666666667,0.333333333333333,1
"17522","TRAJ45",0,2,2,1,0,1
"17523","TRAJ47",0,1,1,1,0,1
"17524","TRAJ49",0,1,1,1,0,1
"17525","TRAJ50",0,1,1,1,0,1
"17526","TRAJ53",0,1,1,1,0,1
"17527","TRAJ54",0,1,1,1,0,1
"17528","TRAJ56",0,1,1,1,0,1
"17529","TRAJ57",0,1,1,1,0,1
"17530","TRAJ58",0,1,1,1,0,1
"17531","TRAJ7",1,1,2,0.5,0.5,1
"17532","TRAJ9",0,2,2,1,0,1
"17533","TRAK1",28,53,81,0.654320987654321,0.345679012345679,1
"17534","TRAK2",29,47,76,0.618421052631579,0.381578947368421,1
"17535","TRAM1",26,40,66,0.606060606060606,0.393939393939394,1
"17536","TRAM1L1",32,53,85,0.623529411764706,0.376470588235294,1
"17537","TRAM2",6,16,22,0.727272727272727,0.272727272727273,1
"17538","TRANK1",112,250,362,0.69060773480663,0.30939226519337,0.44
"17539","TRAP1",19,29,48,0.604166666666667,0.395833333333333,1
"17540","TRAPPC1",5,3,8,0.375,0.625,1
"17541","TRAPPC10",31,44,75,0.586666666666667,0.413333333333333,1
"17542","TRAPPC11",29,37,66,0.560606060606061,0.439393939393939,1
"17543","TRAPPC12",41,42,83,0.506024096385542,0.493975903614458,1
"17544","TRAPPC13",12,9,21,0.428571428571429,0.571428571428571,1
"17545","TRAPPC2",2,3,5,0.6,0.4,1
"17546","TRAPPC2L",3,9,12,0.75,0.25,1
"17547","TRAPPC3",4,11,15,0.733333333333333,0.266666666666667,1
"17548","TRAPPC3L",0,3,3,1,0,1
"17549","TRAPPC4",4,10,14,0.714285714285714,0.285714285714286,1
"17550","TRAPPC5",4,8,12,0.666666666666667,0.333333333333333,1
"17551","TRAPPC6A",6,13,19,0.684210526315789,0.315789473684211,1
"17552","TRAPPC6B",9,5,14,0.357142857142857,0.642857142857143,1
"17553","TRAPPC8",71,65,136,0.477941176470588,0.522058823529412,1
"17554","TRAPPC9",39,70,109,0.642201834862385,0.357798165137615,1
"17555","TRARG1",7,14,21,0.666666666666667,0.333333333333333,1
"17556","TRAT1",19,56,75,0.746666666666667,0.253333333333333,1
"17557","TRAV1-1",6,16,22,0.727272727272727,0.272727272727273,1
"17558","TRAV1-2",1,9,10,0.9,0.1,1
"17559","TRAV10",7,13,20,0.65,0.35,1
"17560","TRAV12-1",7,16,23,0.695652173913043,0.304347826086957,1
"17561","TRAV12-2",5,19,24,0.791666666666667,0.208333333333333,1
"17562","TRAV12-3",15,10,25,0.4,0.6,1
"17563","TRAV13-1",5,21,26,0.807692307692308,0.192307692307692,1
"17564","TRAV13-2",1,12,13,0.923076923076923,0.0769230769230769,1
"17565","TRAV14DV4",4,14,18,0.777777777777778,0.222222222222222,1
"17566","TRAV16",1,6,7,0.857142857142857,0.142857142857143,1
"17567","TRAV17",8,11,19,0.578947368421053,0.421052631578947,1
"17568","TRAV18",6,14,20,0.7,0.3,1
"17569","TRAV19",3,14,17,0.823529411764706,0.176470588235294,1
"17570","TRAV2",7,10,17,0.588235294117647,0.411764705882353,1
"17571","TRAV20",9,11,20,0.55,0.45,1
"17572","TRAV21",10,14,24,0.583333333333333,0.416666666666667,1
"17573","TRAV22",6,24,30,0.8,0.2,1
"17574","TRAV23DV6",5,7,12,0.583333333333333,0.416666666666667,1
"17575","TRAV24",3,10,13,0.769230769230769,0.230769230769231,1
"17576","TRAV25",5,8,13,0.615384615384615,0.384615384615385,1
"17577","TRAV26-1",10,15,25,0.6,0.4,1
"17578","TRAV26-2",6,5,11,0.454545454545455,0.545454545454545,1
"17579","TRAV27",5,16,21,0.761904761904762,0.238095238095238,1
"17580","TRAV29DV5",6,2,8,0.25,0.75,1
"17581","TRAV3",9,12,21,0.571428571428571,0.428571428571429,1
"17582","TRAV30",3,12,15,0.8,0.2,1
"17583","TRAV34",3,10,13,0.769230769230769,0.230769230769231,1
"17584","TRAV36DV7",4,7,11,0.636363636363636,0.363636363636364,1
"17585","TRAV38-1",2,6,8,0.75,0.25,1
"17586","TRAV38-2DV8",1,3,4,0.75,0.25,1
"17587","TRAV39",1,6,7,0.857142857142857,0.142857142857143,1
"17588","TRAV4",2,15,17,0.882352941176471,0.117647058823529,1
"17589","TRAV40",1,9,10,0.9,0.1,1
"17590","TRAV41",4,10,14,0.714285714285714,0.285714285714286,1
"17591","TRAV5",11,10,21,0.476190476190476,0.523809523809524,1
"17592","TRAV6",6,10,16,0.625,0.375,1
"17593","TRAV7",6,11,17,0.647058823529412,0.352941176470588,1
"17594","TRAV8-1",5,16,21,0.761904761904762,0.238095238095238,1
"17595","TRAV8-2",7,16,23,0.695652173913043,0.304347826086957,1
"17596","TRAV8-3",2,15,17,0.882352941176471,0.117647058823529,1
"17597","TRAV8-4",5,16,21,0.761904761904762,0.238095238095238,1
"17598","TRAV8-6",7,18,25,0.72,0.28,1
"17599","TRAV8-7",2,11,13,0.846153846153846,0.153846153846154,1
"17600","TRAV9-1",7,17,24,0.708333333333333,0.291666666666667,1
"17601","TRAV9-2",6,11,17,0.647058823529412,0.352941176470588,1
"17602","TRBC2",13,27,40,0.675,0.325,1
"17603","TRBJ2-1",2,1,3,0.333333333333333,0.666666666666667,1
"17604","TRBJ2-2",1,3,4,0.75,0.25,1
"17605","TRBJ2-3",0,1,1,1,0,1
"17606","TRBJ2-5",1,1,2,0.5,0.5,1
"17607","TRBJ2-6",1,3,4,0.75,0.25,1
"17608","TRBJ2-7",0,3,3,1,0,1
"17609","TRBV19",10,18,28,0.642857142857143,0.357142857142857,1
"17610","TRBV2",7,24,31,0.774193548387097,0.225806451612903,1
"17611","TRBV20-1",8,12,20,0.6,0.4,1
"17612","TRBV23OR9-2",0,1,1,1,0,1
"17613","TRBV24-1",11,17,28,0.607142857142857,0.392857142857143,1
"17614","TRBV27",9,18,27,0.666666666666667,0.333333333333333,1
"17615","TRBV28",8,18,26,0.692307692307692,0.307692307692308,1
"17616","TRBV29-1",5,13,18,0.722222222222222,0.277777777777778,1
"17617","TRBV3-1",23,15,38,0.394736842105263,0.605263157894737,1
"17618","TRBV30",3,10,13,0.769230769230769,0.230769230769231,1
"17619","TRBV4-1",12,9,21,0.428571428571429,0.571428571428571,1
"17620","TRBV4-2",12,22,34,0.647058823529412,0.352941176470588,1
"17621","TRBV5-1",9,16,25,0.64,0.36,1
"17622","TRBV6-1",7,19,26,0.730769230769231,0.269230769230769,1
"17623","TRDC",6,8,14,0.571428571428571,0.428571428571429,1
"17624","TRDJ1",1,1,2,0.5,0.5,1
"17625","TRDJ2",1,3,4,0.75,0.25,1
"17626","TRDJ3",0,2,2,1,0,1
"17627","TRDJ4",1,0,1,0,1,1
"17628","TRDMT1",16,30,46,0.652173913043478,0.347826086956522,1
"17629","TRDN",33,62,95,0.652631578947368,0.347368421052632,1
"17630","TRDV1",7,19,26,0.730769230769231,0.269230769230769,1
"17631","TRDV2",3,6,9,0.666666666666667,0.333333333333333,1
"17632","TRDV3",1,3,4,0.75,0.25,1
"17633","TREH",16,21,37,0.567567567567568,0.432432432432432,1
"17634","TREM1",13,23,36,0.638888888888889,0.361111111111111,1
"17635","TREM2",9,14,23,0.608695652173913,0.391304347826087,1
"17636","TREML1",11,21,32,0.65625,0.34375,1
"17637","TREML2",15,24,39,0.615384615384615,0.384615384615385,1
"17638","TREML4",13,21,34,0.617647058823529,0.382352941176471,1
"17639","TRERF1",60,128,188,0.680851063829787,0.319148936170213,1
"17640","TREX1",7,15,22,0.681818181818182,0.318181818181818,1
"17641","TREX2",21,10,31,0.32258064516129,0.67741935483871,1
"17642","TRGC1",17,12,29,0.413793103448276,0.586206896551724,1
"17643","TRGC2",9,25,34,0.735294117647059,0.264705882352941,1
"17644","TRGJP",2,5,7,0.714285714285714,0.285714285714286,1
"17645","TRGJP2",0,7,7,1,0,1
"17646","TRGV2",10,14,24,0.583333333333333,0.416666666666667,1
"17647","TRGV3",6,13,19,0.684210526315789,0.315789473684211,1
"17648","TRGV4",8,12,20,0.6,0.4,1
"17649","TRGV5",9,12,21,0.571428571428571,0.428571428571429,1
"17650","TRGV8",3,17,20,0.85,0.15,1
"17651","TRGV9",3,7,10,0.7,0.3,1
"17652","TRH",17,19,36,0.527777777777778,0.472222222222222,1
"17653","TRHDE",115,204,319,0.639498432601881,0.360501567398119,1
"17654","TRHR",38,67,105,0.638095238095238,0.361904761904762,1
"17655","TRIAP1",3,4,7,0.571428571428571,0.428571428571429,1
"17656","TRIB1",7,19,26,0.730769230769231,0.269230769230769,1
"17657","TRIB2",11,40,51,0.784313725490196,0.215686274509804,1
"17658","TRIB3",11,23,34,0.676470588235294,0.323529411764706,1
"17659","TRIL",17,28,45,0.622222222222222,0.377777777777778,1
"17660","TRIM10",22,46,68,0.676470588235294,0.323529411764706,1
"17661","TRIM11",17,25,42,0.595238095238095,0.404761904761905,1
"17662","TRIM13",13,26,39,0.666666666666667,0.333333333333333,1
"17663","TRIM14",10,14,24,0.583333333333333,0.416666666666667,1
"17664","TRIM15",15,44,59,0.745762711864407,0.254237288135593,1
"17665","TRIM16",4,5,9,0.555555555555556,0.444444444444444,1
"17666","TRIM16L",8,18,26,0.692307692307692,0.307692307692308,1
"17667","TRIM17",17,23,40,0.575,0.425,1
"17668","TRIM2",25,39,64,0.609375,0.390625,1
"17669","TRIM21",18,32,50,0.64,0.36,1
"17670","TRIM22",32,48,80,0.6,0.4,1
"17671","TRIM23",31,36,67,0.537313432835821,0.462686567164179,1
"17672","TRIM24",30,68,98,0.693877551020408,0.306122448979592,1
"17673","TRIM25",22,24,46,0.521739130434783,0.478260869565217,1
"17674","TRIM26",22,30,52,0.576923076923077,0.423076923076923,1
"17675","TRIM27",18,40,58,0.689655172413793,0.310344827586207,1
"17676","TRIM28",21,33,54,0.611111111111111,0.388888888888889,1
"17677","TRIM29",27,64,91,0.703296703296703,0.296703296703297,1
"17678","TRIM3",34,56,90,0.622222222222222,0.377777777777778,1
"17679","TRIM31",12,26,38,0.684210526315789,0.315789473684211,1
"17680","TRIM32",20,30,50,0.6,0.4,1
"17681","TRIM33",27,43,70,0.614285714285714,0.385714285714286,1
"17682","TRIM35",24,19,43,0.441860465116279,0.558139534883721,1
"17683","TRIM36",30,58,88,0.659090909090909,0.340909090909091,1
"17684","TRIM37",40,62,102,0.607843137254902,0.392156862745098,1
"17685","TRIM38",18,30,48,0.625,0.375,1
"17686","TRIM39",31,32,63,0.507936507936508,0.492063492063492,1
"17687","TRIM39-RPP21",1,5,6,0.833333333333333,0.166666666666667,1
"17688","TRIM4",18,19,37,0.513513513513513,0.486486486486487,1
"17689","TRIM40",7,16,23,0.695652173913043,0.304347826086957,1
"17690","TRIM41",19,20,39,0.512820512820513,0.487179487179487,1
"17691","TRIM42",56,96,152,0.631578947368421,0.368421052631579,1
"17692","TRIM43",13,26,39,0.666666666666667,0.333333333333333,1
"17693","TRIM44",9,16,25,0.64,0.36,1
"17694","TRIM45",19,31,50,0.62,0.38,1
"17695","TRIM46",37,51,88,0.579545454545455,0.420454545454545,1
"17696","TRIM47",7,21,28,0.75,0.25,1
"17697","TRIM48",28,48,76,0.631578947368421,0.368421052631579,1
"17698","TRIM49",37,62,99,0.626262626262626,0.373737373737374,1
"17699","TRIM49D2",0,1,1,1,0,1
"17700","TRIM5",14,21,35,0.6,0.4,1
"17701","TRIM50",18,18,36,0.5,0.5,1
"17702","TRIM51",42,80,122,0.655737704918033,0.344262295081967,1
"17703","TRIM52",5,15,20,0.75,0.25,1
"17704","TRIM53AP",0,1,1,1,0,1
"17705","TRIM54",21,27,48,0.5625,0.4375,1
"17706","TRIM55",34,90,124,0.725806451612903,0.274193548387097,1
"17707","TRIM56",28,48,76,0.631578947368421,0.368421052631579,1
"17708","TRIM58",56,103,159,0.647798742138365,0.352201257861635,1
"17709","TRIM59",20,21,41,0.51219512195122,0.48780487804878,1
"17710","TRIM6",27,41,68,0.602941176470588,0.397058823529412,1
"17711","TRIM6-TRIM34",17,37,54,0.685185185185185,0.314814814814815,1
"17712","TRIM60",36,53,89,0.595505617977528,0.404494382022472,1
"17713","TRIM61",6,16,22,0.727272727272727,0.272727272727273,1
"17714","TRIM62",21,21,42,0.5,0.5,1
"17715","TRIM63",13,19,32,0.59375,0.40625,1
"17716","TRIM65",13,13,26,0.5,0.5,1
"17717","TRIM66",3,5,8,0.625,0.375,1
"17718","TRIM67",20,43,63,0.682539682539683,0.317460317460317,1
"17719","TRIM68",21,27,48,0.5625,0.4375,1
"17720","TRIM69",21,43,64,0.671875,0.328125,1
"17721","TRIM7",11,27,38,0.710526315789474,0.289473684210526,1
"17722","TRIM71",41,63,104,0.605769230769231,0.394230769230769,1
"17723","TRIM72",23,32,55,0.581818181818182,0.418181818181818,1
"17724","TRIM73",3,10,13,0.769230769230769,0.230769230769231,1
"17725","TRIM74",5,3,8,0.375,0.625,1
"17726","TRIM75P",12,31,43,0.720930232558139,0.27906976744186,1
"17727","TRIM77",2,8,10,0.8,0.2,1
"17728","TRIM8",7,19,26,0.730769230769231,0.269230769230769,1
"17729","TRIM9",47,65,112,0.580357142857143,0.419642857142857,1
"17730","TRIML1",49,74,123,0.601626016260163,0.398373983739837,1
"17731","TRIML2",42,80,122,0.655737704918033,0.344262295081967,1
"17732","TRIO",132,170,302,0.562913907284768,0.437086092715232,1
"17733","TRIOBP",93,189,282,0.670212765957447,0.329787234042553,1
"17734","TRIP10",26,23,49,0.469387755102041,0.530612244897959,1
"17735","TRIP11",53,107,160,0.66875,0.33125,1
"17736","TRIP12",87,113,200,0.565,0.435,1
"17737","TRIP13",22,28,50,0.56,0.44,1
"17738","TRIP4",32,27,59,0.457627118644068,0.542372881355932,1
"17739","TRIP6",22,24,46,0.521739130434783,0.478260869565217,1
"17740","TRIR",5,2,7,0.285714285714286,0.714285714285714,1
"17741","TRIT1",14,27,41,0.658536585365854,0.341463414634146,1
"17742","TRMO",9,25,34,0.735294117647059,0.264705882352941,1
"17743","TRMT1",16,34,50,0.68,0.32,1
"17744","TRMT10A",19,29,48,0.604166666666667,0.395833333333333,1
"17745","TRMT10B",10,18,28,0.642857142857143,0.357142857142857,1
"17746","TRMT10C",19,24,43,0.558139534883721,0.441860465116279,1
"17747","TRMT11",12,8,20,0.4,0.6,1
"17748","TRMT112",6,6,12,0.5,0.5,1
"17749","TRMT12",17,26,43,0.604651162790698,0.395348837209302,1
"17750","TRMT13",19,31,50,0.62,0.38,1
"17751","TRMT1L",20,35,55,0.636363636363636,0.363636363636364,1
"17752","TRMT2A",13,24,37,0.648648648648649,0.351351351351351,1
"17753","TRMT2B",24,23,47,0.48936170212766,0.51063829787234,1
"17754","TRMT44",11,21,32,0.65625,0.34375,1
"17755","TRMT5",15,24,39,0.615384615384615,0.384615384615385,1
"17756","TRMT6",20,25,45,0.555555555555556,0.444444444444444,1
"17757","TRMT61A",5,4,9,0.444444444444444,0.555555555555556,1
"17758","TRMT61B",8,24,32,0.75,0.25,1
"17759","TRMT9B",21,24,45,0.533333333333333,0.466666666666667,1
"17760","TRMU",13,20,33,0.606060606060606,0.393939393939394,1
"17761","TRNAU1AP",3,10,13,0.769230769230769,0.230769230769231,1
"17762","TRNT1",8,27,35,0.771428571428571,0.228571428571429,1
"17763","TRO",70,65,135,0.481481481481481,0.518518518518518,1
"17764","TROAP",28,49,77,0.636363636363636,0.363636363636364,1
"17765","TRPA1",100,174,274,0.635036496350365,0.364963503649635,1
"17766","TRPC1",41,62,103,0.601941747572815,0.398058252427184,1
"17767","TRPC3",54,93,147,0.63265306122449,0.36734693877551,1
"17768","TRPC4",87,167,254,0.65748031496063,0.34251968503937,1
"17769","TRPC4AP",26,33,59,0.559322033898305,0.440677966101695,1
"17770","TRPC5",85,103,188,0.547872340425532,0.452127659574468,1
"17771","TRPC6",65,110,175,0.628571428571429,0.371428571428571,1
"17772","TRPC7",68,105,173,0.606936416184971,0.393063583815029,1
"17773","TRPM1",77,128,205,0.624390243902439,0.375609756097561,1
"17774","TRPM2",73,139,212,0.655660377358491,0.344339622641509,1
"17775","TRPM3",88,147,235,0.625531914893617,0.374468085106383,1
"17776","TRPM4",42,75,117,0.641025641025641,0.358974358974359,1
"17777","TRPM5",29,48,77,0.623376623376623,0.376623376623377,1
"17778","TRPM6",105,224,329,0.680851063829787,0.319148936170213,1
"17779","TRPM7",61,107,168,0.636904761904762,0.363095238095238,1
"17780","TRPM8",58,112,170,0.658823529411765,0.341176470588235,1
"17781","TRPS1",143,189,332,0.569277108433735,0.430722891566265,1
"17782","TRPT1",6,8,14,0.571428571428571,0.428571428571429,1
"17783","TRPV1",16,37,53,0.69811320754717,0.30188679245283,1
"17784","TRPV2",34,43,77,0.558441558441558,0.441558441558442,1
"17785","TRPV3",33,41,74,0.554054054054054,0.445945945945946,1
"17786","TRPV4",40,50,90,0.555555555555556,0.444444444444444,1
"17787","TRPV5",76,133,209,0.636363636363636,0.363636363636364,1
"17788","TRPV6",51,97,148,0.655405405405405,0.344594594594595,1
"17789","TRRAP",174,212,386,0.549222797927461,0.450777202072539,1
"17790","TRUB1",13,24,37,0.648648648648649,0.351351351351351,1
"17791","TRUB2",9,15,24,0.625,0.375,1
"17792","TSACC",4,10,14,0.714285714285714,0.285714285714286,1
"17793","TSBP1",23,47,70,0.671428571428571,0.328571428571429,1
"17794","TSC1",51,74,125,0.592,0.408,1
"17795","TSC2",70,77,147,0.523809523809524,0.476190476190476,1
"17796","TSC22D1",19,48,67,0.716417910447761,0.283582089552239,1
"17797","TSC22D2",13,30,43,0.697674418604651,0.302325581395349,1
"17798","TSC22D3",16,5,21,0.238095238095238,0.761904761904762,1
"17799","TSC22D4",11,11,22,0.5,0.5,1
"17800","TSEN15",3,11,14,0.785714285714286,0.214285714285714,1
"17801","TSEN2",15,21,36,0.583333333333333,0.416666666666667,1
"17802","TSEN34",9,22,31,0.709677419354839,0.290322580645161,1
"17803","TSEN54",11,10,21,0.476190476190476,0.523809523809524,1
"17804","TSFM",7,13,20,0.65,0.35,1
"17805","TSG101",9,19,28,0.678571428571429,0.321428571428571,1
"17806","TSGA10",58,43,101,0.425742574257426,0.574257425742574,1
"17807","TSGA10IP",18,31,49,0.63265306122449,0.36734693877551,1
"17808","TSGA13",16,14,30,0.466666666666667,0.533333333333333,1
"17809","TSHB",11,17,28,0.607142857142857,0.392857142857143,1
"17810","TSHR",45,57,102,0.558823529411765,0.441176470588235,1
"17811","TSHZ1",45,73,118,0.61864406779661,0.38135593220339,1
"17812","TSHZ2",103,159,262,0.606870229007634,0.393129770992366,1
"17813","TSHZ3",110,176,286,0.615384615384615,0.384615384615385,1
"17814","TSKS",40,54,94,0.574468085106383,0.425531914893617,1
"17815","TSKU",8,32,40,0.8,0.2,1
"17816","TSLP",12,15,27,0.555555555555556,0.444444444444444,1
"17817","TSN",8,15,23,0.652173913043478,0.347826086956522,1
"17818","TSNARE1",30,28,58,0.482758620689655,0.517241379310345,0.77
"17819","TSNAX",10,10,20,0.5,0.5,1
"17820","TSNAXIP1",32,44,76,0.578947368421053,0.421052631578947,1
"17821","TSPAN1",2,6,8,0.75,0.25,1
"17822","TSPAN10",9,19,28,0.678571428571429,0.321428571428571,1
"17823","TSPAN11",8,21,29,0.724137931034483,0.275862068965517,1
"17824","TSPAN12",19,23,42,0.547619047619048,0.452380952380952,1
"17825","TSPAN13",10,8,18,0.444444444444444,0.555555555555556,1
"17826","TSPAN14",11,12,23,0.521739130434783,0.478260869565217,1
"17827","TSPAN15",4,9,13,0.692307692307692,0.307692307692308,1
"17828","TSPAN16",6,20,26,0.769230769230769,0.230769230769231,1
"17829","TSPAN17",12,7,19,0.368421052631579,0.631578947368421,1
"17830","TSPAN18",13,18,31,0.580645161290323,0.419354838709677,1
"17831","TSPAN19",10,15,25,0.6,0.4,1
"17832","TSPAN2",8,21,29,0.724137931034483,0.275862068965517,1
"17833","TSPAN3",3,18,21,0.857142857142857,0.142857142857143,1
"17834","TSPAN31",6,14,20,0.7,0.3,1
"17835","TSPAN32",9,10,19,0.526315789473684,0.473684210526316,1
"17836","TSPAN33",7,14,21,0.666666666666667,0.333333333333333,1
"17837","TSPAN4",5,7,12,0.583333333333333,0.416666666666667,1
"17838","TSPAN5",10,28,38,0.736842105263158,0.263157894736842,1
"17839","TSPAN6",13,3,16,0.1875,0.8125,1
"17840","TSPAN7",17,10,27,0.37037037037037,0.62962962962963,1
"17841","TSPAN8",12,26,38,0.684210526315789,0.315789473684211,1
"17842","TSPAN9",9,15,24,0.625,0.375,1
"17843","TSPEAR",41,62,103,0.601941747572815,0.398058252427184,0.77
"17844","TSPO",2,2,4,0.5,0.5,1
"17845","TSPO2",4,8,12,0.666666666666667,0.333333333333333,1
"17846","TSPOAP1",67,108,175,0.617142857142857,0.382857142857143,1
"17847","TSPY1",0,4,4,1,0,1
"17848","TSPY2",0,11,11,1,0,1
"17849","TSPYL1",11,19,30,0.633333333333333,0.366666666666667,1
"17850","TSPYL2",38,21,59,0.355932203389831,0.644067796610169,1
"17851","TSPYL4",11,12,23,0.521739130434783,0.478260869565217,1
"17852","TSPYL5",22,44,66,0.666666666666667,0.333333333333333,1
"17853","TSPYL6",26,28,54,0.518518518518518,0.481481481481481,1
"17854","TSR1",21,29,50,0.58,0.42,1
"17855","TSR2",13,2,15,0.133333333333333,0.866666666666667,1
"17856","TSR3",6,12,18,0.666666666666667,0.333333333333333,1
"17857","TSSC4",7,13,20,0.65,0.35,1
"17858","TSSK1B",36,43,79,0.544303797468354,0.455696202531646,1
"17859","TSSK2",15,23,38,0.605263157894737,0.394736842105263,1
"17860","TSSK3",10,12,22,0.545454545454545,0.454545454545455,1
"17861","TSSK4",8,14,22,0.636363636363636,0.363636363636364,1
"17862","TSSK6",11,27,38,0.710526315789474,0.289473684210526,1
"17863","TST",8,15,23,0.652173913043478,0.347826086956522,1
"17864","TSTD2",13,19,32,0.59375,0.40625,1
"17865","TTBK1",54,81,135,0.6,0.4,1
"17866","TTBK2",41,73,114,0.640350877192982,0.359649122807018,1
"17867","TTC1",7,10,17,0.588235294117647,0.411764705882353,1
"17868","TTC12",28,43,71,0.605633802816901,0.394366197183099,1
"17869","TTC13",38,60,98,0.612244897959184,0.387755102040816,1
"17870","TTC14",35,68,103,0.660194174757282,0.339805825242718,1
"17871","TTC16",27,41,68,0.602941176470588,0.397058823529412,1
"17872","TTC17",37,94,131,0.717557251908397,0.282442748091603,1
"17873","TTC19",6,15,21,0.714285714285714,0.285714285714286,1
"17874","TTC21A",48,67,115,0.582608695652174,0.417391304347826,1
"17875","TTC21B",43,89,132,0.674242424242424,0.325757575757576,1
"17876","TTC22",6,19,25,0.76,0.24,1
"17877","TTC23",12,22,34,0.647058823529412,0.352941176470588,1
"17878","TTC23L",10,25,35,0.714285714285714,0.285714285714286,1
"17879","TTC24",8,21,29,0.724137931034483,0.275862068965517,1
"17880","TTC25",18,23,41,0.560975609756098,0.439024390243902,1
"17881","TTC26",20,32,52,0.615384615384615,0.384615384615385,1
"17882","TTC27",32,50,82,0.609756097560976,0.390243902439024,1
"17883","TTC28",2,6,8,0.75,0.25,1
"17884","TTC29",32,40,72,0.555555555555556,0.444444444444444,1
"17885","TTC3",88,129,217,0.594470046082949,0.405529953917051,1
"17886","TTC30A",15,33,48,0.6875,0.3125,1
"17887","TTC30B",19,41,60,0.683333333333333,0.316666666666667,1
"17888","TTC31",10,30,40,0.75,0.25,1
"17889","TTC32",4,7,11,0.636363636363636,0.363636363636364,1
"17890","TTC33",4,20,24,0.833333333333333,0.166666666666667,1
"17891","TTC34",0,4,4,1,0,1
"17892","TTC36",5,4,9,0.444444444444444,0.555555555555556,1
"17893","TTC37",52,79,131,0.603053435114504,0.396946564885496,1
"17894","TTC38",12,15,27,0.555555555555556,0.444444444444444,1
"17895","TTC39A",15,26,41,0.634146341463415,0.365853658536585,1
"17896","TTC39B",19,24,43,0.558139534883721,0.441860465116279,1
"17897","TTC39C",22,28,50,0.56,0.44,1
"17898","TTC4",5,19,24,0.791666666666667,0.208333333333333,1
"17899","TTC5",13,22,35,0.628571428571429,0.371428571428571,1
"17900","TTC6",18,48,66,0.727272727272727,0.272727272727273,1
"17901","TTC7A",33,40,73,0.547945205479452,0.452054794520548,1
"17902","TTC7B",30,50,80,0.625,0.375,1
"17903","TTC8",22,38,60,0.633333333333333,0.366666666666667,1
"17904","TTC9",8,11,19,0.578947368421053,0.421052631578947,1
"17905","TTC9B",4,7,11,0.636363636363636,0.363636363636364,1
"17906","TTC9C",7,1,8,0.125,0.875,1
"17907","TTF1",37,54,91,0.593406593406593,0.406593406593407,1
"17908","TTF2",35,49,84,0.583333333333333,0.416666666666667,1
"17909","TTI1",48,74,122,0.60655737704918,0.39344262295082,1
"17910","TTI2",10,27,37,0.72972972972973,0.27027027027027,1
"17911","TTK",74,100,174,0.574712643678161,0.425287356321839,1
"17912","TTL",15,14,29,0.482758620689655,0.517241379310345,1
"17913","TTLL1",18,22,40,0.55,0.45,1
"17914","TTLL10",17,23,40,0.575,0.425,1
"17915","TTLL11",12,26,38,0.684210526315789,0.315789473684211,1
"17916","TTLL12",27,24,51,0.470588235294118,0.529411764705882,1
"17917","TTLL13P",13,33,46,0.717391304347826,0.282608695652174,1
"17918","TTLL2",35,42,77,0.545454545454545,0.454545454545455,1
"17919","TTLL3",26,29,55,0.527272727272727,0.472727272727273,1
"17920","TTLL4",35,65,100,0.65,0.35,1
"17921","TTLL5",50,63,113,0.557522123893805,0.442477876106195,1
"17922","TTLL6",28,31,59,0.525423728813559,0.474576271186441,1
"17923","TTLL7",36,76,112,0.678571428571429,0.321428571428571,1
"17924","TTLL8",15,31,46,0.673913043478261,0.326086956521739,1
"17925","TTLL9",17,52,69,0.753623188405797,0.246376811594203,1
"17926","TTN",2141,4057,6198,0.654565989028719,0.345434010971281,1
"17927","TTPA",12,31,43,0.720930232558139,0.27906976744186,1
"17928","TTPAL",17,13,30,0.433333333333333,0.566666666666667,1
"17929","TTR",8,14,22,0.636363636363636,0.363636363636364,1
"17930","TTYH1",24,40,64,0.625,0.375,1
"17931","TTYH2",22,23,45,0.511111111111111,0.488888888888889,1
"17932","TTYH3",14,20,34,0.588235294117647,0.411764705882353,1
"17933","TUB",32,46,78,0.58974358974359,0.41025641025641,1
"17934","TUBA1A",20,30,50,0.6,0.4,1
"17935","TUBA1B",11,24,35,0.685714285714286,0.314285714285714,1
"17936","TUBA1C",6,17,23,0.739130434782609,0.260869565217391,1
"17937","TUBA3C",59,96,155,0.619354838709677,0.380645161290323,1
"17938","TUBA3D",25,36,61,0.590163934426229,0.409836065573771,1
"17939","TUBA3E",26,38,64,0.59375,0.40625,1
"17940","TUBA4A",15,25,40,0.625,0.375,1
"17941","TUBA8",13,24,37,0.648648648648649,0.351351351351351,1
"17942","TUBAL3",22,41,63,0.650793650793651,0.349206349206349,1
"17943","TUBB",10,17,27,0.62962962962963,0.37037037037037,1
"17944","TUBB1",19,27,46,0.58695652173913,0.41304347826087,1
"17945","TUBB2A",13,22,35,0.628571428571429,0.371428571428571,1
"17946","TUBB2B",22,25,47,0.531914893617021,0.468085106382979,1
"17947","TUBB4A",34,35,69,0.507246376811594,0.492753623188406,1
"17948","TUBB4AP1",2,0,2,0,1,1
"17949","TUBB4B",13,19,32,0.59375,0.40625,1
"17950","TUBB6",19,33,52,0.634615384615385,0.365384615384615,1
"17951","TUBB7P",37,52,89,0.584269662921348,0.415730337078652,1
"17952","TUBB8",28,41,69,0.594202898550725,0.405797101449275,1
"17953","TUBD1",14,26,40,0.65,0.35,1
"17954","TUBE1",20,25,45,0.555555555555556,0.444444444444444,1
"17955","TUBG1",13,29,42,0.69047619047619,0.30952380952381,1
"17956","TUBG2",12,18,30,0.6,0.4,1
"17957","TUBGCP2",27,49,76,0.644736842105263,0.355263157894737,1
"17958","TUBGCP3",45,50,95,0.526315789473684,0.473684210526316,1
"17959","TUBGCP4",24,22,46,0.478260869565217,0.521739130434783,1
"17960","TUBGCP5",33,49,82,0.597560975609756,0.402439024390244,1
"17961","TUBGCP6",56,64,120,0.533333333333333,0.466666666666667,1
"17962","TUFM",16,24,40,0.6,0.4,1
"17963","TUFT1",15,15,30,0.5,0.5,1
"17964","TULP1",31,39,70,0.557142857142857,0.442857142857143,1
"17965","TULP2",18,24,42,0.571428571428571,0.428571428571429,1
"17966","TULP3",18,23,41,0.560975609756098,0.439024390243902,1
"17967","TULP4",81,93,174,0.53448275862069,0.46551724137931,1
"17968","TUSC1",2,2,4,0.5,0.5,1
"17969","TUSC2",2,2,4,0.5,0.5,1
"17970","TUSC3",36,54,90,0.6,0.4,1
"17971","TUT1",24,42,66,0.636363636363636,0.363636363636364,1
"17972","TUT4",63,96,159,0.60377358490566,0.39622641509434,1
"17973","TUT7",52,65,117,0.555555555555556,0.444444444444444,1
"17974","TVP23A",26,26,52,0.5,0.5,1
"17975","TVP23B",7,6,13,0.461538461538462,0.538461538461538,1
"17976","TVP23C",6,10,16,0.625,0.375,1
"17977","TWF1",11,12,23,0.521739130434783,0.478260869565217,1
"17978","TWF2",6,13,19,0.684210526315789,0.315789473684211,1
"17979","TWIST1",7,10,17,0.588235294117647,0.411764705882353,1
"17980","TWNK",36,29,65,0.446153846153846,0.553846153846154,1
"17981","TWSG1",10,8,18,0.444444444444444,0.555555555555556,1
"17982","TXK",22,47,69,0.681159420289855,0.318840579710145,1
"17983","TXLNA",18,24,42,0.571428571428571,0.428571428571429,1
"17984","TXLNB",36,71,107,0.663551401869159,0.336448598130841,1
"17985","TXLNG",20,14,34,0.411764705882353,0.588235294117647,1
"17986","TXLNGY",0,2,2,1,0,1
"17987","TXN",3,3,6,0.5,0.5,1
"17988","TXN2",7,7,14,0.5,0.5,1
"17989","TXNDC11",19,34,53,0.641509433962264,0.358490566037736,1
"17990","TXNDC12",5,10,15,0.666666666666667,0.333333333333333,1
"17991","TXNDC15",7,21,28,0.75,0.25,1
"17992","TXNDC16",25,46,71,0.647887323943662,0.352112676056338,1
"17993","TXNDC17",6,3,9,0.333333333333333,0.666666666666667,1
"17994","TXNDC2",40,53,93,0.56989247311828,0.43010752688172,1
"17995","TXNDC5",7,22,29,0.758620689655172,0.241379310344828,1
"17996","TXNDC8",1,6,7,0.857142857142857,0.142857142857143,1
"17997","TXNDC9",2,9,11,0.818181818181818,0.181818181818182,1
"17998","TXNIP",19,33,52,0.634615384615385,0.365384615384615,1
"17999","TXNL1",8,21,29,0.724137931034483,0.275862068965517,1
"18000","TXNL4A",6,5,11,0.454545454545455,0.545454545454545,1
"18001","TXNL4B",6,11,17,0.647058823529412,0.352941176470588,1
"18002","TXNRD1",12,43,55,0.781818181818182,0.218181818181818,1
"18003","TXNRD2",20,16,36,0.444444444444444,0.555555555555556,1
"18004","TXNRD3",8,8,16,0.5,0.5,1
"18005","TYK2",51,53,104,0.509615384615385,0.490384615384615,1
"18006","TYMP",5,21,26,0.807692307692308,0.192307692307692,1
"18007","TYMS",9,9,18,0.5,0.5,1
"18008","TYR",52,74,126,0.587301587301587,0.412698412698413,1
"18009","TYRO3",28,60,88,0.681818181818182,0.318181818181818,1
"18010","TYROBP",4,15,19,0.789473684210526,0.210526315789474,1
"18011","TYRP1",19,34,53,0.641509433962264,0.358490566037736,1
"18012","TYSND1",7,9,16,0.5625,0.4375,1
"18013","TYW1",30,49,79,0.620253164556962,0.379746835443038,1
"18014","TYW1B",0,5,5,1,0,1
"18015","TYW3",11,15,26,0.576923076923077,0.423076923076923,1
"18016","TYW5",7,11,18,0.611111111111111,0.388888888888889,1
"18017","U2AF1",2,0,2,0,1,1
"18018","U2AF1L4",6,16,22,0.727272727272727,0.272727272727273,1
"18019","U2AF2",20,32,52,0.615384615384615,0.384615384615385,1
"18020","U2SURP",37,65,102,0.637254901960784,0.362745098039216,1
"18021","UACA",45,94,139,0.676258992805755,0.323741007194245,1
"18022","UAP1",14,22,36,0.611111111111111,0.388888888888889,1
"18023","UAP1L1",11,15,26,0.576923076923077,0.423076923076923,1
"18024","UBA1",26,28,54,0.518518518518518,0.481481481481481,1
"18025","UBA2",24,32,56,0.571428571428571,0.428571428571429,1
"18026","UBA3",15,27,42,0.642857142857143,0.357142857142857,1
"18027","UBA5",6,15,21,0.714285714285714,0.285714285714286,1
"18028","UBA52",7,8,15,0.533333333333333,0.466666666666667,1
"18029","UBA6",46,62,108,0.574074074074074,0.425925925925926,1
"18030","UBA7",22,37,59,0.627118644067797,0.372881355932203,1
"18031","UBAC1",11,18,29,0.620689655172414,0.379310344827586,1
"18032","UBAC2",9,19,28,0.678571428571429,0.321428571428571,1
"18033","UBALD1",3,2,5,0.4,0.6,1
"18034","UBALD2",1,1,2,0.5,0.5,1
"18035","UBAP1",13,20,33,0.606060606060606,0.393939393939394,1
"18036","UBAP2",21,58,79,0.734177215189873,0.265822784810127,1
"18037","UBAP2L",29,60,89,0.674157303370786,0.325842696629214,1
"18038","UBASH3A",30,51,81,0.62962962962963,0.37037037037037,1
"18039","UBASH3B",17,44,61,0.721311475409836,0.278688524590164,1
"18040","UBB",10,12,22,0.545454545454545,0.454545454545455,1
"18041","UBC",26,42,68,0.617647058823529,0.382352941176471,1
"18042","UBD",8,17,25,0.68,0.32,1
"18043","UBE2A",21,7,28,0.25,0.75,1
"18044","UBE2B",0,10,10,1,0,1
"18045","UBE2C",3,12,15,0.8,0.2,1
"18046","UBE2D1",5,5,10,0.5,0.5,1
"18047","UBE2D2",4,6,10,0.6,0.4,1
"18048","UBE2D3",5,16,21,0.761904761904762,0.238095238095238,1
"18049","UBE2D4",2,3,5,0.6,0.4,1
"18050","UBE2E1",5,4,9,0.444444444444444,0.555555555555556,1
"18051","UBE2E2",7,14,21,0.666666666666667,0.333333333333333,1
"18052","UBE2E3",4,21,25,0.84,0.16,1
"18053","UBE2F",8,8,16,0.5,0.5,1
"18054","UBE2G1",3,4,7,0.571428571428571,0.428571428571429,1
"18055","UBE2G2",5,7,12,0.583333333333333,0.416666666666667,1
"18056","UBE2H",3,8,11,0.727272727272727,0.272727272727273,1
"18057","UBE2I",10,5,15,0.333333333333333,0.666666666666667,1
"18058","UBE2J1",13,14,27,0.518518518518518,0.481481481481481,1
"18059","UBE2J2",12,19,31,0.612903225806452,0.387096774193548,1
"18060","UBE2K",5,13,18,0.722222222222222,0.277777777777778,1
"18061","UBE2L3",5,14,19,0.736842105263158,0.263157894736842,1
"18062","UBE2L6",1,9,10,0.9,0.1,1
"18063","UBE2M",8,12,20,0.6,0.4,1
"18064","UBE2N",3,11,14,0.785714285714286,0.214285714285714,1
"18065","UBE2NL",32,30,62,0.483870967741935,0.516129032258065,1
"18066","UBE2O",44,46,90,0.511111111111111,0.488888888888889,1
"18067","UBE2Q1",9,24,33,0.727272727272727,0.272727272727273,1
"18068","UBE2Q2",13,18,31,0.580645161290323,0.419354838709677,1
"18069","UBE2QL1",0,1,1,1,0,1
"18070","UBE2R2",10,18,28,0.642857142857143,0.357142857142857,1
"18071","UBE2S",4,12,16,0.75,0.25,1
"18072","UBE2T",5,9,14,0.642857142857143,0.357142857142857,1
"18073","UBE2U",17,20,37,0.540540540540541,0.459459459459459,1
"18074","UBE2V2",1,11,12,0.916666666666667,0.0833333333333333,1
"18075","UBE2W",7,10,17,0.588235294117647,0.411764705882353,1
"18076","UBE2Z",6,7,13,0.538461538461538,0.461538461538462,1
"18077","UBE3A",51,61,112,0.544642857142857,0.455357142857143,1
"18078","UBE3B",46,64,110,0.581818181818182,0.418181818181818,1
"18079","UBE3C",42,70,112,0.625,0.375,1
"18080","UBE3D",19,19,38,0.5,0.5,1
"18081","UBE4A",24,63,87,0.724137931034483,0.275862068965517,1
"18082","UBE4B",53,79,132,0.598484848484849,0.401515151515151,1
"18083","UBFD1",10,13,23,0.565217391304348,0.434782608695652,1
"18084","UBIAD1",17,23,40,0.575,0.425,1
"18085","UBL3",6,13,19,0.684210526315789,0.315789473684211,1
"18086","UBL4A",6,6,12,0.5,0.5,1
"18087","UBL4B",3,7,10,0.7,0.3,1
"18088","UBL5",2,3,5,0.6,0.4,1
"18089","UBL7",14,13,27,0.481481481481481,0.518518518518518,1
"18090","UBLCP1",12,15,27,0.555555555555556,0.444444444444444,1
"18091","UBN1",34,72,106,0.679245283018868,0.320754716981132,1
"18092","UBN2",54,62,116,0.53448275862069,0.46551724137931,1
"18093","UBOX5",12,26,38,0.684210526315789,0.315789473684211,1
"18094","UBP1",23,22,45,0.488888888888889,0.511111111111111,1
"18095","UBQLN1",25,27,52,0.519230769230769,0.480769230769231,1
"18096","UBQLN2",43,26,69,0.376811594202899,0.623188405797101,1
"18097","UBQLN3",45,82,127,0.645669291338583,0.354330708661417,1
"18098","UBQLN4",15,23,38,0.605263157894737,0.394736842105263,1
"18099","UBQLNL",22,54,76,0.710526315789474,0.289473684210526,1
"18100","UBR1",45,74,119,0.621848739495798,0.378151260504202,1
"18101","UBR2",39,95,134,0.708955223880597,0.291044776119403,1
"18102","UBR3",31,50,81,0.617283950617284,0.382716049382716,1
"18103","UBR4",135,228,363,0.628099173553719,0.371900826446281,1
"18104","UBR5",129,187,316,0.591772151898734,0.408227848101266,1
"18105","UBR7",11,15,26,0.576923076923077,0.423076923076923,1
"18106","UBTD1",5,13,18,0.722222222222222,0.277777777777778,1
"18107","UBTD2",10,11,21,0.523809523809524,0.476190476190476,1
"18108","UBTF",34,53,87,0.609195402298851,0.390804597701149,1
"18109","UBTFL1",0,1,1,1,0,1
"18110","UBTFL2",27,70,97,0.721649484536082,0.278350515463918,1
"18111","UBXN1",14,13,27,0.481481481481481,0.518518518518518,1
"18112","UBXN10",11,26,37,0.702702702702703,0.297297297297297,1
"18113","UBXN11",10,26,36,0.722222222222222,0.277777777777778,1
"18114","UBXN2A",11,13,24,0.541666666666667,0.458333333333333,1
"18115","UBXN2B",6,25,31,0.806451612903226,0.193548387096774,1
"18116","UBXN4",20,40,60,0.666666666666667,0.333333333333333,1
"18117","UBXN6",20,21,41,0.51219512195122,0.48780487804878,1
"18118","UBXN7",14,30,44,0.681818181818182,0.318181818181818,1
"18119","UBXN8",8,11,19,0.578947368421053,0.421052631578947,1
"18120","UCHL1",7,17,24,0.708333333333333,0.291666666666667,1
"18121","UCHL3",4,17,21,0.80952380952381,0.19047619047619,1
"18122","UCHL5",6,16,22,0.727272727272727,0.272727272727273,1
"18123","UCK1",9,15,24,0.625,0.375,1
"18124","UCK2",16,14,30,0.466666666666667,0.533333333333333,1
"18125","UCKL1",8,22,30,0.733333333333333,0.266666666666667,1
"18126","UCMA",7,20,27,0.740740740740741,0.259259259259259,1
"18127","UCN",2,3,5,0.6,0.4,1
"18128","UCN2",3,1,4,0.25,0.75,1
"18129","UCN3",6,11,17,0.647058823529412,0.352941176470588,1
"18130","UCP1",11,23,34,0.676470588235294,0.323529411764706,1
"18131","UCP2",10,10,20,0.5,0.5,1
"18132","UCP3",10,14,24,0.583333333333333,0.416666666666667,1
"18133","UEVLD",10,20,30,0.666666666666667,0.333333333333333,1
"18134","UFC1",1,12,13,0.923076923076923,0.0769230769230769,1
"18135","UFD1",8,14,22,0.636363636363636,0.363636363636364,1
"18136","UFL1",24,35,59,0.593220338983051,0.406779661016949,1
"18137","UFM1",5,3,8,0.375,0.625,1
"18138","UFSP1",5,8,13,0.615384615384615,0.384615384615385,1
"18139","UFSP2",9,23,32,0.71875,0.28125,1
"18140","UGCG",16,11,27,0.407407407407407,0.592592592592593,1
"18141","UGDH",29,29,58,0.5,0.5,1
"18142","UGGT1",45,81,126,0.642857142857143,0.357142857142857,1
"18143","UGGT2",59,96,155,0.619354838709677,0.380645161290323,1
"18144","UGP2",19,37,56,0.660714285714286,0.339285714285714,1
"18145","UGT1A1",26,28,54,0.518518518518518,0.481481481481481,1
"18146","UGT1A10",21,32,53,0.60377358490566,0.39622641509434,1
"18147","UGT1A3",7,38,45,0.844444444444444,0.155555555555556,1
"18148","UGT1A4",14,36,50,0.72,0.28,1
"18149","UGT1A5",15,28,43,0.651162790697674,0.348837209302326,1
"18150","UGT1A6",19,42,61,0.688524590163934,0.311475409836066,1
"18151","UGT1A7",18,26,44,0.590909090909091,0.409090909090909,1
"18152","UGT1A8",12,36,48,0.75,0.25,1
"18153","UGT1A9",15,41,56,0.732142857142857,0.267857142857143,1
"18154","UGT2A1",39,83,122,0.680327868852459,0.319672131147541,1
"18155","UGT2A2",21,21,42,0.5,0.5,1
"18156","UGT2A3",44,91,135,0.674074074074074,0.325925925925926,1
"18157","UGT2B10",27,86,113,0.761061946902655,0.238938053097345,1
"18158","UGT2B11",33,87,120,0.725,0.275,1
"18159","UGT2B15",45,89,134,0.664179104477612,0.335820895522388,1
"18160","UGT2B17",40,62,102,0.607843137254902,0.392156862745098,1
"18161","UGT2B28",52,85,137,0.62043795620438,0.37956204379562,1
"18162","UGT2B4",60,97,157,0.617834394904459,0.382165605095541,1
"18163","UGT2B7",41,62,103,0.601941747572815,0.398058252427184,1
"18164","UGT3A1",58,107,165,0.648484848484848,0.351515151515152,1
"18165","UGT3A2",49,92,141,0.652482269503546,0.347517730496454,1
"18166","UGT8",27,54,81,0.666666666666667,0.333333333333333,1
"18167","UHMK1",10,24,34,0.705882352941177,0.294117647058824,1
"18168","UHRF1",16,42,58,0.724137931034483,0.275862068965517,1
"18169","UHRF1BP1",56,66,122,0.540983606557377,0.459016393442623,1
"18170","UHRF1BP1L",64,85,149,0.570469798657718,0.429530201342282,1
"18171","UHRF2",27,31,58,0.53448275862069,0.46551724137931,1
"18172","UIMC1",14,25,39,0.641025641025641,0.358974358974359,1
"18173","ULBP1",10,23,33,0.696969696969697,0.303030303030303,1
"18174","ULBP2",7,14,21,0.666666666666667,0.333333333333333,1
"18175","ULBP3",10,15,25,0.6,0.4,1
"18176","ULK1",39,63,102,0.617647058823529,0.382352941176471,1
"18177","ULK2",40,68,108,0.62962962962963,0.37037037037037,1
"18178","ULK3",13,12,25,0.48,0.52,1
"18179","ULK4",48,80,128,0.625,0.375,1
"18180","UMOD",37,62,99,0.626262626262626,0.373737373737374,1
"18181","UMODL1",48,99,147,0.673469387755102,0.326530612244898,1
"18182","UMPS",18,24,42,0.571428571428571,0.428571428571429,1
"18183","UNC119",10,5,15,0.333333333333333,0.666666666666667,1
"18184","UNC119B",6,14,20,0.7,0.3,1
"18185","UNC13A",79,122,201,0.606965174129353,0.393034825870647,1
"18186","UNC13B",62,78,140,0.557142857142857,0.442857142857143,1
"18187","UNC13C",176,361,537,0.672253258845438,0.327746741154562,1
"18188","UNC13D",34,46,80,0.575,0.425,1
"18189","UNC45A",16,29,45,0.644444444444444,0.355555555555556,1
"18190","UNC45B",71,72,143,0.503496503496504,0.496503496503497,1
"18191","UNC50",8,9,17,0.529411764705882,0.470588235294118,1
"18192","UNC5A",43,63,106,0.594339622641509,0.405660377358491,1
"18193","UNC5B",37,67,104,0.644230769230769,0.355769230769231,1
"18194","UNC5C",77,94,171,0.549707602339181,0.450292397660819,1
"18195","UNC5CL",24,24,48,0.5,0.5,1
"18196","UNC5D",110,143,253,0.565217391304348,0.434782608695652,1
"18197","UNC79",185,295,480,0.614583333333333,0.385416666666667,1
"18198","UNC80",31,65,96,0.677083333333333,0.322916666666667,1
"18199","UNC93A",27,44,71,0.619718309859155,0.380281690140845,1
"18200","UNC93B1",9,18,27,0.666666666666667,0.333333333333333,1
"18201","UNCX",8,14,22,0.636363636363636,0.363636363636364,1
"18202","UNG",9,14,23,0.608695652173913,0.391304347826087,1
"18203","UNK",19,30,49,0.612244897959184,0.387755102040816,1
"18204","UNKL",10,22,32,0.6875,0.3125,1
"18205","UPB1",10,33,43,0.767441860465116,0.232558139534884,1
"18206","UPF1",41,68,109,0.623853211009174,0.376146788990826,1
"18207","UPF2",40,69,109,0.63302752293578,0.36697247706422,1
"18208","UPF3A",29,35,64,0.546875,0.453125,1
"18209","UPF3B",43,15,58,0.258620689655172,0.741379310344828,1
"18210","UPK1A",9,20,29,0.689655172413793,0.310344827586207,1
"18211","UPK1B",8,24,32,0.75,0.25,1
"18212","UPK2",9,9,18,0.5,0.5,1
"18213","UPK3A",15,14,29,0.482758620689655,0.517241379310345,1
"18214","UPK3B",6,12,18,0.666666666666667,0.333333333333333,1
"18215","UPP1",16,18,34,0.529411764705882,0.470588235294118,1
"18216","UPP2",24,30,54,0.555555555555556,0.444444444444444,1
"18217","UPRT",23,14,37,0.378378378378378,0.621621621621622,1
"18218","UQCC1",11,21,32,0.65625,0.34375,1
"18219","UQCC2",3,3,6,0.5,0.5,1
"18220","UQCC3",2,5,7,0.714285714285714,0.285714285714286,1
"18221","UQCR10",2,6,8,0.75,0.25,1
"18222","UQCR11",2,2,4,0.5,0.5,1
"18223","UQCRB",14,8,22,0.363636363636364,0.636363636363636,1
"18224","UQCRC1",11,17,28,0.607142857142857,0.392857142857143,1
"18225","UQCRC2",11,22,33,0.666666666666667,0.333333333333333,1
"18226","UQCRFS1",15,16,31,0.516129032258065,0.483870967741935,1
"18227","UQCRH",2,5,7,0.714285714285714,0.285714285714286,1
"18228","UQCRHL",0,4,4,1,0,1
"18229","UQCRQ",2,6,8,0.75,0.25,1
"18230","URAD",4,4,8,0.5,0.5,1
"18231","URB1",0,7,7,1,0,1
"18232","URB2",42,84,126,0.666666666666667,0.333333333333333,1
"18233","URGCP",33,61,94,0.648936170212766,0.351063829787234,1
"18234","URI1",14,45,59,0.76271186440678,0.23728813559322,1
"18235","URM1",4,4,8,0.5,0.5,1
"18236","UROC1",52,60,112,0.535714285714286,0.464285714285714,1
"18237","UROD",7,13,20,0.65,0.35,1
"18238","UROS",13,17,30,0.566666666666667,0.433333333333333,1
"18239","USB1",5,20,25,0.8,0.2,1
"18240","USE1",9,10,19,0.526315789473684,0.473684210526316,1
"18241","USF1",23,15,38,0.394736842105263,0.605263157894737,1
"18242","USF2",11,9,20,0.45,0.55,1
"18243","USF3",98,155,253,0.612648221343874,0.387351778656126,1
"18244","USH1C",29,56,85,0.658823529411765,0.341176470588235,1
"18245","USH1G",24,37,61,0.60655737704918,0.39344262295082,1
"18246","USH2A",463,768,1231,0.623883021933388,0.376116978066612,1
"18247","USHBP1",29,55,84,0.654761904761905,0.345238095238095,1
"18248","USO1",23,31,54,0.574074074074074,0.425925925925926,1
"18249","USP1",27,28,55,0.509090909090909,0.490909090909091,1
"18250","USP10",22,50,72,0.694444444444444,0.305555555555556,1
"18251","USP11",50,35,85,0.411764705882353,0.588235294117647,1
"18252","USP12",14,20,34,0.588235294117647,0.411764705882353,1
"18253","USP13",32,69,101,0.683168316831683,0.316831683168317,1
"18254","USP14",12,26,38,0.684210526315789,0.315789473684211,1
"18255","USP15",40,68,108,0.62962962962963,0.37037037037037,1
"18256","USP16",21,35,56,0.625,0.375,1
"18257","USP17L1",0,1,1,1,0,1
"18258","USP17L2",31,62,93,0.666666666666667,0.333333333333333,1
"18259","USP17L4",0,1,1,1,0,1
"18260","USP18",10,9,19,0.473684210526316,0.526315789473684,1
"18261","USP19",51,68,119,0.571428571428571,0.428571428571429,1
"18262","USP2",17,46,63,0.73015873015873,0.26984126984127,1
"18263","USP20",32,47,79,0.594936708860759,0.40506329113924,1
"18264","USP21",27,39,66,0.590909090909091,0.409090909090909,1
"18265","USP22",8,26,34,0.764705882352941,0.235294117647059,1
"18266","USP24",66,90,156,0.576923076923077,0.423076923076923,1
"18267","USP25",31,79,110,0.718181818181818,0.281818181818182,1
"18268","USP26",83,87,170,0.511764705882353,0.488235294117647,1
"18269","USP27X",0,1,1,1,0,1
"18270","USP28",74,83,157,0.528662420382166,0.471337579617834,1
"18271","USP29",103,146,249,0.586345381526104,0.413654618473896,1
"18272","USP3",24,33,57,0.578947368421053,0.421052631578947,1
"18273","USP30",10,40,50,0.8,0.2,1
"18274","USP31",59,69,128,0.5390625,0.4609375,1
"18275","USP32",46,83,129,0.643410852713178,0.356589147286822,1
"18276","USP33",51,57,108,0.527777777777778,0.472222222222222,1
"18277","USP34",111,215,326,0.659509202453988,0.340490797546012,1
"18278","USP35",37,57,94,0.606382978723404,0.393617021276596,1
"18279","USP36",28,51,79,0.645569620253165,0.354430379746835,1
"18280","USP37",25,56,81,0.691358024691358,0.308641975308642,1
"18281","USP38",29,40,69,0.579710144927536,0.420289855072464,1
"18282","USP39",10,23,33,0.696969696969697,0.303030303030303,1
"18283","USP4",32,40,72,0.555555555555556,0.444444444444444,1
"18284","USP40",35,63,98,0.642857142857143,0.357142857142857,1
"18285","USP42",26,51,77,0.662337662337662,0.337662337662338,1
"18286","USP43",30,59,89,0.662921348314607,0.337078651685393,1
"18287","USP44",31,39,70,0.557142857142857,0.442857142857143,1
"18288","USP45",27,29,56,0.517857142857143,0.482142857142857,1
"18289","USP46",12,24,36,0.666666666666667,0.333333333333333,1
"18290","USP47",25,62,87,0.71264367816092,0.28735632183908,1
"18291","USP48",33,64,97,0.65979381443299,0.34020618556701,1
"18292","USP49",23,28,51,0.549019607843137,0.450980392156863,1
"18293","USP5",16,57,73,0.780821917808219,0.219178082191781,1
"18294","USP50",7,12,19,0.631578947368421,0.368421052631579,1
"18295","USP51",44,19,63,0.301587301587302,0.698412698412698,1
"18296","USP53",31,48,79,0.607594936708861,0.392405063291139,1
"18297","USP54",47,72,119,0.605042016806723,0.394957983193277,1
"18298","USP6",61,129,190,0.678947368421053,0.321052631578947,1
"18299","USP6NL",32,30,62,0.483870967741935,0.516129032258065,1
"18300","USP7",61,89,150,0.593333333333333,0.406666666666667,1
"18301","USP8",28,59,87,0.67816091954023,0.32183908045977,1
"18302","USP9X",136,124,260,0.476923076923077,0.523076923076923,1
"18303","USP9Y",0,72,72,1,0,1
"18304","USPL1",27,49,76,0.644736842105263,0.355263157894737,1
"18305","UST",13,29,42,0.69047619047619,0.30952380952381,1
"18306","UTF1",2,2,4,0.5,0.5,1
"18307","UTP11",7,18,25,0.72,0.28,1
"18308","UTP14A",42,25,67,0.373134328358209,0.626865671641791,1
"18309","UTP14C",31,28,59,0.474576271186441,0.525423728813559,1
"18310","UTP15",13,17,30,0.566666666666667,0.433333333333333,1
"18311","UTP18",11,27,38,0.710526315789474,0.289473684210526,1
"18312","UTP20",89,141,230,0.61304347826087,0.38695652173913,1
"18313","UTP23",8,10,18,0.555555555555556,0.444444444444444,1
"18314","UTP25",29,44,73,0.602739726027397,0.397260273972603,1
"18315","UTP3",11,15,26,0.576923076923077,0.423076923076923,1
"18316","UTP4",21,29,50,0.58,0.42,1
"18317","UTP6",28,25,53,0.471698113207547,0.528301886792453,1
"18318","UTRN",118,215,333,0.645645645645646,0.354354354354354,1
"18319","UTS2",3,8,11,0.727272727272727,0.272727272727273,1
"18320","UTS2B",8,12,20,0.6,0.4,1
"18321","UTS2R",13,15,28,0.535714285714286,0.464285714285714,1
"18322","UTY",0,32,32,1,0,1
"18323","UVRAG",32,44,76,0.578947368421053,0.421052631578947,1
"18324","UVSSA",27,33,60,0.55,0.45,1
"18325","UXS1",23,29,52,0.557692307692308,0.442307692307692,1
"18326","UXT",8,2,10,0.2,0.8,1
"18327","VAC14",28,29,57,0.508771929824561,0.491228070175439,1
"18328","VAMP1",0,9,9,1,0,1
"18329","VAMP2",1,5,6,0.833333333333333,0.166666666666667,1
"18330","VAMP3",2,6,8,0.75,0.25,1
"18331","VAMP4",6,6,12,0.5,0.5,1
"18332","VAMP5",5,4,9,0.444444444444444,0.555555555555556,1
"18333","VAMP7",7,21,28,0.75,0.25,1
"18334","VAMP8",2,5,7,0.714285714285714,0.285714285714286,1
"18335","VANGL1",25,27,52,0.519230769230769,0.480769230769231,0.11
"18336","VANGL2",32,38,70,0.542857142857143,0.457142857142857,0.11
"18337","VAPA",6,8,14,0.571428571428571,0.428571428571429,1
"18338","VAPB",5,15,20,0.75,0.25,1
"18339","VARS1",43,73,116,0.629310344827586,0.370689655172414,0.77
"18340","VARS2",27,50,77,0.649350649350649,0.350649350649351,0.77
"18341","VASH1",13,14,27,0.518518518518518,0.481481481481481,1
"18342","VASH2",10,13,23,0.565217391304348,0.434782608695652,1
"18343","VASN",14,15,29,0.517241379310345,0.482758620689655,1
"18344","VASP",11,14,25,0.56,0.44,1
"18345","VAT1",6,15,21,0.714285714285714,0.285714285714286,1
"18346","VAT1L",35,44,79,0.556962025316456,0.443037974683544,1
"18347","Vault",2,8,10,0.8,0.2,1
"18348","VAV1",60,86,146,0.589041095890411,0.410958904109589,1
"18349","VAV2",24,55,79,0.69620253164557,0.30379746835443,1
"18350","VAV3",51,72,123,0.585365853658537,0.414634146341463,1
"18351","VAX1",19,19,38,0.5,0.5,1
"18352","VAX2",12,16,28,0.571428571428571,0.428571428571429,1
"18353","VBP1",16,0,16,0,1,1
"18354","VCAM1",70,87,157,0.554140127388535,0.445859872611465,1
"18355","VCAN",211,300,511,0.587084148727984,0.412915851272016,1
"18356","VCL",33,36,69,0.521739130434783,0.478260869565217,1
"18357","VCP",33,35,68,0.514705882352941,0.485294117647059,1
"18358","VCPIP1",45,67,112,0.598214285714286,0.401785714285714,1
"18359","VCPKMT",4,13,17,0.764705882352941,0.235294117647059,1
"18360","VCX",14,19,33,0.575757575757576,0.424242424242424,1
"18361","VCX2",5,8,13,0.615384615384615,0.384615384615385,1
"18362","VCX3A",14,19,33,0.575757575757576,0.424242424242424,1
"18363","VCX3B",11,8,19,0.421052631578947,0.578947368421053,1
"18364","VDAC1",13,13,26,0.5,0.5,1
"18365","VDAC2",9,12,21,0.571428571428571,0.428571428571429,1
"18366","VDAC3",8,11,19,0.578947368421053,0.421052631578947,1
"18367","VDR",13,23,36,0.638888888888889,0.361111111111111,1
"18368","VEGFA",6,16,22,0.727272727272727,0.272727272727273,1
"18369","VEGFB",12,13,25,0.52,0.48,1
"18370","VEGFC",47,72,119,0.605042016806723,0.394957983193277,1
"18371","VEGFD",16,20,36,0.555555555555556,0.444444444444444,1
"18372","VENTX",11,27,38,0.710526315789474,0.289473684210526,1
"18373","VEPH1",51,68,119,0.571428571428571,0.428571428571429,1
"18374","VEZF1",15,25,40,0.625,0.375,1
"18375","VEZT",31,42,73,0.575342465753425,0.424657534246575,1
"18376","VGF",12,23,35,0.657142857142857,0.342857142857143,1
"18377","VGLL1",22,24,46,0.521739130434783,0.478260869565217,1
"18378","VGLL2",10,8,18,0.444444444444444,0.555555555555556,1
"18379","VGLL3",45,42,87,0.482758620689655,0.517241379310345,1
"18380","VGLL4",19,19,38,0.5,0.5,1
"18381","VHL",67,113,180,0.627777777777778,0.372222222222222,1
"18382","VHLL",7,7,14,0.5,0.5,1
"18383","VIL1",36,53,89,0.595505617977528,0.404494382022472,1
"18384","VILL",36,32,68,0.470588235294118,0.529411764705882,1
"18385","VIM",17,39,56,0.696428571428571,0.303571428571429,1
"18386","VIP",17,21,38,0.552631578947368,0.447368421052632,1
"18387","VIPAS39",18,33,51,0.647058823529412,0.352941176470588,1
"18388","VIPR1",13,18,31,0.580645161290323,0.419354838709677,1
"18389","VIPR2",19,40,59,0.677966101694915,0.322033898305085,1
"18390","VIRMA",66,128,194,0.65979381443299,0.34020618556701,1
"18391","VIT",41,67,108,0.62037037037037,0.37962962962963,1
"18392","VKORC1",5,4,9,0.444444444444444,0.555555555555556,1
"18393","VKORC1L1",6,10,16,0.625,0.375,1
"18394","VLDLR",20,45,65,0.692307692307692,0.307692307692308,1
"18395","VMA21",7,1,8,0.125,0.875,1
"18396","VMAC",3,0,3,0,1,1
"18397","VMO1",12,8,20,0.4,0.6,1
"18398","VMP1",21,20,41,0.48780487804878,0.51219512195122,1
"18399","VN1R1",9,27,36,0.75,0.25,1
"18400","VN1R10P",14,25,39,0.641025641025641,0.358974358974359,1
"18401","VN1R2",32,63,95,0.663157894736842,0.336842105263158,1
"18402","VN1R4",21,45,66,0.681818181818182,0.318181818181818,1
"18403","VN1R5",28,43,71,0.605633802816901,0.394366197183099,1
"18404","VNN1",22,46,68,0.676470588235294,0.323529411764706,1
"18405","VNN2",17,45,62,0.725806451612903,0.274193548387097,1
"18406","VNN3",15,11,26,0.423076923076923,0.576923076923077,1
"18407","VOPP1",6,10,16,0.625,0.375,1
"18408","VPREB1",13,16,29,0.551724137931034,0.448275862068966,1
"18409","VPREB3",0,8,8,1,0,1
"18410","VPS11",15,14,29,0.482758620689655,0.517241379310345,1
"18411","VPS13A",122,182,304,0.598684210526316,0.401315789473684,1
"18412","VPS13B",164,309,473,0.653276955602537,0.346723044397463,1
"18413","VPS13C",122,249,371,0.671159029649596,0.328840970350404,1
"18414","VPS13D",150,212,362,0.585635359116022,0.414364640883978,1
"18415","VPS16",27,56,83,0.674698795180723,0.325301204819277,1
"18416","VPS18",19,33,52,0.634615384615385,0.365384615384615,1
"18417","VPS25",4,7,11,0.636363636363636,0.363636363636364,1
"18418","VPS26A",8,14,22,0.636363636363636,0.363636363636364,1
"18419","VPS26B",9,14,23,0.608695652173913,0.391304347826087,1
"18420","VPS26C",11,19,30,0.633333333333333,0.366666666666667,1
"18421","VPS28",10,15,25,0.6,0.4,1
"18422","VPS29",5,9,14,0.642857142857143,0.357142857142857,1
"18423","VPS33A",32,39,71,0.549295774647887,0.450704225352113,1
"18424","VPS33B",12,23,35,0.657142857142857,0.342857142857143,1
"18425","VPS35",25,43,68,0.632352941176471,0.367647058823529,1
"18426","VPS35L",35,43,78,0.551282051282051,0.448717948717949,1
"18427","VPS36",15,17,32,0.53125,0.46875,1
"18428","VPS37A",10,20,30,0.666666666666667,0.333333333333333,1
"18429","VPS37B",14,16,30,0.533333333333333,0.466666666666667,1
"18430","VPS37C",5,17,22,0.772727272727273,0.227272727272727,1
"18431","VPS37D",3,4,7,0.571428571428571,0.428571428571429,1
"18432","VPS39",20,50,70,0.714285714285714,0.285714285714286,1
"18433","VPS41",36,57,93,0.612903225806452,0.387096774193548,1
"18434","VPS45",13,31,44,0.704545454545455,0.295454545454545,1
"18435","VPS4A",16,17,33,0.515151515151515,0.484848484848485,1
"18436","VPS4B",11,27,38,0.710526315789474,0.289473684210526,1
"18437","VPS50",54,70,124,0.564516129032258,0.435483870967742,1
"18438","VPS51",17,29,46,0.630434782608696,0.369565217391304,1
"18439","VPS52",32,41,73,0.561643835616438,0.438356164383562,1
"18440","VPS53",18,37,55,0.672727272727273,0.327272727272727,1
"18441","VPS54",24,52,76,0.684210526315789,0.315789473684211,1
"18442","VPS72",10,16,26,0.615384615384615,0.384615384615385,1
"18443","VPS8",44,72,116,0.620689655172414,0.379310344827586,1
"18444","VPS9D1",23,21,44,0.477272727272727,0.522727272727273,1
"18445","VRK1",13,18,31,0.580645161290323,0.419354838709677,1
"18446","VRK2",20,40,60,0.666666666666667,0.333333333333333,1
"18447","VRK3",13,21,34,0.617647058823529,0.382352941176471,1
"18448","VRTN",51,78,129,0.604651162790698,0.395348837209302,1
"18449","VSIG1",24,14,38,0.368421052631579,0.631578947368421,1
"18450","VSIG10",22,30,52,0.576923076923077,0.423076923076923,1
"18451","VSIG10L",0,4,4,1,0,1
"18452","VSIG2",15,27,42,0.642857142857143,0.357142857142857,1
"18453","VSIG4",34,15,49,0.306122448979592,0.693877551020408,1
"18454","VSIG8",9,19,28,0.678571428571429,0.321428571428571,1
"18455","VSIR",14,25,39,0.641025641025641,0.358974358974359,1
"18456","VSNL1",7,21,28,0.75,0.25,1
"18457","VSTM1",17,31,48,0.645833333333333,0.354166666666667,1
"18458","VSTM2A",22,51,73,0.698630136986301,0.301369863013699,1
"18459","VSTM2B",1,2,3,0.666666666666667,0.333333333333333,1
"18460","VSTM2L",10,14,24,0.583333333333333,0.416666666666667,1
"18461","VSTM4",22,53,75,0.706666666666667,0.293333333333333,1
"18462","VSX1",9,12,21,0.571428571428571,0.428571428571429,1
"18463","VSX2",7,19,26,0.730769230769231,0.269230769230769,1
"18464","VTA1",11,17,28,0.607142857142857,0.392857142857143,1
"18465","VTCN1",11,22,33,0.666666666666667,0.333333333333333,1
"18466","VTI1A",10,11,21,0.523809523809524,0.476190476190476,1
"18467","VTI1B",7,8,15,0.533333333333333,0.466666666666667,1
"18468","VTN",20,38,58,0.655172413793103,0.344827586206897,1
"18469","VWA1",8,8,16,0.5,0.5,1
"18470","VWA2",34,35,69,0.507246376811594,0.492753623188406,1
"18471","VWA3A",30,78,108,0.722222222222222,0.277777777777778,1
"18472","VWA3B",65,134,199,0.673366834170854,0.326633165829146,1
"18473","VWA5A",44,69,113,0.610619469026549,0.389380530973451,1
"18474","VWA5B1",1,5,6,0.833333333333333,0.166666666666667,1
"18475","VWA5B2",0,4,4,1,0,1
"18476","VWA7",37,59,96,0.614583333333333,0.385416666666667,1
"18477","VWA8",54,115,169,0.680473372781065,0.319526627218935,1
"18478","VWC2",16,23,39,0.58974358974359,0.41025641025641,1
"18479","VWC2L",25,33,58,0.568965517241379,0.431034482758621,1
"18480","VWCE",31,65,96,0.677083333333333,0.322916666666667,1
"18481","VWDE",4,7,11,0.636363636363636,0.363636363636364,1
"18482","VWF",138,203,341,0.595307917888563,0.404692082111437,1
"18483","VXN",17,7,24,0.291666666666667,0.708333333333333,1
"18484","WAC",26,66,92,0.717391304347826,0.282608695652174,1
"18485","WAPL",44,62,106,0.584905660377358,0.415094339622642,1
"18486","WARS1",18,27,45,0.6,0.4,0.77
"18487","WARS2",20,39,59,0.661016949152542,0.338983050847458,0.77
"18488","WAS",30,18,48,0.375,0.625,1
"18489","WASF1",16,35,51,0.686274509803922,0.313725490196078,1
"18490","WASF2",16,33,49,0.673469387755102,0.326530612244898,1
"18491","WASF3",38,72,110,0.654545454545455,0.345454545454545,1
"18492","WASF4P",56,28,84,0.333333333333333,0.666666666666667,1
"18493","WASHC1",1,4,5,0.8,0.2,1
"18494","WASHC2A",45,70,115,0.608695652173913,0.391304347826087,1
"18495","WASHC2C",50,78,128,0.609375,0.390625,1
"18496","WASHC3",5,13,18,0.722222222222222,0.277777777777778,1
"18497","WASHC4",37,66,103,0.640776699029126,0.359223300970874,1
"18498","WASHC5",38,65,103,0.631067961165049,0.368932038834951,1
"18499","WASL",25,46,71,0.647887323943662,0.352112676056338,1
"18500","WBP1",13,14,27,0.518518518518518,0.481481481481481,1
"18501","WBP11",25,36,61,0.590163934426229,0.409836065573771,1
"18502","WBP1L",14,11,25,0.44,0.56,1
"18503","WBP1LP2",1,3,4,0.75,0.25,1
"18504","WBP2",3,12,15,0.8,0.2,1
"18505","WBP2NL",15,18,33,0.545454545454545,0.454545454545455,1
"18506","WBP4",12,24,36,0.666666666666667,0.333333333333333,1
"18507","WDCP",22,35,57,0.614035087719298,0.385964912280702,1
"18508","WDFY1",12,18,30,0.6,0.4,1
"18509","WDFY2",13,13,26,0.5,0.5,1
"18510","WDFY3",150,221,371,0.595687331536388,0.404312668463612,1
"18511","WDFY4",2,13,15,0.866666666666667,0.133333333333333,1
"18512","WDHD1",25,59,84,0.702380952380952,0.297619047619048,1
"18513","WDPCP",29,54,83,0.650602409638554,0.349397590361446,1
"18514","WDR1",19,35,54,0.648148148148148,0.351851851851852,1
"18515","WDR11",34,65,99,0.656565656565657,0.343434343434343,1
"18516","WDR12",11,9,20,0.45,0.55,1
"18517","WDR13",33,17,50,0.34,0.66,1
"18518","WDR17",89,150,239,0.627615062761506,0.372384937238494,1
"18519","WDR18",3,23,26,0.884615384615385,0.115384615384615,1
"18520","WDR19",27,56,83,0.674698795180723,0.325301204819277,1
"18521","WDR20",9,34,43,0.790697674418605,0.209302325581395,1
"18522","WDR24",23,31,54,0.574074074074074,0.425925925925926,1
"18523","WDR25",16,35,51,0.686274509803922,0.313725490196078,1
"18524","WDR26",22,26,48,0.541666666666667,0.458333333333333,1
"18525","WDR27",26,33,59,0.559322033898305,0.440677966101695,1
"18526","WDR3",35,47,82,0.573170731707317,0.426829268292683,1
"18527","WDR31",10,28,38,0.736842105263158,0.263157894736842,1
"18528","WDR33",61,103,164,0.628048780487805,0.371951219512195,1
"18529","WDR35",35,78,113,0.690265486725664,0.309734513274336,1
"18530","WDR36",35,76,111,0.684684684684685,0.315315315315315,1
"18531","WDR37",14,24,38,0.631578947368421,0.368421052631579,1
"18532","WDR38",5,21,26,0.807692307692308,0.192307692307692,1
"18533","WDR4",10,8,18,0.444444444444444,0.555555555555556,1
"18534","WDR41",16,28,44,0.636363636363636,0.363636363636364,1
"18535","WDR43",16,19,35,0.542857142857143,0.457142857142857,1
"18536","WDR44",45,41,86,0.476744186046512,0.523255813953488,1
"18537","WDR45",30,17,47,0.361702127659574,0.638297872340426,1
"18538","WDR45B",11,28,39,0.717948717948718,0.282051282051282,1
"18539","WDR46",14,24,38,0.631578947368421,0.368421052631579,1
"18540","WDR47",32,59,91,0.648351648351648,0.351648351648352,1
"18541","WDR48",17,26,43,0.604651162790698,0.395348837209302,1
"18542","WDR49",72,114,186,0.612903225806452,0.387096774193548,1
"18543","WDR5",18,18,36,0.5,0.5,1
"18544","WDR53",12,20,32,0.625,0.375,1
"18545","WDR54",7,13,20,0.65,0.35,1
"18546","WDR55",34,30,64,0.46875,0.53125,1
"18547","WDR59",35,63,98,0.642857142857143,0.357142857142857,1
"18548","WDR5B",10,13,23,0.565217391304348,0.434782608695652,1
"18549","WDR6",37,58,95,0.610526315789474,0.389473684210526,1
"18550","WDR61",7,6,13,0.461538461538462,0.538461538461538,1
"18551","WDR62",50,64,114,0.56140350877193,0.43859649122807,1
"18552","WDR64",37,74,111,0.666666666666667,0.333333333333333,1
"18553","WDR7",68,82,150,0.546666666666667,0.453333333333333,1
"18554","WDR70",28,57,85,0.670588235294118,0.329411764705882,1
"18555","WDR72",76,136,212,0.641509433962264,0.358490566037736,1
"18556","WDR73",6,6,12,0.5,0.5,1
"18557","WDR74",8,14,22,0.636363636363636,0.363636363636364,1
"18558","WDR75",20,34,54,0.62962962962963,0.37037037037037,1
"18559","WDR76",14,23,37,0.621621621621622,0.378378378378378,1
"18560","WDR77",9,11,20,0.55,0.45,1
"18561","WDR81",24,60,84,0.714285714285714,0.285714285714286,1
"18562","WDR82",3,11,14,0.785714285714286,0.214285714285714,1
"18563","WDR83",4,16,20,0.8,0.2,1
"18564","WDR83OS",3,2,5,0.4,0.6,1
"18565","WDR86",10,17,27,0.62962962962963,0.37037037037037,1
"18566","WDR87",1,28,29,0.96551724137931,0.0344827586206897,1
"18567","WDR88",27,27,54,0.5,0.5,1
"18568","WDR89",9,12,21,0.571428571428571,0.428571428571429,1
"18569","WDR90",50,77,127,0.606299212598425,0.393700787401575,1
"18570","WDR91",30,41,71,0.577464788732394,0.422535211267606,1
"18571","WDR92",9,20,29,0.689655172413793,0.310344827586207,1
"18572","WDR93",13,43,56,0.767857142857143,0.232142857142857,1
"18573","WDSUB1",18,27,45,0.6,0.4,1
"18574","WDTC1",27,61,88,0.693181818181818,0.306818181818182,1
"18575","WEE1",16,28,44,0.636363636363636,0.363636363636364,1
"18576","WEE2",34,56,90,0.622222222222222,0.377777777777778,1
"18577","WFDC1",3,8,11,0.727272727272727,0.272727272727273,1
"18578","WFDC10A",3,4,7,0.571428571428571,0.428571428571429,1
"18579","WFDC10B",2,5,7,0.714285714285714,0.285714285714286,1
"18580","WFDC11",2,10,12,0.833333333333333,0.166666666666667,1
"18581","WFDC12",7,4,11,0.363636363636364,0.636363636363636,1
"18582","WFDC13",3,7,10,0.7,0.3,1
"18583","WFDC2",3,7,10,0.7,0.3,1
"18584","WFDC3",7,18,25,0.72,0.28,1
"18585","WFDC5",7,6,13,0.461538461538462,0.538461538461538,1
"18586","WFDC6",3,4,7,0.571428571428571,0.428571428571429,1
"18587","WFDC8",14,30,44,0.681818181818182,0.318181818181818,1
"18588","WFDC9",5,4,9,0.444444444444444,0.555555555555556,1
"18589","WFIKKN1",4,10,14,0.714285714285714,0.285714285714286,1
"18590","WFIKKN2",36,49,85,0.576470588235294,0.423529411764706,1
"18591","WFS1",20,48,68,0.705882352941177,0.294117647058824,1
"18592","WHAMM",15,20,35,0.571428571428571,0.428571428571429,1
"18593","WHRN",33,43,76,0.565789473684211,0.434210526315789,1
"18594","WIF1",22,40,62,0.645161290322581,0.354838709677419,1
"18595","WIPF1",37,47,84,0.55952380952381,0.44047619047619,1
"18596","WIPF2",30,32,62,0.516129032258065,0.483870967741935,1
"18597","WIPF3",13,17,30,0.566666666666667,0.433333333333333,1
"18598","WIPI1",10,19,29,0.655172413793103,0.344827586206897,1
"18599","WIPI2",16,28,44,0.636363636363636,0.363636363636364,1
"18600","WIZ",26,48,74,0.648648648648649,0.351351351351351,1
"18601","WLS",12,31,43,0.720930232558139,0.27906976744186,1
"18602","WNK1",76,120,196,0.612244897959184,0.387755102040816,1
"18603","WNK2",52,115,167,0.688622754491018,0.311377245508982,1
"18604","WNK3",112,84,196,0.428571428571429,0.571428571428571,1
"18605","WNK4",56,86,142,0.605633802816901,0.394366197183099,1
"18606","WNT1",28,21,49,0.428571428571429,0.571428571428571,1
"18607","WNT10A",14,21,35,0.6,0.4,1
"18608","WNT10B",18,29,47,0.617021276595745,0.382978723404255,1
"18609","WNT11",16,19,35,0.542857142857143,0.457142857142857,1
"18610","WNT16",35,34,69,0.492753623188406,0.507246376811594,1
"18611","WNT2",22,45,67,0.671641791044776,0.328358208955224,1
"18612","WNT2B",27,23,50,0.46,0.54,1
"18613","WNT3",16,30,46,0.652173913043478,0.347826086956522,1
"18614","WNT3A",16,42,58,0.724137931034483,0.275862068965517,1
"18615","WNT4",8,15,23,0.652173913043478,0.347826086956522,1
"18616","WNT5A",20,26,46,0.565217391304348,0.434782608695652,1
"18617","WNT5B",13,22,35,0.628571428571429,0.371428571428571,1
"18618","WNT6",7,13,20,0.65,0.35,1
"18619","WNT7A",20,48,68,0.705882352941177,0.294117647058824,1
"18620","WNT7B",16,21,37,0.567567567567568,0.432432432432432,1
"18621","WNT8A",17,19,36,0.527777777777778,0.472222222222222,1
"18622","WNT8B",10,23,33,0.696969696969697,0.303030303030303,1
"18623","WNT9A",24,40,64,0.625,0.375,1
"18624","WNT9B",8,30,38,0.789473684210526,0.210526315789474,1
"18625","WRAP53",18,32,50,0.64,0.36,1
"18626","WRAP73",13,19,32,0.59375,0.40625,1
"18627","WRN",42,84,126,0.666666666666667,0.333333333333333,1
"18628","WRNIP1",9,17,26,0.653846153846154,0.346153846153846,1
"18629","WSB1",13,16,29,0.551724137931034,0.448275862068966,1
"18630","WSB2",14,20,34,0.588235294117647,0.411764705882353,1
"18631","WSCD1",22,35,57,0.614035087719298,0.385964912280702,1
"18632","WSCD2",45,75,120,0.625,0.375,1
"18633","WT1",27,53,80,0.6625,0.3375,1
"18634","WTAP",22,27,49,0.551020408163265,0.448979591836735,1
"18635","WTIP",10,12,22,0.545454545454545,0.454545454545455,1
"18636","WWC1",57,71,128,0.5546875,0.4453125,1
"18637","WWC2",25,49,74,0.662162162162162,0.337837837837838,1
"18638","WWC3",84,58,142,0.408450704225352,0.591549295774648,1
"18639","WWOX",17,38,55,0.690909090909091,0.309090909090909,1
"18640","WWP1",46,64,110,0.581818181818182,0.418181818181818,1
"18641","WWP2",37,44,81,0.54320987654321,0.45679012345679,1
"18642","WWTR1",13,23,36,0.638888888888889,0.361111111111111,1
"18643","XAB2",33,50,83,0.602409638554217,0.397590361445783,1
"18644","XAF1",6,14,20,0.7,0.3,1
"18645","XAGE1B",0,1,1,1,0,1
"18646","XAGE2",14,13,27,0.481481481481481,0.518518518518518,1
"18647","XAGE3",8,9,17,0.529411764705882,0.470588235294118,1
"18648","XAGE5",14,9,23,0.391304347826087,0.608695652173913,1
"18649","XBP1",6,9,15,0.6,0.4,1
"18650","XCL1",5,19,24,0.791666666666667,0.208333333333333,1
"18651","XCL2",3,10,13,0.769230769230769,0.230769230769231,1
"18652","XCR1",17,31,48,0.645833333333333,0.354166666666667,1
"18653","XDH",82,150,232,0.646551724137931,0.353448275862069,1
"18654","XG",11,10,21,0.476190476190476,0.523809523809524,1
"18655","XIAP",30,15,45,0.333333333333333,0.666666666666667,1
"18656","XIRP1",76,147,223,0.659192825112108,0.340807174887892,1
"18657","XIRP2",367,621,988,0.628542510121457,0.371457489878542,1
"18658","XIST",62,95,157,0.605095541401274,0.394904458598726,1
"18659","XK",27,21,48,0.4375,0.5625,1
"18660","XKR3",47,72,119,0.605042016806723,0.394957983193277,1
"18661","XKR4",49,83,132,0.628787878787879,0.371212121212121,1
"18662","XKR5",9,19,28,0.678571428571429,0.321428571428571,1
"18663","XKR6",30,42,72,0.583333333333333,0.416666666666667,1
"18664","XKR7",32,50,82,0.609756097560976,0.390243902439024,1
"18665","XKR8",10,15,25,0.6,0.4,1
"18666","XKR9",22,32,54,0.592592592592593,0.407407407407407,1
"18667","XKRX",24,23,47,0.48936170212766,0.51063829787234,1
"18668","XPA",7,12,19,0.631578947368421,0.368421052631579,1
"18669","XPC",20,24,44,0.545454545454545,0.454545454545455,1
"18670","XPNPEP1",21,27,48,0.5625,0.4375,1
"18671","XPNPEP2",39,33,72,0.458333333333333,0.541666666666667,1
"18672","XPNPEP3",20,38,58,0.655172413793103,0.344827586206897,1
"18673","XPO1",35,45,80,0.5625,0.4375,1
"18674","XPO4",38,65,103,0.631067961165049,0.368932038834951,1
"18675","XPO5",22,56,78,0.717948717948718,0.282051282051282,1
"18676","XPO6",31,64,95,0.673684210526316,0.326315789473684,1
"18677","XPO7",28,50,78,0.641025641025641,0.358974358974359,1
"18678","XPOT",46,68,114,0.596491228070175,0.403508771929825,1
"18679","XPR1",43,53,96,0.552083333333333,0.447916666666667,1
"18680","XRCC1",9,34,43,0.790697674418605,0.209302325581395,1
"18681","XRCC2",19,21,40,0.525,0.475,1
"18682","XRCC3",7,7,14,0.5,0.5,1
"18683","XRCC4",14,22,36,0.611111111111111,0.388888888888889,1
"18684","XRCC5",33,41,74,0.554054054054054,0.445945945945946,1
"18685","XRCC6",13,31,44,0.704545454545455,0.295454545454545,1
"18686","XRN1",78,99,177,0.559322033898305,0.440677966101695,1
"18687","XRN2",33,64,97,0.65979381443299,0.34020618556701,1
"18688","XRRA1",21,32,53,0.60377358490566,0.39622641509434,1
"18689","XXYLT1",15,23,38,0.605263157894737,0.394736842105263,1
"18690","XYLB",22,36,58,0.620689655172414,0.379310344827586,1
"18691","XYLT1",58,78,136,0.573529411764706,0.426470588235294,1
"18692","XYLT2",60,62,122,0.508196721311475,0.491803278688525,1
"18693","YAE1",6,17,23,0.739130434782609,0.260869565217391,1
"18694","YAF2",2,15,17,0.882352941176471,0.117647058823529,1
"18695","YAP1",11,21,32,0.65625,0.34375,1
"18696","YARS1",25,24,49,0.489795918367347,0.510204081632653,0.77
"18697","YARS2",15,35,50,0.7,0.3,0.77
"18698","YBEY",3,6,9,0.666666666666667,0.333333333333333,1
"18699","YBX1",6,15,21,0.714285714285714,0.285714285714286,1
"18700","YBX2",23,26,49,0.530612244897959,0.469387755102041,1
"18701","YBX3",13,20,33,0.606060606060606,0.393939393939394,1
"18702","YDJC",5,3,8,0.375,0.625,1
"18703","YEATS2",42,67,109,0.614678899082569,0.385321100917431,1
"18704","YEATS4",9,11,20,0.55,0.45,1
"18705","YES1",24,30,54,0.555555555555556,0.444444444444444,1
"18706","YIF1A",13,22,35,0.628571428571429,0.371428571428571,1
"18707","YIF1B",9,18,27,0.666666666666667,0.333333333333333,1
"18708","YIPF1",9,20,29,0.689655172413793,0.310344827586207,1
"18709","YIPF2",7,10,17,0.588235294117647,0.411764705882353,1
"18710","YIPF3",10,18,28,0.642857142857143,0.357142857142857,1
"18711","YIPF4",7,17,24,0.708333333333333,0.291666666666667,1
"18712","YIPF5",6,16,22,0.727272727272727,0.272727272727273,1
"18713","YIPF6",19,0,19,0,1,1
"18714","YIPF7",11,31,42,0.738095238095238,0.261904761904762,1
"18715","YJEFN3",2,4,6,0.666666666666667,0.333333333333333,1
"18716","YJU2",8,9,17,0.529411764705882,0.470588235294118,1
"18717","YKT6",2,9,11,0.818181818181818,0.181818181818182,1
"18718","YLPM1",102,125,227,0.550660792951542,0.449339207048458,1
"18719","YME1L1",29,47,76,0.618421052631579,0.381578947368421,1
"18720","YOD1",4,15,19,0.789473684210526,0.210526315789474,1
"18721","YPEL1",5,7,12,0.583333333333333,0.416666666666667,1
"18722","YPEL2",7,7,14,0.5,0.5,1
"18723","YPEL3",0,10,10,1,0,1
"18724","YPEL4",6,3,9,0.333333333333333,0.666666666666667,1
"18725","YPEL5",3,10,13,0.769230769230769,0.230769230769231,1
"18726","YRDC",3,5,8,0.625,0.375,1
"18727","YTHDC1",54,64,118,0.542372881355932,0.457627118644068,1
"18728","YTHDC2",51,89,140,0.635714285714286,0.364285714285714,1
"18729","YTHDF1",28,30,58,0.517241379310345,0.482758620689655,1
"18730","YTHDF2",23,43,66,0.651515151515151,0.348484848484849,1
"18731","YTHDF3",13,38,51,0.745098039215686,0.254901960784314,1
"18732","YWHAB",7,10,17,0.588235294117647,0.411764705882353,1
"18733","YWHAE",8,20,28,0.714285714285714,0.285714285714286,1
"18734","YWHAG",5,9,14,0.642857142857143,0.357142857142857,1
"18735","YWHAH",9,7,16,0.4375,0.5625,1
"18736","YWHAQ",9,18,27,0.666666666666667,0.333333333333333,1
"18737","YWHAZ",7,13,20,0.65,0.35,1
"18738","YY1",12,16,28,0.571428571428571,0.428571428571429,1
"18739","YY1AP1",29,60,89,0.674157303370786,0.325842696629214,1
"18740","YY2",29,13,42,0.30952380952381,0.69047619047619,1
"18741","Z83844.2",21,21,42,0.5,0.5,1
"18742","Z84488.1",2,3,5,0.6,0.4,1
"18743","Z85994.1",0,1,1,1,0,1
"18744","ZACN",22,19,41,0.463414634146341,0.536585365853659,1
"18745","ZADH2",12,18,30,0.6,0.4,1
"18746","ZAN",112,244,356,0.685393258426966,0.314606741573034,1
"18747","ZAP70",31,52,83,0.626506024096386,0.373493975903614,1
"18748","ZAR1",3,7,10,0.7,0.3,0.77
"18749","ZAR1L",1,3,4,0.75,0.25,0.77
"18750","ZBBX",81,155,236,0.656779661016949,0.343220338983051,1
"18751","ZBED1",49,40,89,0.449438202247191,0.550561797752809,1
"18752","ZBED2",20,41,61,0.672131147540984,0.327868852459016,1
"18753","ZBED4",32,68,100,0.68,0.32,1
"18754","ZBED5",0,3,3,1,0,1
"18755","ZBED6CL",5,23,28,0.821428571428571,0.178571428571429,1
"18756","ZBED8",16,19,35,0.542857142857143,0.457142857142857,1
"18757","ZBED9",97,207,304,0.680921052631579,0.319078947368421,1
"18758","ZBP1",24,46,70,0.657142857142857,0.342857142857143,1
"18759","ZBTB1",17,38,55,0.690909090909091,0.309090909090909,1
"18760","ZBTB10",17,19,36,0.527777777777778,0.472222222222222,1
"18761","ZBTB11",39,58,97,0.597938144329897,0.402061855670103,1
"18762","ZBTB12",14,15,29,0.517241379310345,0.482758620689655,1
"18763","ZBTB14",21,28,49,0.571428571428571,0.428571428571429,1
"18764","ZBTB16",41,59,100,0.59,0.41,1
"18765","ZBTB17",4,36,40,0.9,0.1,1
"18766","ZBTB18",25,37,62,0.596774193548387,0.403225806451613,1
"18767","ZBTB2",20,31,51,0.607843137254902,0.392156862745098,1
"18768","ZBTB20",80,113,193,0.585492227979275,0.414507772020725,1
"18769","ZBTB21",43,65,108,0.601851851851852,0.398148148148148,1
"18770","ZBTB22",38,46,84,0.547619047619048,0.452380952380952,1
"18771","ZBTB24",24,37,61,0.60655737704918,0.39344262295082,1
"18772","ZBTB25",15,18,33,0.545454545454545,0.454545454545455,1
"18773","ZBTB26",15,22,37,0.594594594594595,0.405405405405405,1
"18774","ZBTB3",15,26,41,0.634146341463415,0.365853658536585,1
"18775","ZBTB32",19,34,53,0.641509433962264,0.358490566037736,1
"18776","ZBTB33",55,25,80,0.3125,0.6875,1
"18777","ZBTB34",13,26,39,0.666666666666667,0.333333333333333,1
"18778","ZBTB37",8,16,24,0.666666666666667,0.333333333333333,1
"18779","ZBTB38",41,51,92,0.554347826086957,0.445652173913043,1
"18780","ZBTB39",20,34,54,0.62962962962963,0.37037037037037,1
"18781","ZBTB4",28,46,74,0.621621621621622,0.378378378378378,1
"18782","ZBTB40",45,56,101,0.554455445544555,0.445544554455446,1
"18783","ZBTB41",47,73,120,0.608333333333333,0.391666666666667,1
"18784","ZBTB43",13,24,37,0.648648648648649,0.351351351351351,1
"18785","ZBTB44",13,23,36,0.638888888888889,0.361111111111111,1
"18786","ZBTB45",23,30,53,0.566037735849057,0.433962264150943,1
"18787","ZBTB46",28,52,80,0.65,0.35,1
"18788","ZBTB47",9,11,20,0.55,0.45,1
"18789","ZBTB48",14,24,38,0.631578947368421,0.368421052631579,1
"18790","ZBTB49",23,40,63,0.634920634920635,0.365079365079365,1
"18791","ZBTB5",16,36,52,0.692307692307692,0.307692307692308,1
"18792","ZBTB6",11,20,31,0.645161290322581,0.354838709677419,1
"18793","ZBTB7A",21,28,49,0.571428571428571,0.428571428571429,1
"18794","ZBTB7B",29,40,69,0.579710144927536,0.420289855072464,1
"18795","ZBTB7C",38,50,88,0.568181818181818,0.431818181818182,1
"18796","ZBTB8A",14,24,38,0.631578947368421,0.368421052631579,1
"18797","ZBTB8OS",10,3,13,0.230769230769231,0.769230769230769,1
"18798","ZBTB9",21,31,52,0.596153846153846,0.403846153846154,1
"18799","ZC2HC1A",12,19,31,0.612903225806452,0.387096774193548,1
"18800","ZC2HC1C",7,18,25,0.72,0.28,1
"18801","ZC3H10",9,16,25,0.64,0.36,1
"18802","ZC3H11A",20,40,60,0.666666666666667,0.333333333333333,1
"18803","ZC3H12A",28,42,70,0.6,0.4,1
"18804","ZC3H12B",57,29,86,0.337209302325581,0.662790697674419,1
"18805","ZC3H12C",42,54,96,0.5625,0.4375,1
"18806","ZC3H12D",9,11,20,0.55,0.45,1
"18807","ZC3H13",89,119,208,0.572115384615385,0.427884615384615,1
"18808","ZC3H14",24,49,73,0.671232876712329,0.328767123287671,1
"18809","ZC3H15",17,23,40,0.575,0.425,1
"18810","ZC3H18",68,72,140,0.514285714285714,0.485714285714286,1
"18811","ZC3H3",31,55,86,0.63953488372093,0.36046511627907,1
"18812","ZC3H4",48,63,111,0.567567567567568,0.432432432432432,1
"18813","ZC3H6",40,67,107,0.626168224299065,0.373831775700935,1
"18814","ZC3H7A",31,43,74,0.581081081081081,0.418918918918919,1
"18815","ZC3H7B",38,49,87,0.563218390804598,0.436781609195402,1
"18816","ZC3H8",6,8,14,0.571428571428571,0.428571428571429,1
"18817","ZC3HAV1",29,71,100,0.71,0.29,1
"18818","ZC3HAV1L",9,12,21,0.571428571428571,0.428571428571429,1
"18819","ZC3HC1",17,30,47,0.638297872340426,0.361702127659574,1
"18820","ZC4H2",35,19,54,0.351851851851852,0.648148148148148,1
"18821","ZCCHC10",4,5,9,0.555555555555556,0.444444444444444,1
"18822","ZCCHC12",44,24,68,0.352941176470588,0.647058823529412,1
"18823","ZCCHC13",19,10,29,0.344827586206897,0.655172413793103,1
"18824","ZCCHC14",31,52,83,0.626506024096386,0.373493975903614,1
"18825","ZCCHC17",8,13,21,0.619047619047619,0.380952380952381,1
"18826","ZCCHC2",29,45,74,0.608108108108108,0.391891891891892,1
"18827","ZCCHC24",8,6,14,0.428571428571429,0.571428571428571,1
"18828","ZCCHC3",2,14,16,0.875,0.125,1
"18829","ZCCHC4",13,22,35,0.628571428571429,0.371428571428571,1
"18830","ZCCHC7",23,28,51,0.549019607843137,0.450980392156863,1
"18831","ZCCHC8",31,30,61,0.491803278688525,0.508196721311475,1
"18832","ZCCHC9",16,12,28,0.428571428571429,0.571428571428571,1
"18833","ZCRB1",17,19,36,0.527777777777778,0.472222222222222,1
"18834","ZCWPW1",12,46,58,0.793103448275862,0.206896551724138,1
"18835","ZCWPW2",20,28,48,0.583333333333333,0.416666666666667,1
"18836","ZDBF2",162,266,428,0.621495327102804,0.378504672897196,1
"18837","ZDHHC1",14,11,25,0.44,0.56,1
"18838","ZDHHC11",14,16,30,0.533333333333333,0.466666666666667,1
"18839","ZDHHC12",3,10,13,0.769230769230769,0.230769230769231,1
"18840","ZDHHC13",12,15,27,0.555555555555556,0.444444444444444,1
"18841","ZDHHC14",16,29,45,0.644444444444444,0.355555555555556,1
"18842","ZDHHC15",25,24,49,0.489795918367347,0.510204081632653,1
"18843","ZDHHC16",17,15,32,0.46875,0.53125,1
"18844","ZDHHC17",26,25,51,0.490196078431373,0.509803921568627,1
"18845","ZDHHC18",10,14,24,0.583333333333333,0.416666666666667,1
"18846","ZDHHC19",9,17,26,0.653846153846154,0.346153846153846,1
"18847","ZDHHC2",11,25,36,0.694444444444444,0.305555555555556,1
"18848","ZDHHC20",10,13,23,0.565217391304348,0.434782608695652,1
"18849","ZDHHC21",6,16,22,0.727272727272727,0.272727272727273,1
"18850","ZDHHC22",3,12,15,0.8,0.2,1
"18851","ZDHHC23",18,21,39,0.538461538461538,0.461538461538462,1
"18852","ZDHHC24",6,4,10,0.4,0.6,1
"18853","ZDHHC3",14,15,29,0.517241379310345,0.482758620689655,1
"18854","ZDHHC4",13,25,38,0.657894736842105,0.342105263157895,1
"18855","ZDHHC5",20,34,54,0.62962962962963,0.37037037037037,1
"18856","ZDHHC6",11,20,31,0.645161290322581,0.354838709677419,1
"18857","ZDHHC7",27,17,44,0.386363636363636,0.613636363636364,1
"18858","ZDHHC8",34,55,89,0.617977528089888,0.382022471910112,1
"18859","ZDHHC9",22,13,35,0.371428571428571,0.628571428571429,1
"18860","ZEB1",53,145,198,0.732323232323232,0.267676767676768,1
"18861","ZEB2",93,156,249,0.626506024096386,0.373493975903614,1
"18862","ZER1",23,29,52,0.557692307692308,0.442307692307692,1
"18863","ZFAND1",19,16,35,0.457142857142857,0.542857142857143,1
"18864","ZFAND2A",4,10,14,0.714285714285714,0.285714285714286,1
"18865","ZFAND2B",9,9,18,0.5,0.5,1
"18866","ZFAND3",9,12,21,0.571428571428571,0.428571428571429,1
"18867","ZFAND4",26,50,76,0.657894736842105,0.342105263157895,1
"18868","ZFAND5",7,12,19,0.631578947368421,0.368421052631579,1
"18869","ZFAND6",9,11,20,0.55,0.45,1
"18870","ZFAT",64,98,162,0.604938271604938,0.395061728395062,1
"18871","ZFC3H1",69,112,181,0.61878453038674,0.38121546961326,1
"18872","ZFHX3",150,230,380,0.605263157894737,0.394736842105263,1
"18873","ZFHX4",405,687,1092,0.629120879120879,0.370879120879121,1
"18874","ZFP1",16,15,31,0.483870967741935,0.516129032258065,1
"18875","ZFP14",16,55,71,0.774647887323944,0.225352112676056,1
"18876","ZFP2",18,52,70,0.742857142857143,0.257142857142857,1
"18877","ZFP28",29,52,81,0.641975308641975,0.358024691358025,1
"18878","ZFP3",26,25,51,0.490196078431373,0.509803921568627,1
"18879","ZFP30",23,45,68,0.661764705882353,0.338235294117647,1
"18880","ZFP36",9,25,34,0.735294117647059,0.264705882352941,1
"18881","ZFP36L1",32,57,89,0.640449438202247,0.359550561797753,1
"18882","ZFP36L2",27,55,82,0.670731707317073,0.329268292682927,1
"18883","ZFP37",36,65,101,0.643564356435644,0.356435643564356,1
"18884","ZFP41",12,17,29,0.586206896551724,0.413793103448276,1
"18885","ZFP42",51,66,117,0.564102564102564,0.435897435897436,1
"18886","ZFP57",36,56,92,0.608695652173913,0.391304347826087,1
"18887","ZFP62",0,5,5,1,0,1
"18888","ZFP64",36,55,91,0.604395604395604,0.395604395604396,1
"18889","ZFP69",13,20,33,0.606060606060606,0.393939393939394,1
"18890","ZFP69B",12,37,49,0.755102040816326,0.244897959183673,1
"18891","ZFP82",27,41,68,0.602941176470588,0.397058823529412,1
"18892","ZFP90",22,47,69,0.681159420289855,0.318840579710145,1
"18893","ZFP91",24,36,60,0.6,0.4,1
"18894","ZFP92",0,2,2,1,0,1
"18895","ZFPL1",8,17,25,0.68,0.32,1
"18896","ZFPM1",9,23,32,0.71875,0.28125,1
"18897","ZFPM2",94,213,307,0.693811074918567,0.306188925081433,1
"18898","ZFR",49,63,112,0.5625,0.4375,1
"18899","ZFR2",28,44,72,0.611111111111111,0.388888888888889,1
"18900","ZFX",35,42,77,0.545454545454545,0.454545454545455,1
"18901","ZFY",0,25,25,1,0,1
"18902","ZFYVE1",25,37,62,0.596774193548387,0.403225806451613,1
"18903","ZFYVE16",43,72,115,0.626086956521739,0.373913043478261,1
"18904","ZFYVE19",8,12,20,0.6,0.4,1
"18905","ZFYVE21",4,11,15,0.733333333333333,0.266666666666667,1
"18906","ZFYVE26",91,125,216,0.578703703703704,0.421296296296296,1
"18907","ZFYVE27",12,17,29,0.586206896551724,0.413793103448276,1
"18908","ZFYVE28",33,61,94,0.648936170212766,0.351063829787234,1
"18909","ZFYVE9",46,83,129,0.643410852713178,0.356589147286822,1
"18910","ZG16B",9,20,29,0.689655172413793,0.310344827586207,1
"18911","ZGLP1",3,11,14,0.785714285714286,0.214285714285714,1
"18912","ZGPAT",20,29,49,0.591836734693878,0.408163265306122,1
"18913","ZGRF1",50,100,150,0.666666666666667,0.333333333333333,1
"18914","ZHX1",42,34,76,0.447368421052632,0.552631578947368,1
"18915","ZHX2",49,63,112,0.5625,0.4375,1
"18916","ZHX3",34,47,81,0.580246913580247,0.419753086419753,1
"18917","ZIC1",57,102,159,0.641509433962264,0.358490566037736,1
"18918","ZIC2",13,21,34,0.617647058823529,0.382352941176471,1
"18919","ZIC3",41,25,66,0.378787878787879,0.621212121212121,1
"18920","ZIC4",58,92,150,0.613333333333333,0.386666666666667,1
"18921","ZIC5",12,16,28,0.571428571428571,0.428571428571429,1
"18922","ZIK1",32,42,74,0.567567567567568,0.432432432432432,1
"18923","ZIM2",44,63,107,0.588785046728972,0.411214953271028,1
"18924","ZIM3",58,104,162,0.641975308641975,0.358024691358025,1
"18925","ZKSCAN1",18,22,40,0.55,0.45,1
"18926","ZKSCAN2",46,61,107,0.570093457943925,0.429906542056075,1
"18927","ZKSCAN3",19,35,54,0.648148148148148,0.351851851851852,1
"18928","ZKSCAN4",19,22,41,0.536585365853659,0.463414634146341,1
"18929","ZKSCAN5",32,53,85,0.623529411764706,0.376470588235294,1
"18930","ZKSCAN7",29,49,78,0.628205128205128,0.371794871794872,1
"18931","ZKSCAN8",24,24,48,0.5,0.5,1
"18932","ZMAT1",49,41,90,0.455555555555556,0.544444444444444,1
"18933","ZMAT2",6,9,15,0.6,0.4,1
"18934","ZMAT3",15,21,36,0.583333333333333,0.416666666666667,1
"18935","ZMAT4",28,35,63,0.555555555555556,0.444444444444444,1
"18936","ZMAT5",4,8,12,0.666666666666667,0.333333333333333,1
"18937","ZMIZ1",36,75,111,0.675675675675676,0.324324324324324,1
"18938","ZMIZ2",39,55,94,0.585106382978723,0.414893617021277,1
"18939","ZMPSTE24",12,33,45,0.733333333333333,0.266666666666667,1
"18940","ZMYM1",36,68,104,0.653846153846154,0.346153846153846,1
"18941","ZMYM2",56,61,117,0.521367521367521,0.478632478632479,1
"18942","ZMYM3",84,36,120,0.3,0.7,1
"18943","ZMYM4",54,88,142,0.619718309859155,0.380281690140845,1
"18944","ZMYM5",17,36,53,0.679245283018868,0.320754716981132,1
"18945","ZMYM6",39,75,114,0.657894736842105,0.342105263157895,1
"18946","ZMYND10",12,7,19,0.368421052631579,0.631578947368421,1
"18947","ZMYND11",23,32,55,0.581818181818182,0.418181818181818,1
"18948","ZMYND12",7,27,34,0.794117647058823,0.205882352941176,1
"18949","ZMYND15",19,40,59,0.677966101694915,0.322033898305085,1
"18950","ZMYND19",6,17,23,0.739130434782609,0.260869565217391,1
"18951","ZMYND8",60,76,136,0.558823529411765,0.441176470588235,1
"18952","ZNF10",23,43,66,0.651515151515151,0.348484848484849,1
"18953","ZNF100",24,43,67,0.641791044776119,0.358208955223881,1
"18954","ZNF101",24,28,52,0.538461538461538,0.461538461538462,1
"18955","ZNF106",63,89,152,0.585526315789474,0.414473684210526,1
"18956","ZNF107",42,74,116,0.637931034482759,0.362068965517241,1
"18957","ZNF112",31,68,99,0.686868686868687,0.313131313131313,1
"18958","ZNF114",25,21,46,0.456521739130435,0.543478260869565,1
"18959","ZNF117",29,30,59,0.508474576271186,0.491525423728814,1
"18960","ZNF12",22,51,73,0.698630136986301,0.301369863013699,1
"18961","ZNF121",20,22,42,0.523809523809524,0.476190476190476,1
"18962","ZNF124",19,23,42,0.547619047619048,0.452380952380952,1
"18963","ZNF131",21,35,56,0.625,0.375,1
"18964","ZNF132",22,44,66,0.666666666666667,0.333333333333333,1
"18965","ZNF133",22,46,68,0.676470588235294,0.323529411764706,1
"18966","ZNF134",14,25,39,0.641025641025641,0.358974358974359,1
"18967","ZNF135",35,68,103,0.660194174757282,0.339805825242718,1
"18968","ZNF136",21,40,61,0.655737704918033,0.344262295081967,1
"18969","ZNF137P",5,15,20,0.75,0.25,1
"18970","ZNF138",12,13,25,0.52,0.48,1
"18971","ZNF14",26,49,75,0.653333333333333,0.346666666666667,1
"18972","ZNF140",23,24,47,0.51063829787234,0.48936170212766,1
"18973","ZNF141",18,37,55,0.672727272727273,0.327272727272727,1
"18974","ZNF142",64,75,139,0.539568345323741,0.460431654676259,1
"18975","ZNF143",8,30,38,0.789473684210526,0.210526315789474,1
"18976","ZNF146",6,24,30,0.8,0.2,1
"18977","ZNF148",33,60,93,0.645161290322581,0.354838709677419,1
"18978","ZNF154",29,29,58,0.5,0.5,1
"18979","ZNF155",18,32,50,0.64,0.36,1
"18980","ZNF157",37,24,61,0.39344262295082,0.60655737704918,1
"18981","ZNF16",24,43,67,0.641791044776119,0.358208955223881,1
"18982","ZNF160",32,73,105,0.695238095238095,0.304761904761905,1
"18983","ZNF165",13,33,46,0.717391304347826,0.282608695652174,1
"18984","ZNF169",11,34,45,0.755555555555556,0.244444444444444,1
"18985","ZNF17",27,32,59,0.542372881355932,0.457627118644068,1
"18986","ZNF174",27,27,54,0.5,0.5,1
"18987","ZNF175",20,48,68,0.705882352941177,0.294117647058824,1
"18988","ZNF18",13,25,38,0.657894736842105,0.342105263157895,1
"18989","ZNF180",33,66,99,0.666666666666667,0.333333333333333,1
"18990","ZNF181",15,26,41,0.634146341463415,0.365853658536585,1
"18991","ZNF182",38,19,57,0.333333333333333,0.666666666666667,1
"18992","ZNF184",54,68,122,0.557377049180328,0.442622950819672,1
"18993","ZNF185",31,20,51,0.392156862745098,0.607843137254902,1
"18994","ZNF189",23,33,56,0.589285714285714,0.410714285714286,1
"18995","ZNF19",24,31,55,0.563636363636364,0.436363636363636,1
"18996","ZNF192P1",0,4,4,1,0,1
"18997","ZNF195",16,29,45,0.644444444444444,0.355555555555556,1
"18998","ZNF197",26,49,75,0.653333333333333,0.346666666666667,1
"18999","ZNF2",24,26,50,0.52,0.48,1
"19000","ZNF20",10,35,45,0.777777777777778,0.222222222222222,1
"19001","ZNF200",14,18,32,0.5625,0.4375,1
"19002","ZNF202",17,40,57,0.701754385964912,0.298245614035088,1
"19003","ZNF205",24,28,52,0.538461538461538,0.461538461538462,1
"19004","ZNF207",19,34,53,0.641509433962264,0.358490566037736,1
"19005","ZNF208",145,210,355,0.591549295774648,0.408450704225352,1
"19006","ZNF211",32,48,80,0.6,0.4,1
"19007","ZNF212",15,33,48,0.6875,0.3125,1
"19008","ZNF213",14,22,36,0.611111111111111,0.388888888888889,1
"19009","ZNF214",32,51,83,0.614457831325301,0.385542168674699,1
"19010","ZNF215",30,56,86,0.651162790697674,0.348837209302326,1
"19011","ZNF217",46,56,102,0.549019607843137,0.450980392156863,1
"19012","ZNF219",14,14,28,0.5,0.5,1
"19013","ZNF22",4,19,23,0.826086956521739,0.173913043478261,1
"19014","ZNF221",27,49,76,0.644736842105263,0.355263157894737,1
"19015","ZNF222",25,21,46,0.456521739130435,0.543478260869565,1
"19016","ZNF223",22,38,60,0.633333333333333,0.366666666666667,1
"19017","ZNF224",22,36,58,0.620689655172414,0.379310344827586,1
"19018","ZNF225",21,44,65,0.676923076923077,0.323076923076923,1
"19019","ZNF226",36,55,91,0.604395604395604,0.395604395604396,1
"19020","ZNF227",28,44,72,0.611111111111111,0.388888888888889,1
"19021","ZNF229",48,92,140,0.657142857142857,0.342857142857143,1
"19022","ZNF23",27,33,60,0.55,0.45,1
"19023","ZNF230",27,36,63,0.571428571428571,0.428571428571429,1
"19024","ZNF232",15,24,39,0.615384615384615,0.384615384615385,1
"19025","ZNF233",21,38,59,0.644067796610169,0.355932203389831,1
"19026","ZNF234",26,47,73,0.643835616438356,0.356164383561644,1
"19027","ZNF235",35,43,78,0.551282051282051,0.448717948717949,1
"19028","ZNF236",84,139,223,0.623318385650224,0.376681614349776,1
"19029","ZNF239",18,46,64,0.71875,0.28125,1
"19030","ZNF24",7,27,34,0.794117647058823,0.205882352941176,1
"19031","ZNF248",37,43,80,0.5375,0.4625,1
"19032","ZNF25",21,31,52,0.596153846153846,0.403846153846154,1
"19033","ZNF250",11,21,32,0.65625,0.34375,1
"19034","ZNF251",26,51,77,0.662337662337662,0.337662337662338,1
"19035","ZNF253",22,37,59,0.627118644067797,0.372881355932203,1
"19036","ZNF254",36,66,102,0.647058823529412,0.352941176470588,1
"19037","ZNF256",26,44,70,0.628571428571429,0.371428571428571,1
"19038","ZNF257",53,102,155,0.658064516129032,0.341935483870968,1
"19039","ZNF26",27,49,76,0.644736842105263,0.355263157894737,1
"19040","ZNF260",16,24,40,0.6,0.4,1
"19041","ZNF263",23,38,61,0.622950819672131,0.377049180327869,1
"19042","ZNF264",34,34,68,0.5,0.5,1
"19043","ZNF266",25,50,75,0.666666666666667,0.333333333333333,1
"19044","ZNF267",36,54,90,0.6,0.4,1
"19045","ZNF268",10,23,33,0.696969696969697,0.303030303030303,1
"19046","ZNF271P",20,40,60,0.666666666666667,0.333333333333333,1
"19047","ZNF273",27,33,60,0.55,0.45,1
"19048","ZNF274",20,44,64,0.6875,0.3125,1
"19049","ZNF275",23,12,35,0.342857142857143,0.657142857142857,1
"19050","ZNF276",16,32,48,0.666666666666667,0.333333333333333,1
"19051","ZNF277",12,31,43,0.720930232558139,0.27906976744186,1
"19052","ZNF28",37,52,89,0.584269662921348,0.415730337078652,1
"19053","ZNF280A",36,50,86,0.581395348837209,0.418604651162791,1
"19054","ZNF280B",20,32,52,0.615384615384615,0.384615384615385,1
"19055","ZNF280C",31,19,50,0.38,0.62,1
"19056","ZNF280D",11,12,23,0.521739130434783,0.478260869565217,1
"19057","ZNF281",22,39,61,0.639344262295082,0.360655737704918,1
"19058","ZNF282",29,36,65,0.553846153846154,0.446153846153846,1
"19059","ZNF283",28,50,78,0.641025641025641,0.358974358974359,1
"19060","ZNF284",26,52,78,0.666666666666667,0.333333333333333,1
"19061","ZNF285",35,60,95,0.631578947368421,0.368421052631579,1
"19062","ZNF286A",19,29,48,0.604166666666667,0.395833333333333,1
"19063","ZNF286B",0,2,2,1,0,1
"19064","ZNF287",22,55,77,0.714285714285714,0.285714285714286,1
"19065","ZNF292",110,170,280,0.607142857142857,0.392857142857143,1
"19066","ZNF296",18,17,35,0.485714285714286,0.514285714285714,1
"19067","ZNF3",16,30,46,0.652173913043478,0.347826086956522,1
"19068","ZNF30",18,29,47,0.617021276595745,0.382978723404255,1
"19069","ZNF300",30,50,80,0.625,0.375,1
"19070","ZNF302",17,19,36,0.527777777777778,0.472222222222222,1
"19071","ZNF304",27,47,74,0.635135135135135,0.364864864864865,1
"19072","ZNF311",29,43,72,0.597222222222222,0.402777777777778,1
"19073","ZNF317",24,33,57,0.578947368421053,0.421052631578947,1
"19074","ZNF318",92,127,219,0.579908675799087,0.420091324200913,1
"19075","ZNF319",21,27,48,0.5625,0.4375,1
"19076","ZNF32",10,19,29,0.655172413793103,0.344827586206897,1
"19077","ZNF320",31,51,82,0.621951219512195,0.378048780487805,1
"19078","ZNF322",6,17,23,0.739130434782609,0.260869565217391,1
"19079","ZNF322P1",15,14,29,0.482758620689655,0.517241379310345,1
"19080","ZNF324",20,21,41,0.51219512195122,0.48780487804878,1
"19081","ZNF324B",22,33,55,0.6,0.4,1
"19082","ZNF326",22,29,51,0.568627450980392,0.431372549019608,1
"19083","ZNF329",29,43,72,0.597222222222222,0.402777777777778,1
"19084","ZNF330",22,25,47,0.531914893617021,0.468085106382979,1
"19085","ZNF331",42,70,112,0.625,0.375,1
"19086","ZNF333",14,36,50,0.72,0.28,1
"19087","ZNF334",53,83,136,0.610294117647059,0.389705882352941,1
"19088","ZNF335",44,75,119,0.630252100840336,0.369747899159664,1
"19089","ZNF337",27,42,69,0.608695652173913,0.391304347826087,1
"19090","ZNF33A",35,82,117,0.700854700854701,0.299145299145299,1
"19091","ZNF33B",36,52,88,0.590909090909091,0.409090909090909,1
"19092","ZNF34",29,28,57,0.491228070175439,0.508771929824561,1
"19093","ZNF341",23,68,91,0.747252747252747,0.252747252747253,1
"19094","ZNF343",17,39,56,0.696428571428571,0.303571428571429,1
"19095","ZNF345",32,45,77,0.584415584415584,0.415584415584416,1
"19096","ZNF346",10,13,23,0.565217391304348,0.434782608695652,1
"19097","ZNF347",37,89,126,0.706349206349206,0.293650793650794,1
"19098","ZNF35",21,28,49,0.571428571428571,0.428571428571429,1
"19099","ZNF350",18,37,55,0.672727272727273,0.327272727272727,1
"19100","ZNF354A",36,46,82,0.560975609756098,0.439024390243902,1
"19101","ZNF354B",24,33,57,0.578947368421053,0.421052631578947,1
"19102","ZNF354C",25,55,80,0.6875,0.3125,1
"19103","ZNF358",17,26,43,0.604651162790698,0.395348837209302,1
"19104","ZNF362",22,16,38,0.421052631578947,0.578947368421053,1
"19105","ZNF365",33,48,81,0.592592592592593,0.407407407407407,1
"19106","ZNF366",46,62,108,0.574074074074074,0.425925925925926,1
"19107","ZNF367",9,20,29,0.689655172413793,0.310344827586207,1
"19108","ZNF37A",39,47,86,0.546511627906977,0.453488372093023,1
"19109","ZNF382",39,61,100,0.61,0.39,1
"19110","ZNF383",24,26,50,0.52,0.48,1
"19111","ZNF384",22,32,54,0.592592592592593,0.407407407407407,1
"19112","ZNF385A",13,23,36,0.638888888888889,0.361111111111111,1
"19113","ZNF385B",27,52,79,0.658227848101266,0.341772151898734,1
"19114","ZNF385C",7,4,11,0.363636363636364,0.636363636363636,1
"19115","ZNF385D",60,92,152,0.605263157894737,0.394736842105263,1
"19116","ZNF391",17,34,51,0.666666666666667,0.333333333333333,1
"19117","ZNF394",20,30,50,0.6,0.4,1
"19118","ZNF395",16,44,60,0.733333333333333,0.266666666666667,1
"19119","ZNF396",9,19,28,0.678571428571429,0.321428571428571,1
"19120","ZNF397",8,16,24,0.666666666666667,0.333333333333333,1
"19121","ZNF398",30,40,70,0.571428571428571,0.428571428571429,1
"19122","ZNF404",28,41,69,0.594202898550725,0.405797101449275,1
"19123","ZNF407",77,117,194,0.603092783505155,0.396907216494845,1
"19124","ZNF408",28,28,56,0.5,0.5,1
"19125","ZNF41",39,25,64,0.390625,0.609375,1
"19126","ZNF410",8,15,23,0.652173913043478,0.347826086956522,1
"19127","ZNF414",7,8,15,0.533333333333333,0.466666666666667,1
"19128","ZNF415",22,54,76,0.710526315789474,0.289473684210526,1
"19129","ZNF416",34,34,68,0.5,0.5,1
"19130","ZNF417",13,43,56,0.767857142857143,0.232142857142857,1
"19131","ZNF418",27,60,87,0.689655172413793,0.310344827586207,1
"19132","ZNF419",25,42,67,0.626865671641791,0.373134328358209,1
"19133","ZNF420",31,45,76,0.592105263157895,0.407894736842105,1
"19134","ZNF423",121,154,275,0.56,0.44,1
"19135","ZNF425",41,72,113,0.63716814159292,0.36283185840708,1
"19136","ZNF426",19,33,52,0.634615384615385,0.365384615384615,1
"19137","ZNF428",8,6,14,0.428571428571429,0.571428571428571,1
"19138","ZNF429",35,49,84,0.583333333333333,0.416666666666667,1
"19139","ZNF43",58,90,148,0.608108108108108,0.391891891891892,1
"19140","ZNF430",26,49,75,0.653333333333333,0.346666666666667,1
"19141","ZNF431",25,45,70,0.642857142857143,0.357142857142857,1
"19142","ZNF432",16,51,67,0.761194029850746,0.238805970149254,1
"19143","ZNF433",21,31,52,0.596153846153846,0.403846153846154,1
"19144","ZNF436",13,25,38,0.657894736842105,0.342105263157895,1
"19145","ZNF438",29,59,88,0.670454545454545,0.329545454545455,1
"19146","ZNF439",21,40,61,0.655737704918033,0.344262295081967,1
"19147","ZNF44",26,44,70,0.628571428571429,0.371428571428571,1
"19148","ZNF440",28,52,80,0.65,0.35,1
"19149","ZNF441",19,42,61,0.688524590163934,0.311475409836066,1
"19150","ZNF442",19,55,74,0.743243243243243,0.256756756756757,1
"19151","ZNF443",29,54,83,0.650602409638554,0.349397590361446,1
"19152","ZNF444",4,6,10,0.6,0.4,1
"19153","ZNF445",44,51,95,0.536842105263158,0.463157894736842,1
"19154","ZNF446",11,16,27,0.592592592592593,0.407407407407407,1
"19155","ZNF449",37,16,53,0.30188679245283,0.69811320754717,1
"19156","ZNF45",22,41,63,0.650793650793651,0.349206349206349,1
"19157","ZNF451",51,76,127,0.598425196850394,0.401574803149606,1
"19158","ZNF454",30,66,96,0.6875,0.3125,1
"19159","ZNF460",26,40,66,0.606060606060606,0.393939393939394,1
"19160","ZNF461",19,32,51,0.627450980392157,0.372549019607843,1
"19161","ZNF462",98,130,228,0.570175438596491,0.429824561403509,1
"19162","ZNF467",17,30,47,0.638297872340426,0.361702127659574,1
"19163","ZNF468",23,26,49,0.530612244897959,0.469387755102041,1
"19164","ZNF469",2,9,11,0.818181818181818,0.181818181818182,1
"19165","ZNF470",40,61,101,0.603960396039604,0.396039603960396,1
"19166","ZNF471",32,87,119,0.73109243697479,0.26890756302521,1
"19167","ZNF473",30,59,89,0.662921348314607,0.337078651685393,1
"19168","ZNF474",26,28,54,0.518518518518518,0.481481481481481,1
"19169","ZNF479",90,154,244,0.631147540983607,0.368852459016393,1
"19170","ZNF48",25,40,65,0.615384615384615,0.384615384615385,1
"19171","ZNF480",32,35,67,0.522388059701492,0.477611940298507,1
"19172","ZNF483",37,53,90,0.588888888888889,0.411111111111111,1
"19173","ZNF484",34,43,77,0.558441558441558,0.441558441558442,1
"19174","ZNF485",8,31,39,0.794871794871795,0.205128205128205,1
"19175","ZNF486",17,36,53,0.679245283018868,0.320754716981132,1
"19176","ZNF488",19,45,64,0.703125,0.296875,1
"19177","ZNF490",26,44,70,0.628571428571429,0.371428571428571,1
"19178","ZNF491",25,40,65,0.615384615384615,0.384615384615385,1
"19179","ZNF492",40,79,119,0.663865546218487,0.336134453781513,1
"19180","ZNF493",35,77,112,0.6875,0.3125,1
"19181","ZNF496",28,51,79,0.645569620253165,0.354430379746835,1
"19182","ZNF497",13,16,29,0.551724137931034,0.448275862068966,1
"19183","ZNF500",13,25,38,0.657894736842105,0.342105263157895,1
"19184","ZNF501",5,19,24,0.791666666666667,0.208333333333333,1
"19185","ZNF502",26,39,65,0.6,0.4,1
"19186","ZNF503",10,14,24,0.583333333333333,0.416666666666667,1
"19187","ZNF503-AS2",1,2,3,0.666666666666667,0.333333333333333,1
"19188","ZNF506",26,25,51,0.490196078431373,0.509803921568627,1
"19189","ZNF507",32,58,90,0.644444444444444,0.355555555555556,1
"19190","ZNF510",22,30,52,0.576923076923077,0.423076923076923,1
"19191","ZNF511",6,12,18,0.666666666666667,0.333333333333333,1
"19192","ZNF511-PRAP1",3,4,7,0.571428571428571,0.428571428571429,1
"19193","ZNF512",11,28,39,0.717948717948718,0.282051282051282,1
"19194","ZNF512B",39,52,91,0.571428571428571,0.428571428571429,1
"19195","ZNF513",23,34,57,0.596491228070175,0.403508771929825,1
"19196","ZNF514",19,39,58,0.672413793103448,0.327586206896552,1
"19197","ZNF516",54,80,134,0.597014925373134,0.402985074626866,1
"19198","ZNF517",14,23,37,0.621621621621622,0.378378378378378,1
"19199","ZNF518A",62,91,153,0.594771241830065,0.405228758169935,1
"19200","ZNF518B",47,65,112,0.580357142857143,0.419642857142857,1
"19201","ZNF519",17,33,50,0.66,0.34,1
"19202","ZNF521",119,181,300,0.603333333333333,0.396666666666667,1
"19203","ZNF524",7,13,20,0.65,0.35,1
"19204","ZNF526",18,36,54,0.666666666666667,0.333333333333333,1
"19205","ZNF527",23,58,81,0.716049382716049,0.283950617283951,1
"19206","ZNF528",47,60,107,0.560747663551402,0.439252336448598,1
"19207","ZNF529",11,32,43,0.744186046511628,0.255813953488372,1
"19208","ZNF530",20,50,70,0.714285714285714,0.285714285714286,1
"19209","ZNF532",44,64,108,0.592592592592593,0.407407407407407,1
"19210","ZNF534",31,38,69,0.550724637681159,0.449275362318841,1
"19211","ZNF536",197,318,515,0.61747572815534,0.38252427184466,1
"19212","ZNF540",35,56,91,0.615384615384615,0.384615384615385,1
"19213","ZNF541",0,4,4,1,0,1
"19214","ZNF543",38,46,84,0.547619047619048,0.452380952380952,1
"19215","ZNF544",38,36,74,0.486486486486487,0.513513513513513,1
"19216","ZNF546",42,61,103,0.592233009708738,0.407766990291262,1
"19217","ZNF547",18,27,45,0.6,0.4,1
"19218","ZNF548",22,51,73,0.698630136986301,0.301369863013699,1
"19219","ZNF549",30,46,76,0.605263157894737,0.394736842105263,1
"19220","ZNF550",7,20,27,0.740740740740741,0.259259259259259,1
"19221","ZNF551",26,38,64,0.59375,0.40625,1
"19222","ZNF552",16,12,28,0.428571428571429,0.571428571428571,1
"19223","ZNF554",22,30,52,0.576923076923077,0.423076923076923,1
"19224","ZNF555",22,32,54,0.592592592592593,0.407407407407407,1
"19225","ZNF556",25,55,80,0.6875,0.3125,1
"19226","ZNF557",27,27,54,0.5,0.5,1
"19227","ZNF558",17,25,42,0.595238095238095,0.404761904761905,1
"19228","ZNF559",17,44,61,0.721311475409836,0.278688524590164,1
"19229","ZNF559-ZNF177",13,18,31,0.580645161290323,0.419354838709677,1
"19230","ZNF560",70,109,179,0.608938547486033,0.391061452513966,1
"19231","ZNF561",13,18,31,0.580645161290323,0.419354838709677,1
"19232","ZNF562",10,28,38,0.736842105263158,0.263157894736842,1
"19233","ZNF563",24,34,58,0.586206896551724,0.413793103448276,1
"19234","ZNF564",26,34,60,0.566666666666667,0.433333333333333,1
"19235","ZNF565",11,19,30,0.633333333333333,0.366666666666667,1
"19236","ZNF566",18,43,61,0.704918032786885,0.295081967213115,1
"19237","ZNF567",34,47,81,0.580246913580247,0.419753086419753,1
"19238","ZNF568",40,60,100,0.6,0.4,1
"19239","ZNF569",38,62,100,0.62,0.38,1
"19240","ZNF57",19,21,40,0.525,0.475,1
"19241","ZNF570",19,59,78,0.756410256410256,0.243589743589744,1
"19242","ZNF571",19,37,56,0.660714285714286,0.339285714285714,1
"19243","ZNF572",31,51,82,0.621951219512195,0.378048780487805,1
"19244","ZNF573",29,39,68,0.573529411764706,0.426470588235294,1
"19245","ZNF574",36,53,89,0.595505617977528,0.404494382022472,1
"19246","ZNF575",2,7,9,0.777777777777778,0.222222222222222,1
"19247","ZNF576",6,8,14,0.571428571428571,0.428571428571429,1
"19248","ZNF577",18,37,55,0.672727272727273,0.327272727272727,1
"19249","ZNF578",42,83,125,0.664,0.336,1
"19250","ZNF579",4,11,15,0.733333333333333,0.266666666666667,1
"19251","ZNF580",1,3,4,0.75,0.25,1
"19252","ZNF581",11,11,22,0.5,0.5,1
"19253","ZNF582",26,43,69,0.623188405797101,0.376811594202899,1
"19254","ZNF583",31,62,93,0.666666666666667,0.333333333333333,1
"19255","ZNF584",19,21,40,0.525,0.475,1
"19256","ZNF585A",44,77,121,0.636363636363636,0.363636363636364,1
"19257","ZNF585B",52,81,133,0.609022556390977,0.390977443609023,1
"19258","ZNF586",21,27,48,0.5625,0.4375,1
"19259","ZNF587",17,32,49,0.653061224489796,0.346938775510204,1
"19260","ZNF589",9,18,27,0.666666666666667,0.333333333333333,1
"19261","ZNF592",49,69,118,0.584745762711864,0.415254237288136,1
"19262","ZNF593",4,3,7,0.428571428571429,0.571428571428571,1
"19263","ZNF594",26,62,88,0.704545454545455,0.295454545454545,1
"19264","ZNF595",31,44,75,0.586666666666667,0.413333333333333,1
"19265","ZNF596",13,35,48,0.729166666666667,0.270833333333333,1
"19266","ZNF597",24,41,65,0.630769230769231,0.369230769230769,1
"19267","ZNF598",23,32,55,0.581818181818182,0.418181818181818,1
"19268","ZNF599",24,47,71,0.661971830985915,0.338028169014085,1
"19269","ZNF600",29,67,96,0.697916666666667,0.302083333333333,1
"19270","ZNF605",23,50,73,0.684931506849315,0.315068493150685,1
"19271","ZNF606",39,57,96,0.59375,0.40625,1
"19272","ZNF607",35,60,95,0.631578947368421,0.368421052631579,1
"19273","ZNF608",53,83,136,0.610294117647059,0.389705882352941,1
"19274","ZNF609",59,67,126,0.531746031746032,0.468253968253968,1
"19275","ZNF610",28,42,70,0.6,0.4,1
"19276","ZNF611",41,65,106,0.613207547169811,0.386792452830189,1
"19277","ZNF613",32,33,65,0.507692307692308,0.492307692307692,1
"19278","ZNF614",27,33,60,0.55,0.45,1
"19279","ZNF615",34,63,97,0.649484536082474,0.350515463917526,1
"19280","ZNF616",39,83,122,0.680327868852459,0.319672131147541,1
"19281","ZNF618",28,40,68,0.588235294117647,0.411764705882353,1
"19282","ZNF619",21,37,58,0.637931034482759,0.362068965517241,1
"19283","ZNF620",12,14,26,0.538461538461538,0.461538461538462,1
"19284","ZNF621",16,22,38,0.578947368421053,0.421052631578947,1
"19285","ZNF622",26,31,57,0.543859649122807,0.456140350877193,1
"19286","ZNF623",19,44,63,0.698412698412698,0.301587301587302,1
"19287","ZNF624",31,53,84,0.630952380952381,0.369047619047619,1
"19288","ZNF625",16,24,40,0.6,0.4,1
"19289","ZNF626",39,70,109,0.642201834862385,0.357798165137615,1
"19290","ZNF627",9,22,31,0.709677419354839,0.290322580645161,1
"19291","ZNF628",26,33,59,0.559322033898305,0.440677966101695,1
"19292","ZNF629",22,40,62,0.645161290322581,0.354838709677419,1
"19293","ZNF630",28,24,52,0.461538461538462,0.538461538461538,1
"19294","ZNF638",65,120,185,0.648648648648649,0.351351351351351,1
"19295","ZNF639",21,31,52,0.596153846153846,0.403846153846154,1
"19296","ZNF641",17,13,30,0.433333333333333,0.566666666666667,1
"19297","ZNF644",42,90,132,0.681818181818182,0.318181818181818,1
"19298","ZNF646",52,91,143,0.636363636363636,0.363636363636364,1
"19299","ZNF648",41,62,103,0.601941747572815,0.398058252427184,1
"19300","ZNF649",21,40,61,0.655737704918033,0.344262295081967,1
"19301","ZNF652",21,33,54,0.611111111111111,0.388888888888889,1
"19302","ZNF653",25,23,48,0.479166666666667,0.520833333333333,1
"19303","ZNF654",22,27,49,0.551020408163265,0.448979591836735,1
"19304","ZNF655",18,23,41,0.560975609756098,0.439024390243902,1
"19305","ZNF658",47,81,128,0.6328125,0.3671875,1
"19306","ZNF658B",26,76,102,0.745098039215686,0.254901960784314,1
"19307","ZNF660",12,29,41,0.707317073170732,0.292682926829268,1
"19308","ZNF662",28,35,63,0.555555555555556,0.444444444444444,1
"19309","ZNF664",19,23,42,0.547619047619048,0.452380952380952,1
"19310","ZNF665",43,84,127,0.661417322834646,0.338582677165354,1
"19311","ZNF667",46,71,117,0.606837606837607,0.393162393162393,1
"19312","ZNF668",37,44,81,0.54320987654321,0.45679012345679,1
"19313","ZNF669",13,18,31,0.580645161290323,0.419354838709677,1
"19314","ZNF670",11,25,36,0.694444444444444,0.305555555555556,1
"19315","ZNF671",25,38,63,0.603174603174603,0.396825396825397,1
"19316","ZNF672",10,15,25,0.6,0.4,1
"19317","ZNF674",21,11,32,0.34375,0.65625,1
"19318","ZNF675",27,59,86,0.686046511627907,0.313953488372093,1
"19319","ZNF676",72,147,219,0.671232876712329,0.328767123287671,1
"19320","ZNF677",30,84,114,0.736842105263158,0.263157894736842,1
"19321","ZNF678",19,45,64,0.703125,0.296875,1
"19322","ZNF679",1,5,6,0.833333333333333,0.166666666666667,1
"19323","ZNF680",20,40,60,0.666666666666667,0.333333333333333,1
"19324","ZNF681",29,74,103,0.718446601941748,0.281553398058252,1
"19325","ZNF682",14,43,57,0.754385964912281,0.245614035087719,1
"19326","ZNF683",26,49,75,0.653333333333333,0.346666666666667,1
"19327","ZNF684",11,27,38,0.710526315789474,0.289473684210526,1
"19328","ZNF687",39,56,95,0.589473684210526,0.410526315789474,1
"19329","ZNF688",9,10,19,0.526315789473684,0.473684210526316,1
"19330","ZNF689",17,22,39,0.564102564102564,0.435897435897436,1
"19331","ZNF69",6,6,12,0.5,0.5,1
"19332","ZNF691",11,14,25,0.56,0.44,1
"19333","ZNF692",25,24,49,0.489795918367347,0.510204081632653,1
"19334","ZNF695",21,49,70,0.7,0.3,1
"19335","ZNF696",9,15,24,0.625,0.375,1
"19336","ZNF697",13,21,34,0.617647058823529,0.382352941176471,1
"19337","ZNF699",30,44,74,0.594594594594595,0.405405405405405,1
"19338","ZNF7",28,44,72,0.611111111111111,0.388888888888889,1
"19339","ZNF70",18,23,41,0.560975609756098,0.439024390243902,1
"19340","ZNF700",38,53,91,0.582417582417582,0.417582417582418,1
"19341","ZNF701",34,42,76,0.552631578947368,0.447368421052632,1
"19342","ZNF702P",2,0,2,0,1,1
"19343","ZNF703",11,9,20,0.45,0.55,1
"19344","ZNF704",19,27,46,0.58695652173913,0.41304347826087,1
"19345","ZNF705A",20,24,44,0.545454545454545,0.454545454545455,1
"19346","ZNF705D",1,2,3,0.666666666666667,0.333333333333333,1
"19347","ZNF706",1,3,4,0.75,0.25,1
"19348","ZNF707",11,20,31,0.645161290322581,0.354838709677419,1
"19349","ZNF708",23,36,59,0.610169491525424,0.389830508474576,1
"19350","ZNF709",25,62,87,0.71264367816092,0.28735632183908,1
"19351","ZNF71",31,52,83,0.626506024096386,0.373493975903614,1
"19352","ZNF710",16,30,46,0.652173913043478,0.347826086956522,1
"19353","ZNF711",77,63,140,0.45,0.55,1
"19354","ZNF713",23,37,60,0.616666666666667,0.383333333333333,1
"19355","ZNF714",25,41,66,0.621212121212121,0.378787878787879,1
"19356","ZNF716",0,7,7,1,0,1
"19357","ZNF717",1,2,3,0.666666666666667,0.333333333333333,1
"19358","ZNF718",14,32,46,0.695652173913043,0.304347826086957,1
"19359","ZNF720",0,2,2,1,0,1
"19360","ZNF721",39,74,113,0.654867256637168,0.345132743362832,1
"19361","ZNF727",0,7,7,1,0,1
"19362","ZNF732",0,12,12,1,0,1
"19363","ZNF735",1,7,8,0.875,0.125,1
"19364","ZNF737",0,3,3,1,0,1
"19365","ZNF74",29,41,70,0.585714285714286,0.414285714285714,1
"19366","ZNF740",5,7,12,0.583333333333333,0.416666666666667,1
"19367","ZNF746",19,43,62,0.693548387096774,0.306451612903226,1
"19368","ZNF747",2,4,6,0.666666666666667,0.333333333333333,1
"19369","ZNF749",41,25,66,0.378787878787879,0.621212121212121,1
"19370","ZNF750",24,69,93,0.741935483870968,0.258064516129032,1
"19371","ZNF75A",12,22,34,0.647058823529412,0.352941176470588,1
"19372","ZNF75D",40,27,67,0.402985074626866,0.597014925373134,1
"19373","ZNF76",20,24,44,0.545454545454545,0.454545454545455,1
"19374","ZNF761",45,70,115,0.608695652173913,0.391304347826087,1
"19375","ZNF763",10,29,39,0.743589743589744,0.256410256410256,1
"19376","ZNF764",16,11,27,0.407407407407407,0.592592592592593,1
"19377","ZNF765",25,33,58,0.568965517241379,0.431034482758621,1
"19378","ZNF766",13,26,39,0.666666666666667,0.333333333333333,1
"19379","ZNF767P",9,14,23,0.608695652173913,0.391304347826087,1
"19380","ZNF768",26,40,66,0.606060606060606,0.393939393939394,1
"19381","ZNF77",18,30,48,0.625,0.375,1
"19382","ZNF770",28,39,67,0.582089552238806,0.417910447761194,1
"19383","ZNF771",0,1,1,1,0,1
"19384","ZNF772",14,21,35,0.6,0.4,1
"19385","ZNF773",22,43,65,0.661538461538462,0.338461538461538,1
"19386","ZNF774",18,18,36,0.5,0.5,1
"19387","ZNF775",16,11,27,0.407407407407407,0.592592592592593,1
"19388","ZNF776",22,28,50,0.56,0.44,1
"19389","ZNF777",40,55,95,0.578947368421053,0.421052631578947,1
"19390","ZNF778",19,29,48,0.604166666666667,0.395833333333333,1
"19391","ZNF780A",32,45,77,0.584415584415584,0.415584415584416,1
"19392","ZNF780B",40,61,101,0.603960396039604,0.396039603960396,1
"19393","ZNF781",14,34,48,0.708333333333333,0.291666666666667,1
"19394","ZNF782",34,47,81,0.580246913580247,0.419753086419753,1
"19395","ZNF783",12,29,41,0.707317073170732,0.292682926829268,1
"19396","ZNF784",3,11,14,0.785714285714286,0.214285714285714,1
"19397","ZNF785",9,24,33,0.727272727272727,0.272727272727273,1
"19398","ZNF786",33,54,87,0.620689655172414,0.379310344827586,1
"19399","ZNF787",12,17,29,0.586206896551724,0.413793103448276,1
"19400","ZNF789",6,31,37,0.837837837837838,0.162162162162162,1
"19401","ZNF79",19,27,46,0.58695652173913,0.41304347826087,1
"19402","ZNF790",30,48,78,0.615384615384615,0.384615384615385,1
"19403","ZNF791",26,34,60,0.566666666666667,0.433333333333333,1
"19404","ZNF792",18,38,56,0.678571428571429,0.321428571428571,1
"19405","ZNF793",27,50,77,0.649350649350649,0.350649350649351,1
"19406","ZNF799",16,38,54,0.703703703703704,0.296296296296296,1
"19407","ZNF8",15,43,58,0.741379310344828,0.258620689655172,1
"19408","ZNF80",24,45,69,0.652173913043478,0.347826086956522,1
"19409","ZNF800",32,78,110,0.709090909090909,0.290909090909091,1
"19410","ZNF804A",167,315,482,0.653526970954357,0.346473029045643,1
"19411","ZNF804B",118,264,382,0.691099476439791,0.308900523560209,1
"19412","ZNF805",0,6,6,1,0,1
"19413","ZNF808",49,84,133,0.631578947368421,0.368421052631579,1
"19414","ZNF81",43,37,80,0.4625,0.5375,1
"19415","ZNF813",36,66,102,0.647058823529412,0.352941176470588,1
"19416","ZNF814",0,4,4,1,0,1
"19417","ZNF816",40,43,83,0.518072289156627,0.481927710843373,1
"19418","ZNF816-ZNF321P",10,15,25,0.6,0.4,1
"19419","ZNF821",12,21,33,0.636363636363636,0.363636363636364,1
"19420","ZNF823",16,41,57,0.719298245614035,0.280701754385965,1
"19421","ZNF827",37,90,127,0.708661417322835,0.291338582677165,1
"19422","ZNF829",20,46,66,0.696969696969697,0.303030303030303,1
"19423","ZNF83",17,29,46,0.630434782608696,0.369565217391304,1
"19424","ZNF830",9,19,28,0.678571428571429,0.321428571428571,1
"19425","ZNF831",158,310,468,0.662393162393162,0.337606837606838,1
"19426","ZNF833P",9,15,24,0.625,0.375,1
"19427","ZNF835",63,107,170,0.629411764705882,0.370588235294118,1
"19428","ZNF836",49,78,127,0.614173228346457,0.385826771653543,1
"19429","ZNF837",1,2,3,0.666666666666667,0.333333333333333,1
"19430","ZNF839",17,28,45,0.622222222222222,0.377777777777778,1
"19431","ZNF84",33,58,91,0.637362637362637,0.362637362637363,1
"19432","ZNF840P",1,0,1,0,1,1
"19433","ZNF841",1,6,7,0.857142857142857,0.142857142857143,1
"19434","ZNF843",0,2,2,1,0,1
"19435","ZNF844",0,3,3,1,0,1
"19436","ZNF845",0,7,7,1,0,1
"19437","ZNF846",14,40,54,0.740740740740741,0.259259259259259,1
"19438","ZNF85",27,56,83,0.674698795180723,0.325301204819277,1
"19439","ZNF853",0,2,2,1,0,1
"19440","ZNF860",0,3,3,1,0,1
"19441","ZNF862",51,49,100,0.49,0.51,1
"19442","ZNF875",24,34,58,0.586206896551724,0.413793103448276,1
"19443","ZNF878",24,37,61,0.60655737704918,0.39344262295082,1
"19444","ZNF879",0,7,7,1,0,1
"19445","ZNF880",6,18,24,0.75,0.25,1
"19446","ZNF883",10,41,51,0.803921568627451,0.196078431372549,1
"19447","ZNF888",1,2,3,0.666666666666667,0.333333333333333,1
"19448","ZNF90",0,6,6,1,0,1
"19449","ZNF91",66,127,193,0.658031088082902,0.341968911917098,1
"19450","ZNF92",21,33,54,0.611111111111111,0.388888888888889,1
"19451","ZNF93",20,55,75,0.733333333333333,0.266666666666667,1
"19452","ZNF98",69,123,192,0.640625,0.359375,1
"19453","ZNF99",95,177,272,0.650735294117647,0.349264705882353,1
"19454","ZNFX1",66,91,157,0.579617834394904,0.420382165605096,1
"19455","ZNHIT1",7,16,23,0.695652173913043,0.304347826086957,1
"19456","ZNHIT2",5,13,18,0.722222222222222,0.277777777777778,1
"19457","ZNHIT3",4,9,13,0.692307692307692,0.307692307692308,1
"19458","ZNHIT6",20,23,43,0.534883720930233,0.465116279069767,1
"19459","ZNRD2",2,8,10,0.8,0.2,1
"19460","ZNRF1",3,9,12,0.75,0.25,1
"19461","ZNRF2",3,4,7,0.571428571428571,0.428571428571429,1
"19462","ZNRF3",37,55,92,0.597826086956522,0.402173913043478,1
"19463","ZNRF4",28,46,74,0.621621621621622,0.378378378378378,1
"19464","ZP1",22,42,64,0.65625,0.34375,1
"19465","ZP2",42,57,99,0.575757575757576,0.424242424242424,1
"19466","ZP3",10,23,33,0.696969696969697,0.303030303030303,1
"19467","ZP4",71,84,155,0.541935483870968,0.458064516129032,1
"19468","ZPBP",37,42,79,0.531645569620253,0.468354430379747,1
"19469","ZPBP2",13,25,38,0.657894736842105,0.342105263157895,1
"19470","ZPLD1",36,66,102,0.647058823529412,0.352941176470588,1
"19471","ZPR1",8,20,28,0.714285714285714,0.285714285714286,1
"19472","ZRANB1",18,41,59,0.694915254237288,0.305084745762712,1
"19473","ZRANB2",12,32,44,0.727272727272727,0.272727272727273,1
"19474","ZRANB3",31,67,98,0.683673469387755,0.316326530612245,1
"19475","ZRSR2",11,9,20,0.45,0.55,1
"19476","ZSCAN1",41,63,104,0.605769230769231,0.394230769230769,1
"19477","ZSCAN10",20,46,66,0.696969696969697,0.303030303030303,1
"19478","ZSCAN12",0,3,3,1,0,1
"19479","ZSCAN16",12,14,26,0.538461538461538,0.461538461538462,1
"19480","ZSCAN18",29,57,86,0.662790697674419,0.337209302325581,1
"19481","ZSCAN2",28,27,55,0.490909090909091,0.509090909090909,1
"19482","ZSCAN20",44,74,118,0.627118644067797,0.372881355932203,1
"19483","ZSCAN21",18,29,47,0.617021276595745,0.382978723404255,1
"19484","ZSCAN22",21,27,48,0.5625,0.4375,1
"19485","ZSCAN23",0,1,1,1,0,1
"19486","ZSCAN25",16,31,47,0.659574468085106,0.340425531914894,1
"19487","ZSCAN26",8,11,19,0.578947368421053,0.421052631578947,1
"19488","ZSCAN29",27,33,60,0.55,0.45,1
"19489","ZSCAN30",14,20,34,0.588235294117647,0.411764705882353,1
"19490","ZSCAN31",21,33,54,0.611111111111111,0.388888888888889,1
"19491","ZSCAN32",1,6,7,0.857142857142857,0.142857142857143,1
"19492","ZSCAN4",34,54,88,0.613636363636364,0.386363636363636,1
"19493","ZSCAN5A",22,35,57,0.614035087719298,0.385964912280702,1
"19494","ZSCAN5B",25,54,79,0.683544303797468,0.316455696202532,1
"19495","ZSCAN9",11,18,29,0.620689655172414,0.379310344827586,1
"19496","ZSWIM1",11,25,36,0.694444444444444,0.305555555555556,1
"19497","ZSWIM2",55,99,154,0.642857142857143,0.357142857142857,1
"19498","ZSWIM3",29,37,66,0.560606060606061,0.439393939393939,1
"19499","ZSWIM4",29,53,82,0.646341463414634,0.353658536585366,1
"19500","ZSWIM5",33,51,84,0.607142857142857,0.392857142857143,1
"19501","ZSWIM6",0,6,6,1,0,1
"19502","ZSWIM7",1,4,5,0.8,0.2,1
"19503","ZSWIM8",44,72,116,0.620689655172414,0.379310344827586,1
"19504","ZUP1",16,28,44,0.636363636363636,0.363636363636364,1
"19505","ZW10",31,38,69,0.550724637681159,0.449275362318841,1
"19506","ZWILCH",17,21,38,0.552631578947368,0.447368421052632,1
"19507","ZWINT",23,34,57,0.596491228070175,0.403508771929825,1
"19508","ZXDA",34,28,62,0.451612903225806,0.548387096774194,1
"19509","ZXDB",35,12,47,0.25531914893617,0.74468085106383,1
"19510","ZXDC",24,32,56,0.571428571428571,0.428571428571429,1
"19511","ZYG11A",1,7,8,0.875,0.125,1
"19512","ZYG11B",21,41,62,0.661290322580645,0.338709677419355,1
"19513","ZYX",21,28,49,0.571428571428571,0.428571428571429,1
"19514","ZZEF1",86,99,185,0.535135135135135,0.464864864864865,1
"19515","ZZZ3",44,52,96,0.541666666666667,0.458333333333333,1
